UVx6TlN0AGU9Z29cMl9MM0E/N3dgO3wSVTU7SBJhIEV+enVg
259,32,312,0,32,32,0,0,0,1,1241,0
160,616,344,0,0,8454016,0,0,0,1,632,0
100,144,96,0,512,0,0,270,0,1,4,0
195,144,184,0,0,128,270,0,0,1,21,0
100,224,96,0,512,0,0,270,0,1,18,0
195,304,184,0,0,128,270,0,0,1,23,0
195,224,184,0,0,128,270,0,0,1,22,0
100,384,96,0,512,0,0,270,0,1,20,0
195,384,184,0,0,128,270,0,0,1,24,0
100,304,96,0,512,0,0,270,0,1,19,0
197,56,232,0,2,939,0,0,0,1,962,0
197,568,40,0,2,765,0,0,0,1,691,0
174,40,168,0,1,1016,0,0,0,0,1221,1
174,56,168,0,1,1067,0,0,0,0,1224,1
174,600,144,0,1,0,522,0,0,0,125,1
205,424.15,192,0,-1,0,0.15,0,0,1,779,0
205,519.85,192,0,-1,0,0.15,0,0,1,46,0
186,544,96,0,32,32,0,0,0,1,992,0
188,456,192,0,0,14,0,0,0,1,33,0
188,600,192,0,0,16,14,7,10,1,211,0
188,424,192,0,0,16,0,0,0,1,25,0
188,520,192,0,0,10,0,0,0,1,35,0
188,488,192,0,0,7,0,0,0,1,34,0
154,186.52,261.48,0,1,0.50,32,32,-1,1,1267,1
158,16,80,0,0,16777215,0,1,0,1,40,0
210,456,0,0,0,180,0,0,0,1,475,0
210,424,0,0,0,180,0,0,0,1,481,0
210,392,0,0,0,180,0,0,0,1,484,0
210,360,0,0,0,180,0,0,0,1,487,0
210,328,0,0,0,180,0,0,0,1,490,0
210,264,0,0,0,180,0,0,0,1,496,0
210,232,0,0,0,180,0,0,0,1,499,0
210,168,0,0,0,180,0,0,0,1,505,0
210,136,0,0,0,180,0,0,0,1,508,0
210,360,72,0,490,0,0,0,0,1,423,0
210,520,72,0,461,0,0,0,0,1,325,0
210,136,72,0,512,0,0,0,0,1,451,0
210,72,0,0,0,180,0,0,0,1,517,0
210,104,0,0,0,180,0,0,0,1,512,0
210,104,72,0,517,0,0,0,0,1,455,0
210,168,72,0,508,0,0,0,0,1,447,0
210,200,0,0,0,180,0,0,0,1,502,0
210,200,72,0,505,0,0,0,0,1,443,0
210,232,72,0,502,0,0,0,0,1,440,0
210,264,72,0,499,0,0,0,0,1,436,0
210,328,72,0,493,0,0,0,0,1,428,0
210,296,72,0,496,0,0,0,0,1,432,0
210,296,0,0,0,180,0,0,0,1,493,0
210,392,72,0,487,0,0,0,0,1,419,0
210,488,72,0,475,0,0,0,0,1,406,0
210,488,0,0,0,180,0,0,0,1,461,0
210,456,72,0,481,0,0,0,0,1,412,0
210,424,72,0,484,0,0,0,0,1,416,0
157,16,160,0,32,32,0,0,0,1,41,0
157,448,200,0,64,16,0,0,0,1,53,0
157,632,176,0,16,32,0,0,0,1,174,0
157,600,152,0,16,16,0,0,0,1,251,0
157,632,120,0,16,16,0,0,0,1,262,0
157,576,88,0,32,16,0,0,0,1,267,0
157,560,40,0,64,16,0,0,0,1,317,0
157,504,32,0,16,64,0,0,0,1,333,0
157,48,232,0,64,16,0,0,0,1,395,0
157,472,32,0,16,64,0,0,0,1,546,0
157,440,32,0,16,64,0,0,0,1,550,0
157,408,32,0,16,64,0,0,0,1,552,0
157,376,32,0,16,64,0,0,0,1,555,0
157,344,32,0,16,64,0,0,0,1,557,0
157,312,32,0,16,64,0,0,0,1,560,0
157,280,32,0,16,64,0,0,0,1,563,0
157,248,32,0,16,64,0,0,0,1,569,0
157,216,32,0,16,64,0,0,0,1,572,0
157,184,32,0,16,64,0,0,0,1,576,0
157,152,32,0,16,64,0,0,0,1,578,0
157,120,32,0,16,64,0,0,0,1,581,0
157,88,32,0,16,64,0,0,0,1,584,0
157,304,80,0,448,16,0,0,0,1,621,0
157,320,352,0,656,16,0,0,0,1,740,0
157,32,176,0,64,16,0,0,0,1,845,0
157,88,224,0,16,32,0,0,0,1,854,0
157,637,69,0,16,16,0,0,0,1,896,0
157,504,208,0,48,32,1,0,0,1,9,0
157,592,208,0,64,32,1,0,0,1,1061,0
157,544,264,0,64,16,1,0,0,1,1075,0
157,520,240,0,16,32,1,0,0,1,1086,0
157,568,240,0,16,32,1,0,0,1,1092,0
172,288,160,0,0,0,0,0,0,1,7,1
172,368,159,0,0,0,0,0,0,1,10,1
172,208,160,0,0,0,0,0,0,1,14,1
172,128,160,0,0,0,0,0,0,1,16,1
169,528,0,0,0,0,0,0,0,1,522,1
172,527,96,0,0,0,0,0,0,1,1016,1
172,528,192,0,0,0,0,0,0,1,1067,1
155,160,288,0,1,1,0,0,0,1,1265,0
155,208,240,0,2,1,0,0,0,1,1266,0
166,88,200,0,0,0,0,0,0,1,75,1
166,88,184,0,0,0,180,0,0,1,765,1
166,24,184,0,0,0,270,0,0,1,939,1
166,186.16,261.84,0,1267,0,0,0,0,1,1261,1
196,143.50,167.50,0,0,0,0,0,0,0,0,0
196,383.50,166.50,0,0,0,0,0,0,0,0,0
1234567890
24,256,80,64,16,416,192,10000,0,0,0,0
24,256,80,64,16,480,192,10000,0,0,0,0
24,256,80,64,16,544,192,10000,0,0,0,0
25,96,0,48,144,0,0,10002,0,0,0,0
25,96,0,48,144,0,144,10002,0,0,0,0
25,96,0,48,144,0,288,10002,0,0,0,0
25,96,0,48,144,48,192,10002,0,0,0,0
25,96,0,48,144,48,336,10002,0,0,0,0
25,96,0,48,144,48,48,10002,0,0,0,0
25,96,0,48,144,96,96,10002,0,0,0,0
25,96,0,48,144,96,240,10002,0,0,0,0
25,96,0,48,144,144,0,10002,0,0,0,0
25,96,0,48,144,144,144,10002,0,0,0,0
25,96,0,48,144,144,288,10002,0,0,0,0
25,96,0,48,144,192,192,10002,0,0,0,0
25,96,0,48,144,192,48,10002,0,0,0,0
25,96,0,48,144,240,0,10002,0,0,0,0
25,96,0,48,144,240,144,10002,0,0,0,0
25,96,0,48,144,240,288,10002,0,0,0,0
25,96,0,48,144,288,96,10002,0,0,0,0
25,96,0,48,144,336,48,10002,0,0,0,0
25,96,0,48,144,384,0,10002,0,0,0,0
25,96,0,48,144,384,144,10002,0,0,0,0
25,96,0,48,144,336,192,10002,0,0,0,0
25,96,0,48,144,432,48,10002,0,0,0,0
25,96,0,48,144,432,192,10002,0,0,0,0
25,96,0,48,144,480,144,10002,0,0,0,0
25,96,0,48,144,480,0,10002,0,0,0,0
25,96,0,48,144,528,48,10002,0,0,0,0
25,96,0,48,144,528,192,10002,0,0,0,0
25,96,0,48,144,576,144,10002,0,0,0,0
25,96,0,48,144,576,0,10002,0,0,0,0
987654321
JRorFgErRTolCURh

