X1h6TlR7BmU9Z2dHPkZUCBgPfkpYGzFXPGtUF1MhYwE3Zml8NTghenh/cUNiVSc=
160,109,307,0,1,65408,0,0,0,1,5,0
195,134,228,0,0,128,204,0,123,1,124,0
195,272,368,0,0,128,270,0,128,1,129,0
123,368,96,0,32,255,0,0,0,1,50,0
123,272,208,0,32,65408,0,0,0,1,49,0
123,200,165,0,128,65408,0,0,0,0,35,0
123,200,256,0,32,12615680,0,0,0,1,45,0
100,134,228,0,256,0,124,0,124,1,125,0
100,272,368,0,256,0,129,0,129,1,131,0
123,544,88,0,64,8404992,0,0,0,0,80,0
100,328.50,252,0,256,16711808,55,0,55,1,57,0
123,552,280,0,64,65535,0,0,0,0,84,0
123,552,192,0,64,32768,0,0,0,1,83,0
123,112,104,0,16,16776960,0,0,0,0,120,0
100,264.50,124,0,256,16711808,25,0,25,1,51,0
123,128,40,0,16,16776960,0,0,0,0,122,0
197,272,456,0,2,0,0,0,0,1,135,0
197,344,344,0,2,95,0,0,0,1,90,0
197,344,280,0,2,94,0,0,0,1,93,0
197,80,208,0,3,81,0,0,0,1,6,0
197,128,208,0,2,0,0,0,0,1,9,0
197,104,208,0,4,83,0,0,0,1,8,0
174,64,96,0,1,35,36,37,38,1,41,1
174,368,120,0,1,43,50,78,0,0,48,1
174,272,232,0,1,42,49,78,0,0,47,1
174,80,348,0,1,106,0,0,0,1,100,1
174,399,281,0,1,66,64,80,78,1,63,1
174,392,152,0,1,25,0,51,0,0,29,1
174,112,152,0,0,120,121,122,0,0,119,1
174,200,280,0,1,45,39,78,0,0,46,0
174,456,280,0,1,57,55,0,0,0,58,1
174,216,456,0,1,128,0,0,0,0,126,1
174,336,456,0,1,131,0,0,0,0,127,1
205,368.50,280,0,1,0,0.50,0,0,1,55,0
205,294,456,0,1,5,0.50,0,0,1,128,0
205,304.50,152,0,1,0,0.50,0,0,1,25,0
220,92,245,0,88,32,0,0,0,0,123,1
186,232,344,0,32,32,0,0,0,1,86,0
186,200,280,0,32,32,0,0,0,1,108,0
188,144,347,0,0,106,0,0,0,1,99,0
188,352,136,0,90,34,12,0,0,1,27,0
188,264,152,0,0,41,77,0,0,1,44,0
188,80,309,0,0,52,84,82,91,1,53,0
188,80,152,0,0,33,119,123,0,1,32,0
188,328,344,0,0,12,0,0,0,1,89,0
175,120,87,0,34,30,0,0,0,0,33,0
273,240,72,0,41,2,0,0,0,1,34,0
175,128,120,0,46,120,1,0,0,1,36,0
175,104,120,0,47,80,1,0,0,1,37,0
175,80,120,0,48,60,1,0,0,1,38,0
175,168,344,0,12,35,0,0,0,1,52,0
175,448,176,0,65,10,0,0,0,1,64,0
289,380,197,0,66,0,0,0,0,1,65,0
273,332,193,0,34,2,0,0,0,1,66,0
175,382,337,0,95,80,0,0,0,0,94,0
273,304,376,0,91,2,0,0,0,1,95,0
273,112,408,0,91,2,0,0,0,1,106,0
210,120,387,0,76,0,0,0,0,1,104,0
210,48,330,0,76,270,0,0,0,1,75,0
210,56,296,0,75,270,0,0,0,1,70,0
210,110,267,0,0,180,0,0,0,1,76,0
158,107,309,0,0,16777215,0,1,0,1,4,0
216,193,135,0,2,0,1,0,0,0,77,0
216,552,184,0,4,0,1,0,0,0,81,0
216,552,88,0,3,0,1,0,0,0,78,0
216,553,283,0,11,0,1,0,0,0,82,0
157,200,192,0,64,16,0,0,0,1,15,0
157,272,240,0,64,16,0,0,0,1,16,0
157,204,288,0,64,16,0,0,0,1,17,0
157,328,160,0,152,16,0,0,0,1,18,0
157,368,136,0,32,32,0,0,0,1,31,0
157,392,288,0,152,16,0,0,0,1,54,0
157,280,352,0,152,16,0,0,0,1,72,0
157,152,359,0,32,8,0,0,0,1,103,0
157,136,351,0,32,8,0,0,0,1,73,0
157,504,376,0,32,8,0,0,0,1,114,0
157,536,344,0,32,8,0,0,0,1,115,0
157,484,322,0,32,8,0,0,0,1,116,0
157,96,312,0,96,8,0,0,0,1,24,0
157,112,264,0,64,8,0,0,0,1,2,0
157,140,224,0,8,32,0,0,0,1,67,0
157,140,375,0,8,24,0,0,0,1,118,0
157,104,216,0,64,16,0,0,0,1,7,0
157,104,160,0,64,16,0,0,0,1,11,0
157,128,72,0,64,16,0,0,0,1,88,0
157,72,351,0,64,8,0,0,0,1,97,0
157,84,276,0,8,16,0,0,0,1,3,0
157,64,280,0,32,8,0,0,0,1,69,0
157,64,192,0,16,64,0,0,0,1,10,0
157,64,128,0,16,64,0,0,0,1,14,0
157,52,296,0,8,24,0,0,0,1,68,0
157,44,324,0,8,48,0,0,0,1,74,0
157,44,387,0,8,64,0,0,0,1,117,0
157,112,391,0,64,8,0,0,0,1,102,0
157,464,400,0,32,8,0,0,0,1,113,0
157,416,416,0,32,8,0,0,0,1,112,0
157,116,427,0,152,16,0,0,0,1,109,0
157,368,432,0,32,8,0,0,0,1,111,0
157,273,464,0,152,16,0,0,0,1,110,0
169,104,316,0,1,0,0,0,0,0,91,1
166,135,268,0,0,0,270,0,0,0,12,1
166,128,168,0,0,0,269,0,0,0,39,0
166,104,168,0,0,0,269,0,0,0,42,0
166,80,168,0,0,0,269,0,0,0,43,0
255,256,305,0,64,64,1,0,0,1,133,0
196,368,105,0,0,0,0,0,0,0,0,0
196,272,217,0,0,0,0,0,0,0,0,0
196,64,81,0,0,0,0,0,0,0,0,0
157,240,48,0,96,8,0,0,0,1,87,0
216,128,40,0,26,1,0,0,0,0,121,0
1234567890
25,176,48,32,32,80,288,10002,0,0,0,0
25,176,48,32,32,112,288,10002,0,0,0,0
25,176,48,32,32,112,256,10002,0,0,0,0
25,176,48,32,32,80,256,10002,0,0,0,0
25,112,48,16,16,128,320,10002,0,0,0,0
25,112,48,16,16,112,320,10002,0,0,0,0
25,112,48,16,16,96,320,10002,0,0,0,0
25,112,48,16,16,80,320,10002,0,0,0,0
25,112,80,16,16,128,336,10002,0,0,0,0
25,112,80,16,16,112,336,10002,0,0,0,0
25,112,80,16,16,96,336,10002,0,0,0,0
25,112,80,16,16,80,336,10002,0,0,0,0
25,128,64,16,16,64,304,10002,0,0,0,0
25,128,64,16,16,64,288,10002,0,0,0,0
25,128,64,16,16,64,272,10002,0,0,0,0
25,128,64,16,16,64,256,10002,0,0,0,0
25,112,80,16,16,80,240,10002,0,0,0,0
25,112,80,16,16,96,240,10002,0,0,0,0
25,112,80,16,16,112,240,10002,0,0,0,0
25,112,80,16,16,128,240,10002,0,0,0,0
25,112,48,16,16,128,224,10002,0,0,0,0
25,112,48,16,16,112,224,10002,0,0,0,0
25,112,48,16,16,96,224,10002,0,0,0,0
25,112,48,16,16,80,224,10002,0,0,0,0
25,96,64,16,16,48,240,10002,0,0,0,0
25,96,64,16,16,48,256,10002,0,0,0,0
25,96,64,16,16,48,272,10002,0,0,0,0
25,96,64,16,16,48,288,10002,0,0,0,0
25,96,64,16,16,48,304,10002,0,0,0,0
25,96,64,16,16,48,320,10002,0,0,0,0
25,96,80,16,16,48,336,10002,0,0,0,0
25,96,48,16,16,48,224,10002,0,0,0,0
25,112,48,16,16,64,224,10002,0,0,0,0
25,112,64,16,16,64,240,10002,0,0,0,0
25,112,64,16,16,64,320,10002,0,0,0,0
25,112,80,16,16,64,336,10002,0,0,0,0
24,256,208,32,32,112,352,10000,0,0,0,0
24,464,192,32,16,96,240,10000,0,0,0,0
24,112,160,16,32,64,240,10000,0,0,0,0
24,416,160,16,16,64,224,10000,0,0,0,0
24,416,160,16,16,112,224,10000,0,0,0,0
24,400,192,16,32,80,224,10000,0,0,0,0
24,400,208,16,16,80,256,10000,0,0,0,0
24,464,160,32,16,96,48,10000,0,0,0,0
24,32,160,32,16,128,48,10000,0,0,0,0
24,96,64,32,32,96,112,10000,0,0,0,0
24,128,0,32,16,96,96,10000,0,0,0,0
25,96,48,16,32,96,80,10002,0,0,0,0
25,96,64,16,16,96,112,10002,0,0,0,0
25,96,64,16,16,96,128,10002,0,0,0,0
25,96,64,16,16,96,144,10002,0,0,0,0
25,128,64,16,16,112,144,10002,0,0,0,0
25,128,64,16,16,112,128,10002,0,0,0,0
25,128,64,16,16,112,112,10002,0,0,0,0
25,128,64,16,16,112,96,10002,0,0,0,0
25,128,48,16,16,112,80,10002,0,0,0,0
25,544,32,16,16,48,96,10002,0,0,0,0
25,528,16,32,16,64,96,10002,0,0,0,0
24,128,0,32,16,112,32,10000,0,0,0,0
25,96,48,16,32,112,16,10002,0,0,0,0
25,128,48,16,32,128,16,10002,0,0,0,0
25,128,80,16,16,128,48,10002,0,0,0,0
25,96,80,16,16,112,48,10002,0,0,0,0
987654321
Cw08BwxiXShuLn8OMkVJelojdFpXXiBOGHxyDUwi

