UVx6TlN0AGU9Z2JAOkhFM0ctdRRrEz1HC2FyDUwVaQAqZmh8NTghenh/cUNiVSc=
259,344,240,0,48,80,0,0,0,1,364,0
259,218,58,0,48,48,0,0,0,1,368,0
259,416,16,0,464,48,0,0,0,1,369,0
259,240,280,0,160,128,0,0,0,1,370,0
259,344,304,0,64,48,0,0,0,1,371,0
259,464,272,0,208,160,0,0,0,1,372,0
259,472,144,0,80,112,0,0,0,1,373,0
160,96,320,0,0,16777215,0,0,0,1,23,0
100,8,0,0,256,32768,0,270,0,1,178,0
218,405,8,0,256,202,0,270,0,1,192,0
218,348,0,0,256,202,0,270,0,1,170,0
218,627,0,0,256,32768,0,271,0,1,216,0
218,510,9,0,256,202,0,270,0,1,194,0
218,282,3,0,256,202,0,270,0,1,195,0
218,455,8,0,256,202,0,270,0,1,193,0
218,232,0,0,256,202,0,270,0,1,168,0
123,85,79,0,128,187,0,0,0,1,175,0
224,352,120,0,128,8388608,0,0,0,1,311,0
100,225.00,263.33,0,250,16777215,61,0,73,1,75,0
100,476.06,265.18,0,250,16777215,84,0,89,1,64,0
197,18,60,0,1,105,0,0,0,1,153,0
197,632,32,0,1.20,29,0,0,0,1,36,0
197,632,328,0,2,0,0,0,0,1,35,0
197,120,200,0,2,212,0,0,0,1,233,0
174,560,32,0,1,37,46,212,220,0,52,1
174,504,33,0,1,180,368,337,0,0,198,1
174,186,192,0,1,209,116,121,142,0,211,1
174,103,200,0,1,212,282,290,323,0,299,1
174,488,128,0,1,301,297,296,0,0,300,1
174,632,120,0,1,56,101,0,0,0,57,1
174,616,120,0,1,297,101,56,0,0,287,1
174,401,193,0,1,235,234,0,0,0,238,1
174,380,194,0,1,282,0,0,0,0,249,1
174,215,74,0,1,187,40,209,0,0,199,1
194,544,248,0,0,110,223,0,0,0,352,0
189,384,240,0,0,128,302,94,0,1,80,0
189,168,320,0,0,70,0,73,0,1,396,0
205,476,192,0,-1,0,1.50,0,0,1,288,0
189,304,240,0,0,128,238,99,0,1,76,0
219,592,125,0,32,8,0,0,0,1,215,1
186,344,193,0,32,32,0,0,0,1,243,0
219,216,37,0,32,8,0,0,0,1,180,1
219,524,17,0,24,32,0,0,0,1,187,1
219,112,248,0,32,32,0,0,0,1,29,1
219,608,48,0,32,32,0,0,0,1,37,1
219,174,176,0,8,32,0,0,0,1,212,1
219,144,248,0,32,32,0,0,0,1,56,1
219,144,216,0,32,32,0,0,0,1,101,1
188,234,74,0,0,361,0,0,0,1,362,0
188,544,328,0,0,352,370,371,0,1,353,0
188,344,272,0,0,245,286,0,0,1,244,0
185,232,136,0,209,16,1,0,0,1,205,0
242,216,17,0,32,32,0,0,0,1,312,0
242,216,176,0,32,32,0,0,0,1,313,0
242,464,112,0,32,32,0,0,0,1,386,0
154,584,87,1,1,2,32,32,-1,1,46,1
154,340,312,0,2,1,32,32,-1,1,61,0
154,225.00,263.33,0,4,0.50,32,32,-1,1,73,1
154,493,312,0,5,1,32,32,-1,1,84,1
154,476.06,265.18,0,3,0.75,32,32,-1,1,89,1
154,399,312,0,6,0.50,32,32,-1,1,94,1
154,278,312,0,7,0.50,32,32,-1,1,99,1
154,75.50,8,0,8,0.75,32,32,-1,1,109,1
154,128.50,7.78,0,9,1.50,32,32,-1,1,119,1
154,8,78,0,10,1,32,32,-1,1,125,1
154,160,118,0,11,2,32,32,-1,1,130,1
154,160,40,0,12,2,32,32,-1,1,140,1
154,131,144,0,13,2,32,32,-1,1,151,1
154,160,15,0,14,0.50,32,32,-1,1,160,1
154,232,136,0,15,5,32,32,-1,0,209,1
154,583,135.50,0,16,2.50,32,32,-1,1,220,1
158,16,328,0,0,16777215,0,1,0,1,22,0
210,200,8,0,0,270,0,0,0,1,154,0
210,0,52,0,154,270,0,0,0,1,146,0
210,596,328,0,49,0,0,0,0,1,48,0
210,16,152,0,146,0,0,0,0,1,144,0
216,87,97,0,12,0,0,0,0,1,374,0
210,540,224,0,0,180,0,0,0,1,306,0
210,468,224,0,306,0,0,0,0,1,305,0
216,215,175,0,6,0,0,0,0,1,376,0
210,485,224,0,306,0,0,0,0,1,342,0
216,347,302,0,71,0,0,0,0,1,375,0
210,208,80,0,0,180,0,0,0,1,49,0
157,79,344,0,32,32,0,0,0,1,34,0
157,16,344,0,32,32,0,0,0,1,2,0
157,48,344,0,32,32,0,0,0,1,3,0
157,111,344,0,32,32,0,0,0,1,4,0
157,143,344,0,32,32,0,0,0,1,5,0
157,175,344,0,32,32,0,0,0,1,6,0
157,207,344,0,32,32,0,0,0,1,7,0
157,238,344,0,32,32,0,0,0,1,8,0
157,270,344,0,32,32,0,0,0,1,9,0
157,302,344,0,32,32,0,0,0,1,10,0
157,334,344,0,32,32,0,0,0,1,11,0
157,366,344,0,32,32,0,0,0,1,12,0
157,398,344,0,32,32,0,0,0,1,13,0
157,424,344,0,176,32,0,0,0,1,14,0
157,512,344,0,32,32,0,0,0,1,17,0
157,544,344,0,32,32,0,0,0,1,18,0
157,576,344,0,32,32,0,0,0,1,19,0
157,608,344,0,32,32,0,0,0,1,20,0
157,632,344,0,32,32,0,0,0,1,21,0
157,48,312,0,32,32,0,0,0,1,24,0
157,48,280,0,32,32,0,0,0,1,25,0
157,144,280,0,32,32,0,0,0,1,26,0
157,144,312,0,32,32,0,0,0,1,27,0
157,640,48,0,32,32,0,0,0,1,38,0
157,568,48,0,48,32,0,0,0,1,39,0
157,624,136,0,32,32,0,0,0,1,54,0
157,343,280,0,56,16,0,0,0,1,77,0
157,80,216,0,32,32,0,0,0,1,102,0
157,112,216,0,32,32,0,0,0,1,103,0
157,16,168,0,32,32,0,0,0,1,104,0
157,184,80,0,32,32,0,0,0,1,132,0
157,184,16,0,32,32,0,0,0,1,133,0
157,184,48,0,32,32,0,0,0,1,134,0
157,184,112,0,32,32,0,0,0,1,135,0
157,184,144,0,32,32,0,0,0,1,136,0
157,16,64,0,32,8,0,0,0,1,145,0
157,28,49,0,8,40,0,0,0,1,156,0
157,216,78,0,48,8,0,0,0,1,197,0
157,144,198,0,32,8,0,0,0,1,283,0
157,236,209,0,152,32,0,0,0,1,284,0
157,416,209,0,88,32,0,0,0,1,285,0
157,509,209,0,32,32,0,0,0,1,292,0
157,509,114,0,32,160,0,0,0,1,294,0
157,453,145,0,16,32,0,0,0,1,303,0
157,567,267,0,32,128,0,0,0,1,304,0
157,80,248,0,32,32,0,0,0,1,336,0
157,319,248,0,8,48,0,0,0,1,343,0
157,367,248,0,8,48,0,0,0,1,345,0
157,328,152,0,8,8,0,0,0,1,346,0
157,360,152,0,8,8,0,0,0,1,347,0
157,400,37,0,336,8,0,0,0,1,358,0
157,534,129,0,48,192,0,0,0,1,359,0
157,360,189,0,8,8,0,0,0,1,367,0
157,344,209,0,64,32,0,0,0,1,282,0
169,536,1,0,0,0,0,0,0,1,40,1
155,584,72,0,1,1,0,0,0,1,44,0
155,584,143,0,2,1,0,0,0,1,45,0
155,178,312,0,1,2,0,0,0,1,59,0
155,344,312,0,2,2,0,0,0,1,60,0
155,190,263,0,1,4,0,0,0,1,71,0
155,296,264,0,2,4,0,0,0,1,72,0
155,408,312,0,1,5,0,0,0,1,82,0
155,504,312,0,2,5,0,0,0,1,83,0
155,417,271,0,1,3,0,0,0,1,87,0
155,488,264,0,2,3,0,0,0,1,88,0
155,376,312,0,1,6,0,0,0,1,92,0
155,488,312,0,2,6,0,0,0,1,93,0
155,256,312,0,1,7,0,0,0,1,97,0
155,312,312,0,2,7,0,0,0,1,98,0
155,8,8,0,1,8,0,0,0,1,107,0
155,160,8,0,2,8,0,0,0,1,108,0
155,19,7,0,1,9,0,0,0,1,117,0
155,160,8,0,2,9,0,0,0,1,118,0
155,8,72,0,1,10,0,0,0,1,123,0
155,8,120,0,2,10,0,0,0,1,124,0
155,160,8,0,1,11,0,0,0,1,128,0
155,160,144,0,2,11,0,0,0,1,129,0
155,160,32,0,1,12,0,0,0,1,138,0
155,160,112,0,2,12,0,0,0,1,139,0
155,88,144,0,1,13,0,0,0,1,149,0
155,161,144,0,2,13,0,0,0,1,150,0
155,160,8,0,1,14,0,0,0,1,158,0
155,160,128,0,2,14,0,0,0,1,159,0
155,232,136,0,1,15,0,0,0,1,207,0
155,232,192,0,2,15,0,0,0,1,208,0
155,583,73,0,1,16,0,0,0,1,218,0
155,583,143,0,2,16,0,0,0,1,219,0
169,445,161,0,0,0,0,0,0,1,290,1
172,460,192,0,0,0,0,0,0,1,297,1
172,461,129,0,0,0,0,0,0,1,301,1
172,376,72,0,0,0,0,0,0,0,323,1
166,584,89,0,46,0,0,0,0,1,42,1
166,74.75,8,0,109,0,270,0,0,1,105,1
166,130.00,7.79,0,119,151,270,0,0,1,116,1
166,8,77,0,125,130,0,0,0,1,121,1
166,160,38,0,140,0,180,0,0,1,142,1
166,160,14.50,0,160,0,180,0,0,1,162,1
166,583,138,0,220,0,0,0,0,1,222,1
166,109,0,0,0,0,270,0,0,1,234,1
166,128,0,0,0,0,270,0,0,1,235,1
166,379,49,0,0,0,270,0,0,0,245,0
166,397,49,0,0,0,270,0,0,0,286,1
166,487,174,0,0,0,180,0,0,1,296,1
166,168,56,0,0,0,215,0,0,0,337,1
166,488,60,0,0,0,180,0,0,0,361,1
255,240,64,0,100,100,1,0,0,1,363,0
1234567890
25,0,304,96,48,0,0,10002,0,0,0,0
25,0,304,96,48,96,0,10002,0,0,0,0
25,0,304,96,48,192,0,10002,0,0,0,0
25,0,304,96,48,-32,48,10002,0,0,0,0
25,0,304,96,48,64,48,10002,0,0,0,0
25,0,304,96,48,160,48,10002,0,0,0,0
25,0,304,96,48,256,48,10002,0,0,0,0
25,0,304,96,48,288,0,10002,0,0,0,0
25,0,304,96,48,352,48,10002,0,0,0,0
25,0,304,96,48,384,0,10002,0,0,0,0
25,0,304,96,48,448,48,10002,0,0,0,0
25,0,304,96,48,480,0,10002,0,0,0,0
25,0,304,96,48,544,48,10002,0,0,0,0
25,0,304,96,48,576,0,10002,0,0,0,0
25,0,304,96,48,0,96,10002,0,0,0,0
25,0,304,96,48,96,96,10002,0,0,0,0
25,0,304,96,48,192,96,10002,0,0,0,0
25,0,304,96,48,288,96,10002,0,0,0,0
25,0,304,96,48,384,96,10002,0,0,0,0
25,0,304,96,48,480,96,10002,0,0,0,0
25,0,304,96,48,576,96,10002,0,0,0,0
25,0,304,96,48,608,144,10002,0,0,0,0
25,0,304,96,48,512,144,10002,0,0,0,0
25,0,304,96,48,416,144,10002,0,0,0,0
25,0,304,96,48,320,144,10002,0,0,0,0
25,0,304,96,48,224,144,10002,0,0,0,0
25,0,304,96,48,128,144,10002,0,0,0,0
25,0,304,96,48,32,144,10002,0,0,0,0
25,0,304,96,48,0,192,10002,0,0,0,0
25,0,304,96,48,96,192,10002,0,0,0,0
25,0,304,96,48,192,192,10002,0,0,0,0
25,0,304,96,48,288,192,10002,0,0,0,0
25,0,304,96,48,384,192,10002,0,0,0,0
25,0,304,96,48,480,192,10002,0,0,0,0
25,0,304,96,48,576,192,10002,0,0,0,0
25,0,304,96,48,560,240,10002,0,0,0,0
25,0,304,96,48,464,240,10002,0,0,0,0
25,0,304,96,48,368,240,10002,0,0,0,0
25,0,304,96,48,272,240,10002,0,0,0,0
25,0,304,96,48,176,240,10002,0,0,0,0
25,0,304,96,48,80,240,10002,0,0,0,0
25,0,304,96,48,-16,240,10002,0,0,0,0
25,0,304,96,48,0,288,10002,0,0,0,0
25,0,304,96,48,96,288,10002,0,0,0,0
25,0,304,96,48,192,288,10002,0,0,0,0
25,0,304,96,48,288,288,10002,0,0,0,0
25,0,304,96,48,384,288,10002,0,0,0,0
25,0,304,96,48,480,288,10002,0,0,0,0
25,0,304,96,48,576,288,10002,0,0,0,0
25,0,304,96,48,592,336,10002,0,0,0,0
25,0,304,96,48,496,336,10002,0,0,0,0
25,0,304,96,48,400,336,10002,0,0,0,0
25,0,304,96,48,304,336,10002,0,0,0,0
25,0,304,96,48,208,336,10002,0,0,0,0
25,0,304,96,48,112,336,10002,0,0,0,0
25,0,304,96,48,16,336,10002,0,0,0,0
25,0,304,48,48,-16,144,10002,0,0,0,0
25,0,304,48,48,-32,336,10002,0,0,0,0
24,496,192,64,32,576,64,10000,0,0,0,0
24,496,192,64,32,112,0,10000,0,0,0,0
24,512,224,32,64,48,32,10000,0,0,0,0
24,528,64,32,32,144,160,10000,0,0,0,0
24,496,64,32,32,0,128,10000,0,0,0,0
24,464,192,32,16,32,256,10000,0,0,0,0
24,256,144,32,32,240,256,10000,0,0,0,0
24,256,144,32,32,432,256,10000,0,0,0,0
24,256,144,32,32,272,112,10000,0,0,0,0
24,256,144,32,32,384,64,10000,0,0,0,0
24,112,320,48,32,592,272,10000,0,0,0,0
24,320,192,32,32,608,240,10000,0,0,0,0
24,384,48,16,16,288,320,10000,0,0,0,0
24,368,48,16,16,288,288,10000,0,0,0,0
24,336,64,16,16,288,272,10000,0,0,0,0
24,352,48,16,16,304,272,10000,0,0,0,0
24,384,48,16,16,304,256,10000,0,0,0,0
24,384,48,16,16,304,240,10000,0,0,0,0
24,384,48,16,16,304,224,10000,0,0,0,0
24,384,48,16,16,416,288,10000,0,0,0,0
24,384,48,16,16,416,272,10000,0,0,0,0
24,384,48,16,16,416,256,10000,0,0,0,0
24,384,48,16,16,416,240,10000,0,0,0,0
24,384,48,16,16,416,224,10000,0,0,0,0
24,64,320,48,32,320,304,10000,0,0,0,0
24,0,256,64,32,256,160,10000,0,0,0,0
24,0,192,32,32,384,128,10000,0,0,0,0
24,0,160,32,32,144,304,10000,0,0,0,0
24,336,80,48,16,256,304,10000,0,0,0,0
24,368,64,16,16,240,304,10000,0,0,0,0
24,368,64,16,16,224,304,10000,0,0,0,0
24,368,64,16,16,208,304,10000,0,0,0,0
24,368,64,16,16,192,304,10000,0,0,0,0
24,336,48,16,16,176,304,10000,0,0,0,0
24,368,48,16,16,176,288,10000,0,0,0,0
24,368,48,16,16,176,272,10000,0,0,0,0
24,368,48,16,16,176,256,10000,0,0,0,0
24,352,64,16,16,176,240,10000,0,0,0,0
24,384,64,16,16,160,240,10000,0,0,0,0
24,384,64,16,16,144,240,10000,0,0,0,0
24,384,64,16,16,128,240,10000,0,0,0,0
24,384,64,16,16,112,240,10000,0,0,0,0
24,384,64,16,16,96,240,10000,0,0,0,0
24,384,64,16,16,48,240,10000,0,0,0,0
24,384,64,16,16,32,240,10000,0,0,0,0
24,384,64,16,16,16,240,10000,0,0,0,0
24,384,64,16,16,0,240,10000,0,0,0,0
24,160,320,48,32,16,208,10000,0,0,0,0
24,336,48,16,16,416,304,10000,0,0,0,0
24,352,64,16,16,432,304,10000,0,0,0,0
24,368,48,16,16,432,320,10000,0,0,0,0
24,496,32,64,32,480,304,10000,0,0,0,0
24,496,192,64,32,208,224,10000,0,0,0,0
987654321
IR0kQgYjUz0/
EwAjEUAyXChmLg==
DhtqA0A2XyBpJ2hacg==
Owd

