UVx6TlN0AGU9Z0RaIFNrdncZTxQeUmAOSSknVA59PFli
259,456,261,0,96,32,0,0,0,1,232,0
259,416,304,0,8,90,0,0,0,1,297,0
259,464,304,0,8,90,0,0,0,1,298,0
259,512,304,0,8,90,0,0,0,1,299,0
259,384,304,0,8,90,0,0,0,1,300,0
259,456,264,0,110,10,0,0,0,1,311,0
160,597,88,0,0,16777215,0,0,0,1,61,0
100,568,136,0,256,8421504,0,228,0,1,375,0
100,160,248,0,256,8421504,0,355,0,1,374,0
100,16,72,0,256,8421504,0,325,0,1,373,0
185,32,128,0,0,32,1,0,0,1,131,0
185,24,80,0,0,32,1,0,0,1,132,0
185,16,184,0,0,32,1,0,0,1,133,0
185,24,280,0,0,32,1,0,0,1,135,0
185,248,336,0,0,32,1,0,0,1,137,0
185,160,328,0,0,32,1,0,0,1,138,0
185,200,312,0,0,32,1,0,0,1,139,0
185,296,320,0,0,32,1,0,0,1,140,0
185,408,328,0,0,32,1,0,0,1,144,0
185,456,328,0,0,32,1,0,0,1,145,0
185,504,328,0,0,32,1,0,0,1,146,0
185,608,216,0,0,32,1,0,0,1,150,0
185,608,176,0,0,32,1,0,0,1,151,0
185,600,136,0,0,32,1,0,0,1,152,0
185,136,120,0,0,32,1,0,0,1,159,0
185,24,232,0,0,32,1,0,0,1,161,0
185,56,232,0,0,32,1,0,0,1,167,0
185,88,223,0,0,32,1,0,0,1,168,0
185,184,112,0,0,32,1,0,0,1,169,0
185,208,72,0,0,32,1,0,0,1,170,0
185,264,192,0,0,32,1,0,0,1,173,0
185,128,232,0,0,48,1,0,0,1,181,0
185,168,216,0,0,32,1,0,0,1,182,0
185,152,48,0,0,64,1,0,0,1,201,0
185,296,128,0,0,64,1,0,0,1,202,0
185,96,8,0,0,16,1,0,0,1,203,0
185,240,104,0,0,32,1,0,0,1,210,0
185,48,160,0,0,16,1,0,0,1,211,0
185,216,136,0,0,16,1,0,0,1,212,0
185,352,307,0,0,64,1,0,0,1,215,0
185,528,111,0,0,48,1,0,0,1,237,0
185,128,232,0,0,16,1,0,0,1,240,0
185,296,128,0,0,48,1,0,0,1,241,0
185,296,128,0,0,32,1,0,0,1,242,0
185,296,128,0,0,16,1,0,0,1,243,0
185,152,48,0,0,48,1,0,0,1,244,0
185,152,48,0,0,16,1,0,0,1,245,0
185,528,296,0,0,16,1,0,0,1,248,0
185,352,168,0,0,16,1,0,0,1,249,0
185,32,128,0,0,16,1,0,0,1,250,0
185,216,336,0,0,16,1,0,0,1,253,0
185,376,136,0,0,32,1,0,0,1,258,0
185,568,144,0,0,16,1,0,0,1,272,0
185,64,352,0,0,64,1,0,0,1,285,0
185,128,336,0,0,16,1,0,0,1,286,0
185,568,232,0,0,32,1,0,0,1,293,0
185,311,24,0,0,48,1,0,0,1,315,0
185,256,64,0,0,32,1,0,0,1,316,0
185,312,24,0,0,32,1,0,0,1,318,0
185,256,64,0,0,16,1,0,0,1,319,0
185,184,112,0,0,16,1,0,0,1,320,0
185,472,88,0,0,16,1,0,0,1,329,0
185,368,64,0,0,48,1,0,0,1,333,0
185,368,64,0,0,16,1,0,0,1,334,0
185,413,333,0,0,32,1,0,0,1,366,0
185,413,333,0,0,32,1,0,0,1,367,0
185,616,8,0,0,32,1,0,0,1,376,0
185,584,0,0,0,16,1,0,0,1,377,0
185,368,0,0,0,32,1,0,0,1,378,0
154,57.16,211.26,0,1,0.50,50,32,1,1,165,1
154,97.50,280,0,2,0.50,56,32,1,1,178,1
154,399.67,96.61,0,3,0.50,16,20,1,1,305,1
158,32,32,0,0,16777215,0,1,0,1,14,0
157,392,261,0,32,32,0,0,0,1,221,0
157,520,261,0,32,32,0,0,0,1,227,0
157,552,261,0,32,32,0,0,0,1,228,0
157,584,296,0,96,96,0,0,0,1,263,0
157,624,280,0,96,96,0,0,0,1,264,0
157,624,344,0,96,96,0,0,0,1,265,0
157,488,88,0,32,32,0,0,0,1,325,0
157,576,112,0,32,32,0,0,0,1,342,0
157,616,112,0,32,32,0,0,0,1,343,0
157,592,112,0,32,32,0,0,0,1,347,0
157,544,112,0,32,32,0,0,0,1,348,0
157,0,48,0,32,32,1,0,0,1,12,0
157,0,16,0,32,32,1,0,0,1,15,0
157,0,80,0,32,32,1,0,0,1,16,0
157,0,112,0,32,32,1,0,0,1,17,0
157,0,144,0,32,32,1,0,0,1,18,0
157,0,176,0,32,32,1,0,0,1,19,0
157,0,208,0,32,32,1,0,0,1,20,0
157,32,48,0,32,32,1,0,0,1,59,0
157,640,80,0,32,32,1,0,0,1,28,0
157,640,112,0,32,32,1,0,0,1,29,0
157,640,144,0,32,32,1,0,0,1,30,0
157,640,168,0,32,32,1,0,0,1,31,0
157,640,200,0,32,32,1,0,0,1,32,0
157,640,232,0,32,32,1,0,0,1,33,0
157,640,264,0,32,32,1,0,0,1,34,0
157,640,16,0,32,32,1,0,0,1,26,0
157,640,48,0,32,32,1,0,0,1,27,0
157,640,288,0,32,32,1,0,0,1,35,0
157,640,320,0,32,32,1,0,0,1,36,0
157,640,352,0,32,32,1,0,0,1,37,0
157,224,360,0,32,32,1,0,0,1,45,0
157,256,360,0,32,32,1,0,0,1,46,0
157,288,360,0,32,32,1,0,0,1,47,0
157,320,360,0,32,32,1,0,0,1,48,0
157,344,360,0,32,32,1,0,0,1,49,0
157,376,360,0,32,32,1,0,0,1,50,0
157,408,360,0,32,32,1,0,0,1,51,0
157,440,360,0,32,32,1,0,0,1,52,0
157,472,360,0,32,32,1,0,0,1,53,0
157,504,360,0,32,32,1,0,0,1,54,0
157,536,360,0,32,32,1,0,0,1,55,0
157,568,360,0,32,32,1,0,0,1,56,0
157,600,360,0,32,32,1,0,0,1,57,0
157,624,360,0,32,32,1,0,0,1,58,0
157,192,360,0,32,32,1,0,0,1,44,0
157,0,240,0,32,32,1,0,0,1,21,0
157,0,272,0,32,32,1,0,0,1,22,0
157,0,304,0,32,32,1,0,0,1,23,0
157,0,336,0,32,32,1,0,0,1,24,0
157,0,360,0,32,32,1,0,0,1,25,0
157,32,360,0,32,32,1,0,0,1,39,0
157,64,360,0,32,32,1,0,0,1,40,0
157,96,360,0,32,32,1,0,0,1,41,0
157,128,360,0,32,32,1,0,0,1,42,0
157,160,360,0,32,32,1,0,0,1,43,0
155,24,216,0,1,1,0,0,0,1,163,0
155,248,184,0,2,1,0,0,0,1,164,0
155,64,280,0,1,2,0,0,0,1,176,0
155,304,280,0,2,2,0,0,0,1,177,0
155,392,64,0,1,3,0,0,0,1,303,0
155,456,336,0,2,3,0,0,0,1,304,0
255,632,144,0,128,128,1,0,0,1,358,0
255,240,16,0,128,128,1,0,0,1,359,0
255,288,72,0,128,128,1,0,0,1,360,0
255,176,8,0,128,128,1,0,0,1,361,0
255,16,344,0,128,128,1,0,0,1,362,0
255,280,344,0,128,128,1,0,0,1,364,0
255,392,344,0,128,128,1,0,0,1,365,0
255,536,344,0,128,128,1,0,0,1,368,0
255,152,344,0,128,128,1,0,0,1,369,0
255,0,216,0,128,128,1,0,0,1,370,0
255,0,104,0,128,128,1,0,0,1,372,0
253,488,72,0,16777215,0,0,0,0,1,195,0
253,40,32,0,16777215,0,0,0,0,1,197,0
253,24,32,0,16777215,0,0,0,0,1,198,0
253,536,244,0,16777215,0,0,0,0,1,267,0
253,392,244,0,16777215,0,0,0,0,1,269,0
253,544,96,0,16777215,0,0,0,0,1,352,0
253,576,96,0,16777215,0,0,0,0,1,353,0
253,608,96,0,16777215,0,0,0,0,1,354,0
1234567890
25,272,0,64,144,16,0,10002,0,0,0,0
25,272,0,64,144,80,0,10002,0,0,0,0
25,272,0,64,144,144,0,10002,0,0,0,0
25,272,0,64,144,208,0,10002,0,0,0,0
25,272,0,64,144,272,0,10002,0,0,0,0
25,272,0,64,144,336,0,10002,0,0,0,0
25,272,0,64,144,400,0,10002,0,0,0,0
25,272,0,64,144,464,0,10002,0,0,0,0
25,272,0,64,144,528,0,10002,0,0,0,0
25,272,0,64,144,592,0,10002,0,0,0,0
25,272,0,64,144,0,144,10002,0,0,0,0
25,272,0,64,144,64,144,10002,0,0,0,0
25,272,0,64,144,128,144,10002,0,0,0,0
25,272,0,64,144,192,144,10002,0,0,0,0
25,272,0,64,144,256,144,10002,0,0,0,0
25,272,0,64,144,320,144,10002,0,0,0,0
25,272,0,64,144,384,144,10002,0,0,0,0
25,272,0,64,144,448,144,10002,0,0,0,0
25,272,0,64,144,512,144,10002,0,0,0,0
25,272,0,64,144,576,144,10002,0,0,0,0
25,272,0,64,144,48,288,10002,0,0,0,0
25,272,0,64,144,112,288,10002,0,0,0,0
25,272,0,64,144,176,288,10002,0,0,0,0
25,272,0,64,144,240,288,10002,0,0,0,0
25,272,0,64,144,304,288,10002,0,0,0,0
25,272,0,64,144,368,288,10002,0,0,0,0
25,272,0,64,144,432,288,10002,0,0,0,0
25,272,0,64,144,496,288,10002,0,0,0,0
25,272,0,64,144,560,288,10002,0,0,0,0
25,272,0,64,144,624,288,10002,0,0,0,0
25,272,0,48,144,0,288,10002,0,0,0,0
987654321
Lhw5GiY=
Lhw5GiY=
Lhw5GiY=
Lhw5GiY=

