UVx6TldyBGU9Z09PJ19CKVUlcEFBUhJLHnB+VA99PFliZml8NTgheng=
259,160,208,0,320,96,0,0,0,1,455,0
259,152,320,0,304,144,0,0,0,1,471,0
259,136,552,0,304,304,0,0,0,1,475,0
259,464,608,0,352,192,0,0,0,1,478,0
259,472,320,0,336,384,0,0,0,1,480,0
160,568,120,0,0,16777215,0,0,0,1,389,0
195,320,24,0,0,100,270,0,27,1,19,0
100,144,160,0,256,0,0,270,0,1,78,0
100,208,408,0,608,8454143,0,270,0,1,198,0
100,520,368,0,604,0,0,270,0,1,629,0
100,584,224,0,464,0,0,270,0,1,529,0
100,408,368,0,604,0,0,270,0,1,532,0
100,16,280,0,688,0,0,0,0,1,160,0
100,416,168,0,532,0,0,270,0,1,347,0
123,72,120,0,52,0,0,0,0,1,39,0
100,360,16,0,548,0,0,327,0,1,395,0
100,256,16,0,544,0,0,270,0,1,13,0
123,448,568,0,160,0,0,0,0,1,583,0
197,592,624,0,2,480,0,0,0,1,426,0
197,392,304,0,2,0,0,0,0,1,427,0
197,256,144,0,2,455,0,0,0,1,425,0
174,32,512,0,1,225,0,0,0,0,230,0
174,120,456,0,1,218,0,0,0,0,209,0
174,240,688,0,1,278,0,0,0,0,277,1
174,216,688,0,1,278,0,0,0,0,276,1
174,192,688,0,1,280,0,0,0,0,275,1
174,272,544,0,1,207,0,0,0,0,199,0
174,64,296,0,1,52,84,0,0,1,85,0
174,280,688,0,1,300,0,0,0,0,567,1
174,448,352,0,1,360,0,0,0,0,349,1
174,392,208,0,1,343,0,0,0,0,352,1
174,608,688,0,1,283,583,0,0,0,285,1
174,128,80,0,1,16,456,0,0,0,14,0
205,72,592,0,1,0,0.50,0,0,1,228,0
194,608,232,0,0,128,270,0,0,1,365,0
181,536,536,0,0,252,270,0,0,1,297,0
181,360,536,0,0,248,270,0,0,1,294,0
189,434,32,0,419,128,270,0,0,1,413,0
205,96.50,144,0,1,0,0.50,0,0,1,10,0
205,418.50,304,0,1,0,0.50,0,0,1,340,0
189,280,416,0,0,168,230,0,0,1,210,0
205,367.50,496,0,1,0,0.50,0,0,1,326,0
189,616,24,0,0,140,270,423,0,1,414,0
186,496,208,0,32,32,0,0,0,1,353,0
219,496,312,0,32,16,0,0,0,1,356,1
186,56,456,0,32,32,0,0,0,1,203,0
219,56,560,0,16,64,0,0,0,1,225,0
219,160,552,0,32,16,0,0,0,1,207,0
219,264,664,0,16,48,0,0,0,1,202,1
188,96,592,0,0,232,0,0,0,1,233,0
188,384,592,0,0,145,0,0,0,1,282,0
188,496,352,0,0,106,363,0,0,1,354,0
188,288,248,0,0,114,0,0,0,1,98,0
188,400,352,0,0,84,0,0,0,1,393,0
185,32,376,0,151,16,1,0,0,1,131,0
185,32,328,0,136,16,1,0,0,1,191,0
185,128,624,0,250,16,1,0,0,1,253,0
185,64,624,0,238,16,1,0,0,1,241,0
185,96,624,0,245,16,1,0,0,1,252,0
242,544,336,0,32,32,0,0,0,1,392,0
242,32,280,0,32,32,0,0,0,1,177,0
242,376,112,0,32,32,0,0,0,1,410,0
176,128,280,0,136,32,32,0,0,1,144,0
176,160,280,0,151,32,32,0,0,1,184,0
176,64,280,0,52,32,32,0,0,1,89,0
176,288,280,0,480,32,32,0,0,1,483,0
176,32,248,0,0,32,32,0,0,1,472,0
176,192,200,0,65,32,32,0,0,1,54,0
176,144,232,0,60,32,32,0,0,1,79,0
176,32,216,0,52,32,32,0,0,1,83,0
175,152,424,0,211,80,1,0,0,0,218,0
273,240,624,0,202,2,0,0,0,1,278,0
175,504,272,0,368,120,1,0,0,1,369,0
154,64,224,0,1,4,32,48,1,0,60,0
154,240,224,0,2,2,32,48,1,0,65,0
154,216,56,0,3,0.50,48,16,1,0,114,1
154,32,328,0,4,2.50,16,32,-1,0,136,1
154,32,376,0,5,0.20,16,32,-1,0,151,1
154,64,624,0,6,0.50,16,32,-1,0,238,1
154,96,624,0,7,0.75,16,32,-1,0,245,1
154,128,624,0,8,0.50,16,32,-1,0,250,1
154,328,632,0,9,0.75,32,16,1,0,300,1
154,336,384.50,0,10,0.50,32,16,1,1,331,0
154,608,389,0,11,0.50,32,16,1,1,375,0
154,446,32,0,12,0.50,16,32,-1,1,419,1
154,520,105,0,13,0.50,16,32,-1,1,423,1
210,16,448,0,0,270,0,0,0,1,205,0
210,16,432,0,0,270,0,0,0,1,204,0
210,152,624,0,565,0,0,0,0,1,562,0
210,168,624,0,564,0,0,0,0,1,563,0
210,392,512,0,0,180,0,0,0,1,564,0
210,376,512,0,0,180,0,0,0,1,565,0
210,304,240,0,0,90,0,0,0,1,100,0
210,304,224,0,0,90,0,0,0,1,102,0
210,264,592,0,205,0,0,0,0,1,274,0
210,280,592,0,204,0,0,0,0,1,273,0
210,0,120,0,102,270,0,0,0,1,99,0
210,0,136,0,100,270,0,0,0,1,101,0
158,56,48,0,0,16777215,0,1,0,1,6,0
157,360,264,0,16,208,0,0,0,1,335,0
157,8,416,0,16,544,0,0,0,1,3,0
157,296,352,0,16,112,0,0,0,1,124,0
157,232,336,0,16,48,0,0,0,1,168,0
157,472,328,0,16,48,0,0,0,1,338,0
157,464,360,0,192,16,0,0,0,1,337,0
157,176,368,0,32,48,0,0,0,1,130,0
157,64,352,0,96,16,0,0,0,1,120,0
157,120,336,0,16,48,0,0,0,1,499,0
157,520,328,0,16,48,0,0,0,1,357,0
157,632,352,0,16,672,0,0,0,1,4,0
157,400,312,0,64,16,0,0,0,1,342,0
157,176,304,0,128,16,0,0,0,1,123,0
157,48,304,0,64,16,0,0,0,1,45,0
157,312,304,0,16,16,0,0,0,1,484,0
157,280,304,0,16,16,0,0,0,1,599,0
157,152,256,0,208,16,0,0,0,1,41,0
157,440,264,0,16,16,0,0,0,1,350,0
157,264,208,0,16,112,0,0,0,1,40,0
157,312,208,0,16,112,0,0,0,1,97,0
157,280,256,0,48,16,0,0,0,1,96,0
157,584,208,0,16,112,0,0,0,1,366,0
157,384,216,0,32,16,0,0,0,1,348,0
157,472,192,0,16,64,0,0,0,1,358,0
157,520,192,0,16,64,0,0,0,1,359,0
157,112,152,0,192,16,0,0,0,1,9,0
157,248,184,0,16,16,0,0,0,1,614,0
157,256,152,0,32,16,0,0,0,1,17,0
157,464,144,0,320,32,0,0,0,1,18,0
157,80,64,0,16,96,0,0,0,1,7,0
157,64,104,0,16,16,0,0,0,1,8,0
157,352,56,0,16,80,0,0,0,1,29,0
157,376,88,0,32,16,0,0,0,1,409,0
157,440,88,0,16,16,0,0,0,1,411,0
157,152,136,0,16,16,0,0,0,1,15,0
157,128,88,0,16,16,0,0,0,1,11,0
157,25,104,0,16,16,0,0,0,1,105,0
157,8,64,0,16,96,0,0,0,1,104,0
157,320,8,0,640,16,0,0,0,1,38,0
157,56,56,0,32,16,0,0,0,1,5,0
157,202,400,0,176,16,0,0,0,1,129,0
157,48,400,0,64,16,0,0,0,1,132,0
157,296,520,0,16,240,0,0,0,1,196,0
157,80,464,0,128,16,0,0,0,1,192,0
157,328,456,0,48,16,0,0,0,1,367,0
157,136,512,0,16,96,0,0,0,1,193,0
157,352,504,0,96,16,0,0,0,1,325,0
157,384,600,0,16,16,0,0,0,1,584,0
157,320,696,0,640,16,0,0,0,1,2,0
157,232,552,0,112,16,0,0,0,1,195,0
157,184,584,0,16,48,0,0,0,1,208,0
157,40,520,0,48,16,0,0,0,1,229,0
157,96,600,0,96,16,0,0,0,1,226,0
157,256,496,0,32,16,0,0,0,1,197,0
157,96,552,0,16,16,0,0,0,1,227,0
157,264,601,0,48,16,0,0,0,1,271,0
157,280,624,0,16,32,0,0,0,1,391,0
157,232,632,0,16,16,0,0,0,1,281,0
157,160,632,0,32,16,0,0,0,1,566,0
157,440,504,0,16,16,0,0,0,1,324,0
157,568,504,0,16,16,0,0,0,1,322,0
169,344,96,0,1,0,0,0,0,0,27,0
172,16,232,0,0,0,0,0,0,1,52,0
155,64,224,0,1,1,0,0,0,1,58,0
155,112,224,0,2,1,0,0,0,0,59,0
155,240,224,0,1,2,0,0,0,1,63,0
155,144,224,0,2,2,0,0,0,0,64,0
169,16,112,0,1,0,0,0,0,1,106,1
155,216,56,0,1,3,0,0,0,1,112,0
155,336,56,0,2,3,0,0,0,1,113,0
155,32,328,0,1,4,0,0,0,1,134,0
155,96,328,0,2,4,0,0,0,1,135,0
155,96,280,0,3,4,0,0,0,1,138,0
155,256,280,0,4,4,0,0,0,1,139,0
155,256,376,0,5,4,0,0,0,1,140,0
155,208,376,0,6,4,0,0,0,1,141,0
155,208,328,0,7,4,0,0,0,1,142,0
169,288,264,0,0,0,0,0,0,1,145,1
155,32,376,0,1,5,0,0,0,1,149,0
155,112,376,0,2,5,0,0,0,0,150,0
155,144,328,0,8,4,0,0,0,1,153,0
155,144,376,0,9,4,0,0,0,1,169,0
155,64,624,0,1,6,0,0,0,1,236,0
155,64,672,0,2,6,0,0,0,1,237,0
155,96,624,0,1,7,0,0,0,1,243,0
155,96,672,0,2,7,0,0,0,1,244,0
155,128,624,0,1,8,0,0,0,1,248,0
155,128,672,0,2,8,0,0,0,1,249,0
172,144,592,0,0,0,0,0,0,1,283,1
155,328,632,0,1,9,0,0,0,1,298,0
155,544,632,0,2,9,0,0,0,1,299,0
155,336,304,0,1,10,0,0,0,1,329,0
155,336,408,0,2,10,0,0,0,1,330,0
172,432,304,0,0,0,0,0,0,1,343,1
172,480,208,0,0,0,0,0,0,1,360,1
172,592,248,0,0,0,0,0,0,1,363,1
155,608,312,0,1,11,0,0,0,1,373,0
155,608,440,0,2,11,0,0,0,1,374,0
155,408,32,0,1,12,0,0,0,1,417,0
155,480,32,0,2,12,0,0,0,1,418,0
155,520,24,0,1,13,0,0,0,1,421,0
155,520,120,0,2,13,0,0,0,1,422,0
172,208,144,0,0,0,0,0,0,1,456,1
169,240,408,0,0,0,0,0,0,0,211,0
166,184,19,0,0,0,270,0,0,1,16,0
166,200,160,0,0,0,270,0,0,0,84,1
166,56,472,0,0,0,271,0,0,1,232,0
166,16,680,0,0,0,0,0,0,0,280,1
166,368,328,0,0,0,0,0,0,1,339,1
166,440,160,0,0,0,270,0,0,1,368,0
157,503,504,0,16,16,0,0,0,1,323,0
157,616,568,0,16,16,0,0,0,1,312,0
157,616,504,0,16,16,0,0,0,1,311,0
157,616,537,0,16,16,0,0,0,1,313,0
157,592,632,0,64,16,0,0,0,1,302,0
242,320,432,0,32,32,0,0,0,1,582,0
242,96,440,0,32,32,0,0,0,1,200,0
242,96,528,0,32,32,0,0,0,1,514,0
242,240,672,0,32,32,0,0,0,1,390,0
176,32,608,0,238,32,32,0,0,1,255,0
176,568,480,0,478,32,32,0,0,1,482,0
176,592,608,0,475,32,32,0,0,1,474,0
176,32,640,0,245,32,32,0,0,1,256,0
176,272,672,0,478,32,32,0,0,1,479,0
176,32,672,0,250,32,32,0,0,1,257,0
1234567890
25,272,176,224,80,16,16,10002,0,0,0,0
25,272,176,224,80,240,16,10002,0,0,0,0
25,272,176,224,80,464,16,10002,0,0,0,0
25,272,176,224,80,16,96,10002,0,0,0,0
25,272,176,224,80,240,96,10002,0,0,0,0
25,272,176,224,80,464,96,10002,0,0,0,0
25,272,176,224,80,16,176,10002,0,0,0,0
25,272,176,224,80,240,176,10002,0,0,0,0
25,272,176,224,80,464,176,10002,0,0,0,0
25,272,176,224,80,16,256,10002,0,0,0,0
25,272,176,224,80,240,256,10002,0,0,0,0
25,272,176,224,80,464,256,10002,0,0,0,0
25,272,176,224,80,16,336,10002,0,0,0,0
25,272,176,224,80,240,336,10002,0,0,0,0
25,272,176,224,80,464,336,10002,0,0,0,0
25,272,176,224,80,16,416,10002,0,0,0,0
25,272,176,224,80,240,416,10002,0,0,0,0
25,272,176,224,80,464,416,10002,0,0,0,0
25,272,176,224,80,16,496,10002,0,0,0,0
25,272,176,224,80,240,496,10002,0,0,0,0
25,272,176,224,80,464,496,10002,0,0,0,0
25,272,176,224,80,16,576,10002,0,0,0,0
25,272,176,224,80,240,576,10002,0,0,0,0
25,272,176,224,80,464,576,10002,0,0,0,0
25,272,176,224,80,16,656,10002,0,0,0,0
25,272,176,224,80,240,656,10002,0,0,0,0
25,272,176,224,80,464,656,10002,0,0,0,0
25,272,176,176,16,0,0,10002,0,0,0,0
25,272,176,176,16,176,0,10002,0,0,0,0
25,272,176,176,16,352,0,10002,0,0,0,0
25,272,176,176,16,528,0,10002,0,0,0,0
25,272,176,16,80,0,16,10002,0,0,0,0
25,272,176,16,80,0,96,10002,0,0,0,0
25,272,176,16,80,0,176,10002,0,0,0,0
25,272,176,16,80,0,256,10002,0,0,0,0
25,272,176,16,80,0,336,10002,0,0,0,0
25,272,176,16,80,0,416,10002,0,0,0,0
25,272,176,16,80,0,496,10002,0,0,0,0
25,272,176,16,80,0,576,10002,0,0,0,0
25,272,176,16,80,0,656,10002,0,0,0,0
987654321
Bg==
BQ==
BA==
Aw=

