UVx6TlN0AGU9Z2pLPmxfP1NgT0pPDgJNFmg7SBJhIEV+enVgKSQ9Zg==
259,600,176,0,80,128,0,0,0,1,43,0
259,336,176,0,448,128,0,0,0,1,44,0
259,56,176,0,112,128,0,0,0,1,84,0
259,352,40,0,576,80,0,0,0,1,187,0
259,320,312,0,640,96,0,0,0,1,188,0
259,32,8,0,64,16,0,0,0,1,202,0
259,24,80,0,48,64,0,0,0,1,203,0
160,608,240,0,0,16777088,0,0,0,1,39,0
123,434,176,0,188,255,0,0,0,1,89,0
123,112,120,0,24,16711935,70,0,0,1,195,0
123,560,232,0,24,16711935,76,0,0,1,191,0
123,80,224,0,24,255,0,0,0,1,30,0
100,24,112,0,256,0,0,268,0,1,34,0
100,80,112,0,256,0,0,268,0,1,29,0
123,192,176,0,132,255,0,0,0,1,88,0
197,80,240,0,3,18,0,0,0,1,25,0
193,72,328,0,0,94,96,107,0,1,95,1
193,104,360,0,0,74,75,80,81,1,96,1
193,104,304,0,0,68,69,78,79,1,94,1
193,128,328,0,0,79,80,110,0,0,108,1
193,184,312,0,0,58,72,115,0,1,114,1
193,232,360,0,0,120,79,80,144,1,122,1
193,232,304,0,0,58,72,126,160,0,116,1
193,264,320,0,0,78,74,133,0,0,123,1
193,320,312,0,0,58,72,136,0,1,129,1
193,360,312,0,0,74,138,0,0,1,137,1
193,448,312,0,0,72,165,0,0,0,154,1
193,528,320,0,0,58,168,0,0,0,166,1
193,561,306,0,0,37,172,180,0,1,171,1
193,402,306,0,0,80,157,0,0,0,139,1
193,8,88,0,1,44,0,0,0,0,201,1
193,40,48,0,0,18,85,93,0,0,83,1
219,200,160,0,16,80,0,0,0,1,45,1
219,488,160,0,16,80,0,0,0,1,48,1
219,352,160,0,16,80,0,0,0,1,49,1
219,200,200,0,32,16,0,0,0,1,51,1
219,352,200,0,32,16,0,0,0,1,54,1
219,344,160,0,16,32,0,0,0,1,100,1
219,208,160,0,16,32,0,0,0,1,102,1
219,488,128,0,32,16,0,0,0,1,104,1
185,176,24,0,182,64,1,0,0,1,178,0
176,144,176,0,83,32,128,0,0,1,82,0
289,80,48,0,84,0,0,0,0,1,85,0
175,40,320,0,95,120,0,0,0,0,92,0
289,8,320,0,92,0,0,0,0,1,93,0
175,104,312,0,108,120,0,0,0,0,107,0
175,160,304,0,114,220,0,0,0,0,109,0
289,144,344,0,109,0,0,0,0,1,110,0
175,201,339,0,116,256,0,0,0,0,115,0
175,264,344,0,123,60,0,0,0,0,120,0
289,232,312,0,122,0,0,0,0,1,126,0
175,306,330,0,129,180,0,0,0,0,130,0
289,296,296,0,130,0,0,0,0,1,133,0
175,352,328,0,137,60,0,0,0,0,136,0
175,387,322,0,139,60,0,0,0,0,138,0
175,456,336,0,154,200,0,0,0,0,153,0
289,424,324,0,153,0,0,0,0,1,157,0
289,210,308,0,142,0,0,0,0,1,160,0
175,496,304,0,166,80,0,0,0,0,163,0
289,495,330,0,163,0,0,0,0,1,165,0
175,563,329,0,171,200,0,0,0,0,167,0
289,536,338,0,167,0,0,0,0,1,168,0
289,600,296,0,43,0,0,0,0,1,172,0
154,112,120,0,1,0.50,16,16,-1,1,70,1
154,560,232,0,2,0.50,16,16,-1,1,76,1
154,120,112,0,3,0.20,16,16,-1,1,146,1
154,176,24,0,4,0.50,32,32,-1,1,182,1
158,24,240,0,1,16777215,0,1,0,1,21,0
157,320,256,0,640,32,0,0,0,1,15,0
157,104,160,0,16,96,0,0,0,1,24,0
157,32,168,0,16,16,0,0,0,1,28,0
157,48,128,0,16,16,0,0,0,1,33,0
157,344,96,0,592,32,0,0,0,1,35,0
157,568,160,0,16,96,0,0,0,1,36,0
157,272,176,0,32,16,0,0,0,1,149,0
157,269,128,0,32,16,0,0,0,1,150,0
157,424,216,0,32,16,0,0,0,1,164,0
157,440,108,0,16,16,0,0,0,1,175,0
157,8,96,0,16,16,0,0,0,1,198,0
157,32,32,0,64,32,0,0,0,1,199,0
157,56,64,0,16,32,0,0,0,1,200,0
169,96,208,0,0,0,0,0,0,1,18,1
169,560,208,0,0,0,0,0,0,1,37,1
155,112,120,0,1,1,0,0,0,0,68,0
155,112,160,0,2,1,0,0,0,0,69,0
155,560,232,0,1,2,0,0,0,0,74,0
155,560,200,0,2,2,0,0,0,0,75,0
155,112,200,0,3,1,0,0,0,0,78,0
155,112,233,0,4,1,0,0,0,0,79,0
155,560,160,0,3,2,0,0,0,0,80,0
155,560,120,0,4,2,0,0,0,0,81,0
155,120,112,0,1,3,0,0,0,0,144,0
155,432,112,0,2,3,0,0,0,1,145,0
155,176,24,0,1,4,0,0,0,0,180,0
155,176,184,0,2,4,0,0,0,1,181,0
155,496,184,0,3,4,0,0,0,1,184,0
166,112,120,0,70,0,0,0,0,0,58,0
166,560,232,0,76,0,180,0,0,0,72,1
166,120,112,0,146,0,270,0,0,0,142,1
1234567890
25,176,176,80,80,0,96,10002,0,0,0,0
25,176,176,80,80,0,176,10002,0,0,0,0
25,176,176,80,80,80,176,10002,0,0,0,0
25,176,176,80,80,80,96,10002,0,0,0,0
25,176,176,80,80,160,80,10002,0,0,0,0
25,176,176,80,80,160,160,10002,0,0,0,0
25,176,176,80,80,240,192,10002,0,0,0,0
25,176,176,80,80,240,112,10002,0,0,0,0
25,176,176,80,80,320,96,10002,0,0,0,0
25,176,176,80,80,320,176,10002,0,0,0,0
25,176,176,80,80,400,176,10002,0,0,0,0
25,176,176,80,80,400,96,10002,0,0,0,0
25,176,176,80,80,480,96,10002,0,0,0,0
25,176,176,80,80,480,176,10002,0,0,0,0
25,176,176,80,80,560,192,10002,0,0,0,0
25,176,176,80,80,560,112,10002,0,0,0,0
24,128,192,16,32,144,160,10000,0,0,0,0
24,144,224,16,16,240,208,10000,0,0,0,0
24,128,160,32,32,384,144,10000,0,0,0,0
24,0,192,32,32,432,176,10000,0,0,0,0
24,464,208,32,16,128,224,10000,0,0,0,0
24,416,160,16,16,48,208,10000,0,0,0,0
24,384,16,16,32,80,176,10000,0,0,0,0
24,432,32,32,16,48,192,10000,0,0,0,0
24,432,48,32,16,48,176,10000,0,0,0,0
24,496,224,16,64,112,128,10000,0,0,0,0
24,544,224,16,64,544,112,10000,0,0,0,0
24,0,288,32,32,256,176,10000,0,0,0,0
24,80,176,32,16,256,144,10000,0,0,0,0
24,272,112,16,16,192,144,10000,0,0,0,0
24,272,112,16,16,192,128,10000,0,0,0,0
24,272,112,16,16,192,112,10000,0,0,0,0
24,272,112,16,16,192,160,10000,0,0,0,0
24,272,112,16,16,192,176,10000,0,0,0,0
24,304,112,16,32,192,192,10000,0,0,0,0
24,304,112,16,32,480,192,10000,0,0,0,0
24,304,112,16,16,480,176,10000,0,0,0,0
24,304,112,16,16,480,160,10000,0,0,0,0
24,304,112,16,16,480,144,10000,0,0,0,0
24,304,112,16,16,480,128,10000,0,0,0,0
24,304,112,16,16,480,112,10000,0,0,0,0
24,0,160,32,32,528,208,10000,0,0,0,0
24,368,16,16,16,32,192,10000,0,0,0,0
987654321
Lk8nQgFiVyxgIHQOGn8NPUE1O09GEXBOEG5yCx4lY1UiJjgpJXNwOy0g

