UVx6TlN0AGU9Z0lbMAdhP0IpdwpqCzMOSSknVA59PFliZml8NQ==
259,255,88,0,208,185,0,0,0,1,402,0
259,464,88,0,224,135,0,0,0,1,416,0
259,448,192,0,208,75,0,0,0,1,417,0
259,448,296,0,208,135,0,0,0,1,418,0
259,175,255,0,320,160,0,0,0,1,419,0
160,72,240,0,0,16777215,0,0,0,1,271,0
100,408,72,0,256,0,0,323,0,1,152,0
100,248,264,0,256,0,0,209,0,1,321,0
123,448,280,0,85,0,0,0,0,1,304,0
100,360,192,0,256,255,0,0,0,1,256,0
100,128,128,0,256,16744448,0,180,0,1,31,0
100,328,136,0,256,0,0,115,0,1,37,0
197,304,208,0,2,0,0,0,0,1,272,0
197,240,80,0,4,195,0,0,0,1,173,0
174,456,328,0,1,330,0,0,0,0,335,1
174,96,144,0,1,38,0,0,0,0,107,1
174,320,48,0,1,171,169,38,0,0,155,1
205,432.50,328,0,1,0,0.50,0,0,1,318,0
181,72,120,0,0,128,0,0,0,1,119,0
181,160,232,0,0,128,270,0,0,1,343,0
205,287.50,80,0,1,0,0.50,0,0,1,36,0
186,264,328,0,32,32,0,0,0,1,342,0
188,448,144,0,0,209,0,0,0,1,208,0
188,154,72,0,270,177,0,0,0,1,154,0
242,440,208,0,32,32,0,0,0,1,265,0
210,400,48,0,0,270,0,0,0,1,198,0
210,512,328,0,320,0,0,0,0,1,319,0
210,376,328,0,324,0,0,0,0,1,322,0
210,440,328,0,0,0,0,0,0,1,324,0
210,320,312,0,0,90,0,0,0,1,320,0
158,88,85,0,0,8454143,0,1,0,1,27,0
216,32,304,0,40,0,0,0,0,1,430,0
216,56,304,0,43,0,0,0,0,1,432,0
216,72,304,0,30,0,0,0,0,1,433,0
216,96,304,0,30,0,0,0,0,1,436,0
216,88,312,0,47,0,0,0,0,1,435,0
210,256,176,0,198,0,0,0,0,1,197,0
157,616,184,0,112,448,0,0,0,1,382,0
157,288,344,0,32,32,0,0,0,1,284,0
157,256,344,0,32,32,0,0,0,1,286,0
157,320,344,0,32,32,0,0,0,1,285,0
157,224,344,0,32,32,0,0,0,1,281,0
157,192,344,0,32,32,0,0,0,1,282,0
157,160,344,0,32,32,0,0,0,1,283,0
157,128,344,0,32,32,0,0,0,1,297,0
157,96,344,0,32,32,0,0,0,1,293,0
157,64,344,0,32,32,0,0,0,1,294,0
157,64,344,0,32,32,0,0,0,1,295,0
157,32,344,0,32,32,0,0,0,1,351,0
157,32,344,0,32,32,0,0,0,1,352,0
157,0,288,0,32,32,0,0,0,1,298,0
157,0,312,0,32,32,0,0,0,1,299,0
157,112,256,0,32,32,0,0,0,1,302,0
157,80,256,0,32,32,0,0,0,1,301,0
157,48,256,0,32,32,0,0,0,1,300,0
157,16,256,0,32,32,0,0,0,1,291,0
157,416,344,0,32,32,0,0,0,1,243,0
157,448,344,0,32,32,0,0,0,1,275,0
157,512,344,0,32,32,0,0,0,1,279,0
157,544,344,0,32,32,0,0,0,1,278,0
157,480,344,0,32,32,0,0,0,1,274,0
157,384,344,0,32,32,0,0,0,1,276,0
157,352,344,0,32,32,0,0,0,1,222,0
157,0,344,0,32,32,0,0,0,1,292,0
157,544,312,0,32,32,0,0,0,1,287,0
157,544,288,0,32,32,0,0,0,1,241,0
157,480,312,0,32,32,0,0,0,1,313,0
157,480,304,0,32,32,0,0,0,1,334,0
157,544,256,0,32,32,0,0,0,1,277,0
157,336,320,0,32,32,0,0,0,1,310,0
157,336,304,0,32,32,0,0,0,1,311,0
157,336,272,0,32,32,0,0,0,1,303,0
157,112,160,0,32,32,0,0,0,1,21,0
157,80,160,0,32,32,0,0,0,1,16,0
157,48,160,0,32,32,0,0,0,1,9,0
157,336,192,0,32,32,0,0,0,1,233,0
157,416,160,0,32,32,0,0,0,1,190,0
157,384,160,0,32,32,0,0,0,1,183,0
157,352,160,0,32,32,0,0,0,1,149,0
157,208,224,0,32,32,0,0,0,1,280,0
157,192,224,0,32,32,0,0,0,1,333,0
157,512,240,0,32,32,0,0,0,1,239,0
157,480,240,0,32,32,0,0,0,1,225,0
157,448,240,0,32,32,0,0,0,1,232,0
157,416,240,0,32,32,0,0,0,1,242,0
157,384,240,0,32,32,0,0,0,1,238,0
157,336,240,0,32,32,0,0,0,1,234,0
157,544,224,0,32,32,0,0,0,1,224,0
157,544,192,0,32,32,0,0,0,1,226,0
157,336,224,0,32,32,0,0,0,1,240,0
157,544,160,0,32,32,0,0,0,1,181,0
157,480,160,0,32,32,0,0,0,1,187,0
157,448,160,0,32,32,0,0,0,1,188,0
157,16,224,0,32,32,0,0,0,1,296,0
157,16,192,0,32,32,0,0,0,1,290,0
157,304,224,0,32,32,0,0,0,1,236,0
157,272,224,0,32,32,0,0,0,1,235,0
157,240,224,0,32,32,0,0,0,1,237,0
157,168,160,0,32,32,0,0,0,1,185,0
157,144,160,0,32,32,0,0,0,1,22,0
157,16,160,0,32,32,0,0,0,1,12,0
157,288,160,0,32,32,0,0,0,1,146,0
157,320,160,0,32,32,0,0,0,1,148,0
157,256,184,0,32,16,0,0,0,1,131,0
157,224,160,0,32,32,0,0,0,1,395,0
157,192,160,0,32,32,0,0,0,1,17,0
157,352,128,0,32,32,0,0,0,1,144,0
157,384,112,0,32,32,0,0,0,1,132,0
157,368,112,0,32,32,0,0,0,1,141,0
157,384,80,0,32,32,0,0,0,1,189,0
157,368,80,0,32,32,0,0,0,1,145,0
157,384,48,0,32,32,0,0,0,1,193,0
157,368,48,0,32,32,0,0,0,1,139,0
157,296,96,0,32,32,0,0,0,1,24,0
157,264,96,0,32,32,0,0,0,1,134,0
157,168,96,0,32,32,0,0,0,1,8,0
157,176,32,0,96,32,0,0,0,1,143,0
157,232,96,0,32,32,0,0,0,1,135,0
157,320,48,0,32,8,0,0,0,1,138,0
157,288,32,0,32,32,0,0,0,1,140,0
157,256,32,0,32,32,0,0,0,1,124,0
157,224,32,0,32,32,0,0,0,1,11,0
157,208,32,0,32,32,0,0,0,1,122,0
157,416,16,0,32,32,0,0,0,1,213,0
157,384,16,0,32,32,0,0,0,1,184,0
157,368,16,0,32,32,0,0,0,1,142,0
157,168,16,0,32,32,0,0,0,1,192,0
157,32,128,0,32,32,0,0,0,1,14,0
157,16,128,0,32,32,0,0,0,1,129,0
157,16,104,0,32,32,0,0,0,1,123,0
157,96,96,0,32,24,0,0,0,1,7,0
157,80,96,0,32,24,0,0,0,1,5,0
157,32,96,0,32,32,0,0,0,1,29,0
157,544,128,0,32,32,0,0,0,1,182,0
157,544,96,0,32,32,0,0,0,1,186,0
157,552,72,0,32,32,0,0,0,1,223,0
157,544,48,0,32,32,0,0,0,1,216,0
157,544,32,0,32,32,0,0,0,1,212,0
157,144,96,0,32,32,0,0,0,1,15,0
157,144,64,0,24,32,0,0,0,1,6,0
157,32,72,0,32,32,0,0,0,1,13,0
157,32,48,0,32,32,0,0,0,1,127,0
157,0,72,0,32,32,0,0,0,1,128,0
157,0,40,0,32,32,0,0,0,1,121,0
157,32,24,0,32,32,0,0,0,1,4,0
157,512,16,0,32,32,0,0,0,1,211,0
157,544,16,0,32,32,0,0,0,1,359,0
157,480,16,0,32,32,0,0,0,1,215,0
157,448,16,0,32,32,0,0,0,1,214,0
157,288,0,0,176,32,0,0,0,1,136,0
157,256,8,0,32,32,0,0,0,1,147,0
157,224,8,0,32,32,0,0,0,1,194,0
157,192,8,0,32,32,0,0,0,1,191,0
157,144,0,0,32,32,0,0,0,1,18,0
157,112,0,0,32,32,0,0,0,1,2,0
157,80,0,0,32,32,0,0,0,1,125,0
157,48,0,0,32,32,0,0,0,1,126,0
157,16,8,0,32,32,0,0,0,1,10,0
157,136,48,0,16,72,0,0,0,1,409,0
169,136,112,0,0,0,0,0,0,1,38,0
169,216,48,0,0,0,0,0,0,1,169,0
169,248,48,0,0,0,0,0,0,1,171,0
172,184,80,0,0,0,0,0,0,0,177,0
172,240,144,0,0,0,0,0,0,1,195,1
172,496,144,0,0,0,0,0,0,1,209,1
169,464,256,0,0,0,0,0,0,1,330,1
166,368,128,0,0,0,273,0,0,1,443,1
1234567890
25,560,208,32,32,576,304,10002,0,0,0,0
25,560,144,32,80,592,192,10002,0,0,0,0
25,192,96,80,112,192,336,10002,0,0,0,0
25,80,16,16,16,80,16,10002,0,0,0,0
25,80,16,16,16,64,32,10002,0,0,0,0
25,80,16,16,16,64,16,10002,0,0,0,0
25,80,16,16,16,48,16,10002,0,0,0,0
25,80,16,16,16,80,32,10002,0,0,0,0
25,80,16,16,16,96,16,10002,0,0,0,0
25,80,16,16,16,112,16,10002,0,0,0,0
25,80,16,16,16,80,48,10002,0,0,0,0
25,80,16,16,16,96,48,10002,0,0,0,0
25,80,16,16,16,128,64,10002,0,0,0,0
25,80,16,16,16,64,64,10002,0,0,0,0
25,80,16,16,16,48,96,10002,0,0,0,0
25,80,16,16,16,48,80,10002,0,0,0,0
25,80,16,16,16,48,64,10002,0,0,0,0
25,80,16,16,16,48,48,10002,0,0,0,0
25,80,16,16,16,48,32,10002,0,0,0,0
25,80,16,16,16,64,48,10002,0,0,0,0
25,80,16,16,16,80,64,10002,0,0,0,0
25,80,16,16,16,96,64,10002,0,0,0,0
25,80,16,16,16,96,80,10002,0,0,0,0
25,80,16,16,16,112,96,10002,0,0,0,0
25,80,16,16,16,128,96,10002,0,0,0,0
25,80,16,16,16,112,80,10002,0,0,0,0
25,80,16,16,16,112,64,10002,0,0,0,0
25,80,16,16,16,112,48,10002,0,0,0,0
25,80,16,16,16,112,32,10002,0,0,0,0
25,80,16,16,16,96,32,10002,0,0,0,0
987654321
M08=
Ihs=
KgcpCgU=
XUE=

