UVx6TlN0AGU9Z19bIEABG0E4blVAOiJHGGg7SBJhIEV+enVgKSQ9Zg==
259,481,280,0,320,144,0,0,0,1,69,0
259,480,176,0,128,32,0,0,0,1,245,0
259,112,280,0,256,176,0,0,0,1,309,0
160,272,336,0,1,33023,0,0,0,1,31,0
123,544,24,0,68,0,0,0,0,1,83,0
100,472,24,0,320,0,0,204,0,1,272,0
123,24,176,0,228,0,0,0,0,1,12,0
195,104,24,0,0,220,285,0,47,1,57,0
123,272,264,0,180,0,0,0,0,1,74,0
100,471,264,0,416,0,182,0,182,0,303,0
100,416,176,0,644,0,0,0,0,1,221,0
197,360,336,0,2,262,0,0,0,1,94,0
174,64,336,0,1,110,111,174,0,0,108,1
174,544,64,0,1,165,169,199,208,0,200,1
174,416,64,0,1,117,102,121,125,0,116,1
174,608,336,0,1,303,188,125,0,0,183,1
174,208,192,0,1,85,88,87,47,0,66,1
174,312,192,0,1,263,69,85,0,0,264,1
189,471,264,0,0,140,351,0,0,1,182,0
205,438.50,192,0,-1,0,0.50,0,0,0,193,0
219,144,136,0,160,16,0,0,0,1,42,1
186,576,192,0,32,32,0,0,0,1,186,0
219,296,72,0,112,16,0,0,0,1,102,1
219,232,40,0,16,48,0,0,0,1,117,1
219,568,40,0,16,48,0,0,0,1,169,1
220,32,136,0,32,16,0,0,0,0,165,1
188,184,193,0,0,178,0,0,0,1,61,0
188,464,192,0,0,226,0,0,0,1,225,0
188,624,152,0,90,223,165,278,291,1,222,0
188,392,192,0,0,76,0,0,0,1,72,0
242,24,168,0,48,48,0,0,0,0,174,0
242,544,40,0,32,48,0,0,0,0,199,0
242,432,112,0,32,32,0,0,0,0,278,0
242,352,208,0,64,32,0,0,0,1,284,0
176,480,112,0,193,32,32,0,0,1,246,0
176,480,112,0,245,32,32,0,0,1,255,0
176,160,56,0,309,128,80,0,0,1,315,0
154,107,200,0,1,0.50,16,16,1,1,51,1
154,368,72,0,2,0.50,32,16,1,0,121,1
154,232,136,0,3,0.50,16,16,1,0,208,1
158,24,64,0,0,16777215,0,1,0,1,13,0
210,312,16,0,97,180,0,0,0,1,100,0
210,216,336,0,148,0,0,0,0,1,144,0
210,200,336,0,146,0,0,0,0,1,145,0
210,24,0,0,156,180,0,0,0,1,161,0
210,616,64,0,161,0,0,0,0,1,156,0
210,600,64,0,160,0,0,0,0,1,153,0
210,520,16,0,144,180,0,0,0,1,148,0
210,72,64,0,100,0,0,0,0,1,97,0
210,56,64,0,99,0,0,0,0,1,98,0
210,8,0,0,153,180,0,0,0,1,160,0
210,296,16,0,98,180,0,0,0,1,99,0
210,464,104,0,217,270,0,0,0,1,218,0
210,448,104,0,218,90,0,0,0,1,217,0
210,632,240,0,194,0,0,0,0,1,191,0
210,448,120,0,219,90,0,0,0,1,216,0
210,504,16,0,145,180,0,0,0,1,146,0
210,568,96,0,0,180,0,0,0,1,194,0
210,464,120,0,216,270,0,0,0,1,219,0
157,40,72,0,80,16,0,0,0,1,11,0
157,24,208,0,48,32,0,0,0,1,18,0
157,248,8,0,304,16,0,0,0,1,33,0
157,184,208,0,80,32,0,0,0,1,44,0
157,232,264,0,16,144,0,0,0,1,45,0
157,88,40,0,16,80,0,0,0,1,58,0
157,232,144,0,16,32,0,0,0,1,65,0
157,320,352,0,640,32,0,0,0,1,67,0
157,408,248,0,16,80,0,0,0,1,71,0
157,408,160,0,16,64,0,0,0,1,73,0
157,312,264,0,16,144,0,0,0,1,43,0
157,56,136,0,16,16,0,0,0,1,113,0
157,64,344,0,32,16,0,0,0,1,133,0
157,520,8,0,240,16,0,0,0,1,147,0
157,496,80,0,288,32,0,0,0,1,149,0
157,632,40,0,16,48,0,0,0,1,154,0
157,488,200,0,208,16,0,0,0,1,187,0
157,632,152,0,16,112,0,0,0,1,190,0
157,8,112,0,16,64,0,0,0,1,210,0
157,480,144,0,128,32,0,0,0,1,220,0
157,232,96,0,16,64,0,0,0,1,238,0
157,456,112,0,16,32,0,0,0,1,253,0
157,488,40,0,16,48,0,0,0,1,254,0
157,632,288,0,16,96,0,0,0,1,297,0
155,56,200,0,1,1,0,0,0,1,49,0
155,136,200,0,2,1,0,0,0,1,50,0
172,384,176,0,0,0,0,0,0,0,76,1
169,224,160,0,0,0,0,0,0,1,85,1
172,272,192,0,0,0,0,0,0,0,87,1
172,240,192,0,1,0,0,0,0,0,88,1
155,368,72,0,1,2,0,0,0,1,119,0
155,240,72,0,2,2,0,0,0,1,120,0
172,592,192,0,0,0,0,0,0,1,188,1
155,232,136,0,1,3,0,0,0,1,206,0
155,408,136,0,2,3,0,0,0,1,207,0
169,528,160,0,0,0,0,0,0,0,223,1
166,88,88,0,0,0,293,0,0,0,47,1
166,152,336,0,0,51,351,0,0,1,110,1
166,224,96,0,0,0,225,0,0,1,111,1
166,392,168,0,0,0,174,0,0,0,125,1
166,8,152,0,0,0,355,0,0,0,178,1
166,408,296,0,0,0,270,0,0,1,226,1
166,240,216,0,0,0,0,0,0,1,262,1
166,376,200,0,0,0,180,0,0,1,263,1
166,224,248,0,0,0,180,0,0,0,291,1
1234567890
24,208,304,16,16,176,176,10000,0,0,0,0
24,208,304,16,16,176,160,10000,0,0,0,0
24,208,304,16,16,176,128,10000,0,0,0,0
24,208,304,16,16,192,128,10000,0,0,0,0
24,208,304,16,16,192,208,10000,0,0,0,0
24,208,304,16,16,192,176,10000,0,0,0,0
24,208,304,16,16,192,160,10000,0,0,0,0
24,208,304,16,16,208,160,10000,0,0,0,0
24,208,304,16,16,208,176,10000,0,0,0,0
24,208,304,16,16,224,208,10000,0,0,0,0
24,64,16,64,16,32,96,10000,0,0,0,0
24,352,80,16,16,256,48,10000,0,0,0,0
24,352,80,16,16,240,48,10000,0,0,0,0
24,352,80,16,16,224,48,10000,0,0,0,0
24,352,80,16,16,208,48,10000,0,0,0,0
24,352,80,16,16,192,48,10000,0,0,0,0
24,352,80,16,16,176,48,10000,0,0,0,0
24,384,80,16,16,144,48,10000,0,0,0,0
24,352,80,16,16,160,48,10000,0,0,0,0
24,320,64,16,16,144,32,10000,0,0,0,0
24,320,64,16,16,144,16,10000,0,0,0,0
24,336,48,16,16,144,64,10000,0,0,0,0
24,352,64,16,16,160,64,10000,0,0,0,0
24,320,64,16,16,160,80,10000,0,0,0,0
24,320,64,16,16,160,96,10000,0,0,0,0
24,320,64,16,16,160,112,10000,0,0,0,0
24,320,64,16,16,160,128,10000,0,0,0,0
24,336,48,16,16,160,144,10000,0,0,0,0
24,352,80,16,16,176,144,10000,0,0,0,0
24,352,80,16,16,208,144,10000,0,0,0,0
24,352,80,16,16,192,144,10000,0,0,0,0
24,16,224,16,16,48,192,10000,0,0,0,0
24,0,224,16,16,128,192,10000,0,0,0,0
24,80,208,16,16,64,192,10000,0,0,0,0
24,80,208,16,16,80,192,10000,0,0,0,0
24,80,208,16,16,96,192,10000,0,0,0,0
24,80,208,16,16,112,192,10000,0,0,0,0
24,0,160,32,32,0,304,10000,0,0,0,0
24,128,160,32,32,144,288,10000,0,0,0,0
24,320,240,48,16,176,224,10000,0,0,0,0
24,256,144,32,32,240,96,10000,0,0,0,0
24,128,160,32,32,400,304,10000,0,0,0,0
24,64,256,32,32,48,224,10000,0,0,0,0
24,432,208,16,16,464,112,10000,0,0,0,0
24,336,16,16,16,64,16,10000,0,0,0,0
24,336,16,16,16,48,16,10000,0,0,0,0
24,416,160,16,16,48,160,10000,0,0,0,0
24,96,288,64,32,512,96,10000,0,0,0,0
24,320,256,32,32,544,16,10000,0,0,0,0
24,432,160,32,32,560,288,10000,0,0,0,0
24,160,80,48,16,496,256,10000,0,0,0,0
987654321
Rw==

