UVx6TlN0AGU9Z09CMkhGCUMtdRRvGTFLFyknVA59PFliZml8NTgh
259,56,104,0,32,16,0,0,0,1,183,0
259,352,264,0,48,48,0,0,0,1,387,1
259,472,224,0,32,32,0,0,0,1,731,0
259,224,296,0,16,16,0,0,0,1,859,0
259,544,160,0,48,32,0,0,0,1,909,0
259,40,304,0,64,96,0,0,0,1,996,0
259,608,240,0,48,192,0,0,0,1,1015,0
259,176,336,0,208,32,0,0,0,1,1227,0
160,48,240,0,1,16777215,0,0,0,1,685,0
123,552,304,0,48,255,0,0,0,0,1296,0
224,448,200,0,108,0,0,0,0,1,1318,0
123,200,240,0,128,0,0,0,0,1,1248,0
100,408,32,0,416,0,0,270,0,1,1118,0
100,504,32,0,416,0,0,271,0,1,1147,0
100,120,192,0,256,0,1273,0,0,1,1275,0
100,24,112,0,440,0,0,348,0,1,1096,0
123,173,38,0,236,0,0,0,0,1,1116,0
100,312,112,0,440,0,0,192,0,1,1095,0
178,280,104,0,32,16,0,0,0,1,747,0
197,552,176,0,1.50,0,0,0,0,1,906,0
174,600,80,0,1,387,1053,0,0,0,371,0
174,392,320,0,1,457,471,1296,0,0,458,0
174,344,272,0,1,324,0,0,0,0,321,1
174,72,176,0,1,0,0,11,0,0,28,0
174,224,232,0,1,907,909,1334,0,0,910,0
174,56,96,0,1,170,105,174,183,0,173,0
205,368.50,128,0,1,0,0.50,0,0,1,216,0
181,504,216.50,0,314,128,0,0,0,1,622,0
219,336,64,0,16,64,0,0,0,1,143,1
186,312,96,0,32,32,0,0,0,1,144,0
219,504,184,0,32,16,0,0,0,1,320,1
186,40,304,0,32,32,0,0,0,1,933,0
220,464,256,0,112,32,0,0,0,0,700,0
220,408,160,0,64,32,0,0,0,0,639,0
188,584,219,0,270,403,430,374,489,1,415,0
188,264,304,0,0,828,858,0,0,1,810,0
188,584,280,0,270,503,0,0,0,1,504,0
188,624,169,0,180,540,487,639,376,1,542,0
188,336,224,0,0,123,114,117,115,1,142,0
188,224,192,0,180,934,0,0,0,1,931,0
188,40,328,0,0,911,955,976,0,1,936,0
188,352,224,0,0,58,0,0,0,1,762,0
188,412,128,0,0,252,0,0,0,1,251,0
188,320,96,0,0,747,0,0,0,1,746,0
188,602,218,0,90,572,715,0,0,1,557,0
185,112,80,0,72,16,1,0,0,1,59,0
185,152,80,0,76,16,1,0,0,1,93,0
185,192,80,0,80,16,1,0,0,1,125,0
185,232,80,0,123,16,1,0,0,1,134,0
242,280,80,0,32,32,0,0,0,0,58,0
242,56,160,0,32,32,0,0,0,0,174,0
242,344,160,0,32,32,0,0,0,1,349,0
242,360,304,0,32,32,0,0,0,1,670,0
242,264,288,0,32,32,0,0,0,1,843,0
242,80,160,0,32,32,0,0,0,0,976,0
242,296,160,0,32,32,0,0,0,0,1334,0
175,192,8,0,80,20,0,0,0,0,114,0
175,112,8,0,72,60,0,0,0,0,115,0
175,152,8,0,76,40,0,0,0,0,117,0
175,592,200,0,430,60,0,0,0,0,457,0
175,624,304,0,403,60,0,0,0,0,471,0
175,392,32,0,487,93,0,0,0,0,489,0
175,472,32,0,540,93,0,0,0,0,572,0
175,424,32,0,700,110,0,0,0,0,715,0
175,224,336,0,859,60,0,0,0,0,858,0
154,96,136,0,2,0.30,16,16,1,0,11,0
154,112,80,0,3,0.50,16,16,-1,0,72,0
154,152,80,0,4,0.50,16,16,-1,0,76,0
154,192,80,0,5,0.50,16,16,-1,0,80,0
154,232,80,0,1,0.50,16,16,-1,0,123,0
154,504,185.50,1,6,0.50,16,16,-1,1,314,1
154,552,328,0,7,0.50,32,16,1,0,403,0
154,592,328,0,8,0.50,16,16,1,0,430,0
154,392,280,0,9,0.50,32,16,1,0,487,0
154,624,280,0,10,0.50,16,16,1,0,540,0
154,89.02,217.02,0,14,0.25,16,16,-1,1,1273,1
158,40,176,0,1,16777215,0,1,0,1,24,0
210,232,264,0,0,270,0,0,0,1,522,0
210,232,280,0,0,270,0,0,0,1,523,0
210,616,104,0,522,90,0,0,0,1,521,0
210,616,120,0,523,90,0,0,0,1,520,0
157,192,184,0,272,16,0,0,0,1,16,0
157,168,104,0,192,16,0,0,0,1,25,0
157,16,168,0,16,144,0,0,0,1,29,0
157,320,120,0,16,48,0,0,0,1,104,0
157,320,224,0,16,64,0,0,0,1,152,0
157,368,200,0,16,48,0,0,0,1,153,0
157,352,232,0,48,16,0,0,0,1,154,0
157,304,104,0,16,16,0,0,0,1,162,0
157,32,104,0,16,16,0,0,0,1,172,0
157,16,64,0,16,64,0,0,0,1,184,0
157,320,24,0,624,16,0,0,0,1,185,0
157,368,152,0,16,48,0,0,0,1,204,0
157,416,136,0,80,16,0,0,0,1,205,0
157,568,136,0,96,16,0,0,0,1,207,0
157,432,208,0,48,64,0,0,0,1,310,0
157,464,280,0,112,16,0,0,0,1,326,0
157,528,256,0,16,64,0,0,0,1,327,0
157,552,184,0,64,16,0,0,0,1,373,0
157,576,264,0,16,144,0,0,0,1,400,0
157,432,336,0,208,32,0,0,0,1,444,0
157,624,112,0,16,64,0,0,0,1,518,0
157,592,88,0,48,16,0,0,0,1,519,0
157,472,192,0,32,32,0,0,0,1,730,0
157,624,56,0,16,48,0,0,0,1,777,0
157,304,304,0,48,96,0,0,0,1,811,0
157,176,312,0,208,16,0,0,0,1,812,0
157,224,264,0,16,48,0,0,0,1,813,0
157,576,160,0,16,32,0,0,0,1,905,0
157,128,232,0,16,80,0,0,0,1,913,0
157,80,272,0,16,64,0,0,0,1,914,0
157,40,248,0,64,16,0,0,0,1,932,0
157,40,336,0,32,16,0,0,0,1,937,0
157,584,344,0,96,16,0,0,0,1,1034,0
157,368,280,0,16,16,0,0,0,1,1206,0
155,96,136,0,1,2,0,0,0,1,9,0
155,240,136,0,2,2,0,0,0,1,10,0
155,112,80,0,1,3,0,0,0,1,70,0
155,112,48,0,2,3,0,0,0,1,71,0
155,152,80,0,1,4,0,0,0,1,74,0
155,152,48,0,2,4,0,0,0,1,75,0
155,192,80,0,1,5,0,0,0,1,78,0
155,192,48,0,2,5,0,0,0,1,79,0
169,312,144,0,0,0,0,0,0,1,105,0
155,232,80,0,1,1,0,0,0,1,121,0
155,232,48,0,2,1,0,0,0,1,122,0
172,40,96,0,0,0,0,0,0,1,170,0
155,504,160,0,1,6,0,0,0,1,312,0
155,504,256,0,2,6,0,0,0,1,313,0
155,392,256,0,3,6,0,0,0,1,316,0
155,392,160,0,4,6,0,0,0,1,317,0
172,328,272,0,0,0,0,0,0,1,324,0
169,520,192,0,0,0,0,0,0,1,374,0
169,568,96,0,0,0,0,0,0,1,376,0
155,552,328,0,1,7,0,0,0,1,401,0
155,552,232,0,2,7,0,0,0,1,402,0
155,592,328,0,1,8,0,0,0,1,428,0
155,592,232,0,2,8,0,0,0,1,429,0
155,392,280,0,1,9,0,0,0,1,485,0
155,392,184,0,2,9,0,0,0,1,486,0
155,624,280,0,1,10,0,0,0,1,538,0
155,624,184,0,2,10,0,0,0,1,539,0
169,520,144,0,0,0,0,0,0,1,907,1
169,120,272,0,0,0,0,0,0,1,911,0
172,24,304,0,0,0,0,0,0,1,934,0
172,24,176,0,0,0,0,0,0,1,955,0
169,360,240,0,0,0,0,0,0,1,1053,0
155,80,208,0,1,14,0,0,0,1,1271,0
155,104,232,0,2,14,0,0,0,1,1272,0
166,168,112,0,0,0,270,0,0,1,44,1
166,216,112,0,0,0,270,0,0,1,48,1
166,144,112,0,0,0,270,0,0,1,51,1
166,192,112,0,0,0,270,0,0,1,53,1
166,120,112,0,0,0,270,0,0,1,54,1
166,520,136,0,0,0,180,0,0,0,252,0
166,568,304,0,0,0,180,0,0,0,503,0
166,312,248,0,0,0,180,0,0,1,828,0
253,360,136,0,16777215,0,5,0,0,1,309,0
1234567890
25,0,48,144,48,16,32,10002,0,0,0,0
25,0,48,144,48,16,80,10002,0,0,0,0
25,0,48,144,48,16,128,10002,0,0,0,0
25,0,48,144,48,16,176,10002,0,0,0,0
25,0,48,144,48,16,224,10002,0,0,0,0
25,0,48,144,48,16,272,10002,0,0,0,0
25,0,48,144,48,160,32,10002,0,0,0,0
25,0,48,144,48,160,80,10002,0,0,0,0
25,0,48,144,48,160,128,10002,0,0,0,0
25,0,48,144,48,160,176,10002,0,0,0,0
25,0,48,144,48,160,224,10002,0,0,0,0
25,0,48,144,48,160,272,10002,0,0,0,0
25,0,48,144,48,304,32,10002,0,0,0,0
25,0,48,144,48,304,80,10002,0,0,0,0
25,0,48,144,48,304,128,10002,0,0,0,0
25,0,48,144,48,304,176,10002,0,0,0,0
25,0,48,144,48,304,224,10002,0,0,0,0
25,0,48,144,48,304,272,10002,0,0,0,0
25,0,48,144,48,448,272,10002,0,0,0,0
25,0,48,144,48,448,224,10002,0,0,0,0
25,0,48,144,48,448,176,10002,0,0,0,0
25,0,48,144,48,448,128,10002,0,0,0,0
25,0,48,144,48,448,80,10002,0,0,0,0
25,0,48,144,48,448,32,10002,0,0,0,0
25,0,48,144,48,592,32,10002,0,0,0,0
25,0,48,144,48,592,80,10002,0,0,0,0
25,0,48,144,48,592,128,10002,0,0,0,0
25,0,64,144,32,16,0,10002,0,0,0,0
25,0,64,144,32,160,0,10002,0,0,0,0
25,0,64,144,32,304,0,10002,0,0,0,0
25,0,64,144,32,448,0,10002,0,0,0,0
25,0,64,144,32,592,0,10002,0,0,0,0
25,128,48,16,48,0,0,10002,0,0,0,0
25,128,48,16,48,0,48,10002,0,0,0,0
25,128,48,16,48,0,96,10002,0,0,0,0
25,128,48,16,48,0,144,10002,0,0,0,0
25,128,48,16,48,0,192,10002,0,0,0,0
25,128,48,16,48,0,240,10002,0,0,0,0
25,128,48,16,48,0,288,10002,0,0,0,0
25,128,48,16,48,0,336,10002,0,0,0,0
25,0,48,144,48,16,320,10002,0,0,0,0
25,0,48,144,48,160,320,10002,0,0,0,0
25,0,48,144,48,304,320,10002,0,0,0,0
25,0,48,144,48,448,320,10002,0,0,0,0
25,0,48,144,48,592,320,10002,0,0,0,0
25,0,48,144,48,592,272,10002,0,0,0,0
25,0,48,144,48,592,224,10002,0,0,0,0
25,0,48,144,48,592,176,10002,0,0,0,0
987654321
MwAjEUArQ2loMi1MOkQ=

