UVx6TlN0AGU9Z1pjF3xMKFYpektaUgdvPSknVA59PFliZml8NTgh
160,616,336,0,0,16777215,0,0,0,1,239,0
100,152,264,0,252,0,0,328,0,1,17,0
123,320,56,0,128,0,0,0,0,0,216,0
100,56,136,0,360,0,0,270,0,0,158,0
100,176,136,0,256,0,0,270,0,1,183,0
123,280,280,0,200,0,0,0,0,0,192,0
100,160,0,0,164,0,0,270,0,1,230,0
100,64,0,0,256,0,0,270,0,1,229,0
197,120,344,0,3,25,0,0,0,1,6,0
197,272,168,0,2,151,0,0,0,1,150,0
197,24,112,0,5,249,0,0,0,1,228,0
197,280,344,0,2,31,0,0,0,1,24,0
197,16,248,0,8,54,0,0,0,1,60,0
197,152,88,0,4,203,0,0,0,1,227,0
174,232,344,0,1,35,191,0,0,0,36,1
174,208,344,0,1,31,191,0,0,0,33,1
174,456,64,0,1,0,208,210,0,0,213,1
194,160,72,0,0,128,0,0,0,1,199,0
205,288.50,248,0,1,0,0.50,0,0,1,99,0
189,336,272,0,0,128,270,0,0,1,26,0
189,272,272,0,0,124,227,0,0,1,19,0
189,8.50,136,0,0,152,0,0,0,1,267,0
194,160,48,0,0,128,0,0,0,1,200,0
219,624,280,0,80,32,0,0,0,1,240,0
219,368,304,0,32,80,0,0,0,1,25,0
219,568,8,0,32,64,0,0,0,1,249,1
188,312,344,0,0,35,0,0,0,1,43,0
188,320,96,0,0,216,0,0,0,1,217,0
188,248,168,0,0,129,158,168,240,1,145,0
242,408,216,0,32,32,0,0,0,1,163,0
242,424,48,0,32,32,0,0,0,1,285,0
273,216,280,0,15,0,0,0,0,1,31,0
273,248,280,0,42,0,0,0,0,1,35,0
273,304,280,0,192,0,0,0,0,1,191,0
154,504,312,0,1,0.50,32,32,1,0,54,0
158,16,344,0,0,16777215,0,1,0,1,3,0
210,144,240,0,110,270,0,0,0,1,107,0
210,232,144,0,108,270,0,0,0,1,109,0
210,144,224,0,109,270,0,0,0,1,108,0
210,232,160,0,107,270,0,0,0,1,110,0
157,184,256,0,352,16,0,0,0,1,14,0
157,176,352,0,352,16,0,0,0,1,2,0
157,80,328,0,16,32,0,0,0,1,4,0
157,96,320,0,16,32,0,0,0,1,5,0
157,144,320,0,16,32,0,0,0,1,7,0
157,160,328,0,16,32,0,0,0,1,8,0
157,104,256,0,16,32,0,0,0,1,9,0
157,120,256,0,16,32,0,0,0,1,10,0
157,136,256,0,16,32,0,0,0,1,11,0
157,464,352,0,352,16,0,0,0,1,23,0
157,376,248,0,32,32,0,0,0,1,45,0
157,400,248,0,32,32,0,0,0,1,46,0
157,472,312,0,32,32,0,0,0,1,47,0
157,536,312,0,32,32,0,0,0,1,49,0
157,432,248,0,32,32,0,0,0,1,50,0
157,568,184,0,32,288,0,0,0,1,51,0
157,472,80,0,32,32,0,0,0,1,61,0
157,440,80,0,32,32,0,0,0,1,62,0
157,408,80,0,32,32,0,0,0,1,63,0
157,432,144,0,32,96,0,0,0,1,66,0
157,376,216,0,32,32,0,0,0,1,67,0
157,376,184,0,32,32,0,0,0,1,68,0
157,408,120,0,32,32,0,0,0,1,69,0
157,368,120,0,32,32,0,0,0,1,70,0
157,344,120,0,32,32,0,0,0,1,71,0
157,328,120,0,32,32,0,0,0,1,72,0
157,328,152,0,32,32,0,0,0,1,73,0
157,328,184,0,32,32,0,0,0,1,74,0
157,424,152,0,32,32,0,0,0,1,75,0
157,424,184,0,32,32,0,0,0,1,76,0
157,432,184,0,32,32,0,0,0,1,77,0
157,392,120,0,32,32,0,0,0,1,78,0
157,400,112,0,32,32,0,0,0,1,79,0
157,368,112,0,32,32,0,0,0,1,80,0
157,336,112,0,32,32,0,0,0,1,81,0
157,312,112,0,32,32,0,0,0,1,82,0
157,0,264,0,32,32,0,0,0,1,83,0
157,360,120,0,32,32,0,0,0,1,84,0
157,392,120,0,32,32,0,0,0,1,85,0
157,352,248,0,32,32,0,0,0,1,88,0
157,328,248,0,32,32,0,0,0,1,89,0
157,176,120,0,352,16,0,0,0,1,90,0
157,264,184,0,32,32,0,0,0,1,100,0
157,240,184,0,32,32,0,0,0,1,101,0
157,216,144,0,32,32,0,0,0,1,102,0
157,216,176,0,32,32,0,0,0,1,103,0
157,216,184,0,32,32,0,0,0,1,104,0
157,128,232,0,32,32,0,0,0,1,131,0
157,128,136,0,32,32,0,0,0,1,132,0
157,128,136,0,32,32,0,0,0,1,156,0
157,128,88,0,32,112,0,0,0,1,201,0
157,160,104,0,32,32,0,0,0,1,202,0
157,192,8,0,32,32,0,0,0,1,212,0
157,192,104,0,32,32,0,0,0,1,214,0
157,192,176,0,16,16,0,0,0,1,258,0
157,576,328,0,16,32,0,0,0,1,276,0
172,104,304,0,0,0,0,0,0,1,15,0
155,504,312,0,1,1,200,0,0,1,52,0
155,504,80,0,2,1,0,0,0,1,53,0
169,128,184,0,1,0,0,0,0,1,129,0
169,152,216,0,0,0,0,0,0,1,151,1
169,128,152,0,0,0,0,0,0,1,168,1
169,128,0,0,0,0,0,0,0,1,203,1
169,176,56,0,1,0,0,0,0,1,208,1
169,176,24,0,0,0,0,0,0,1,210,1
166,560,336,0,0,0,180,0,0,0,42,1
1234567890
24,288,80,16,16,400,336,10000,0,0,0,0
24,288,80,16,16,400,320,10000,0,0,0,0
24,288,80,16,16,400,304,10000,0,0,0,0
24,464,192,16,16,96,224,10000,0,0,0,0
24,112,192,48,96,144,160,10000,0,0,0,0
24,112,192,48,96,0,160,10000,0,0,0,0
24,112,192,48,96,16,256,10000,0,0,0,0
24,112,192,48,96,496,192,10000,0,0,0,0
24,112,192,48,96,272,144,10000,0,0,0,0
24,16,160,64,32,576,304,10000,0,0,0,0
24,16,160,64,32,576,272,10000,0,0,0,0
24,0,160,32,32,80,80,10000,0,0,0,0
24,0,160,32,32,48,80,10000,0,0,0,0
24,0,160,32,32,144,64,10000,0,0,0,0
24,128,16,64,32,576,240,10000,0,0,0,0
24,128,16,64,32,576,192,10000,0,0,0,0
24,128,16,64,32,448,160,10000,0,0,0,0
24,128,16,64,32,240,80,10000,0,0,0,0
24,256,112,32,32,208,80,10000,0,0,0,0
25,272,176,224,80,0,272,10002,0,0,0,0
25,272,176,224,80,0,192,10002,0,0,0,0
25,272,176,224,80,0,112,10002,0,0,0,0
25,272,176,224,80,0,32,10002,0,0,0,0
25,272,176,224,80,224,272,10002,0,0,0,0
25,272,176,224,80,224,192,10002,0,0,0,0
25,272,176,224,80,224,112,10002,0,0,0,0
25,272,176,224,80,224,32,10002,0,0,0,0
25,272,176,224,80,448,32,10002,0,0,0,0
25,272,176,224,80,448,112,10002,0,0,0,0
25,272,176,224,80,448,192,10002,0,0,0,0
25,272,176,224,80,448,272,10002,0,0,0,0
25,272,224,224,32,0,0,10002,0,0,0,0
25,272,224,224,32,224,0,10002,0,0,0,0
25,272,224,224,32,448,0,10002,0,0,0,0
987654321
MCUOPTcjQitgKn5a

