UVx6TlN0AGU9Z2dePwdGI1glelYfUmAOSSknVA59PFliZmk=
160,176,256,0,0,16777215,0,0,0,1,31,0
195,160,280,0,0,172,0,0,0,1,22,0
224,256,304,0,128,0,0,0,0,1,23,0
218,288,192,0,256,0,0,0,0,1,10,0
218,379,148,0,256,0,0,0,0,1,53,0
197,440,256,0,2,0,0,0,0,1,12,0
197,424,256,0,2,0,0,0,0,1,62,0
197,200,264,0,2,0,0,0,0,1,58,0
197,200,264,0,2,0,0,0,0,1,80,0
197,200,264,0,2,0,0,0,0,1,78,0
197,200,264,0,2,0,0,0,0,1,79,0
197,200,264,0,2,0,0,0,0,1,84,0
197,200,264,0,2,0,0,0,0,1,83,0
197,200,264,0,2,0,0,0,0,1,85,0
197,200,264,0,2,0,0,0,0,1,86,0
174,456,256,0,1,0,0,0,0,0,59,1
181,168,328,0,0,128,0,0,0,1,20,0
189,432,296,0,0,128,0,0,0,1,9,0
194,608,64,0,0,128,0,0,0,1,65,0
194,168,312,0,0,160,0,0,0,1,6,0
205,344,272,0,1,0,0.50,0,0,1,87,0
205,536.50,256,0,1,0,0.50,0,0,1,46,0
205,327.50,264,0,1,0,0.50,0,0,1,33,0
205,503.50,280,0,1,0,0.50,0,0,1,3,0
205,495.50,280,0,1,0,0.50,0,0,1,29,0
186,408,280,0,32,32,0,0,0,1,8,0
186,592,304,0,32,32,0,0,0,1,19,0
186,152,184,0,32,32,0,0,0,1,27,0
219,232,288,0,32,32,0,0,0,1,36,1
186,176,184,0,32,32,0,0,0,1,45,0
219,272,288,0,32,32,0,0,0,1,47,1
186,592,304,0,32,32,0,0,0,1,74,0
219,496,264,0,32,32,0,0,0,1,75,1
188,408,280,0,0,0,0,0,0,1,14,0
188,566,311,0,0,0,0,0,0,1,76,0
188,496,280,0,0,0,0,0,0,1,77,0
185,376,288,0,0,32,1,0,0,1,11,0
185,231,141,0,0,64,1,0,0,1,30,0
185,560,136,0,0,64,1,0,0,1,54,0
185,560,136,0,0,16,1,0,0,1,55,0
185,232,272,0,0,16,1,0,0,1,57,0
179,352,280,0,0,32,32,0,0,1,63,0
273,640,96,0,0,0,0,0,0,1,67,0
158,200,263,0,0,65535,0,1,0,1,32,0
210,312,264,0,0,0,0,0,0,1,44,0
210,296,264,0,0,0,0,0,0,1,24,0
210,624,80,0,0,0,0,0,0,1,90,0
210,280,264,0,0,0,0,0,0,1,88,0
210,264,264,0,0,0,0,0,0,1,89,0
216,520,96,0,0,0,0,0,0,1,2,0
210,328,264,0,0,0,0,0,0,1,25,0
210,586,150,0,0,0,0,0,0,1,68,0
157,168,280,0,32,32,0,0,0,1,27,0
157,432,264,0,32,32,0,0,0,1,7,0
157,408,296,0,32,32,0,0,0,1,13,0
157,304,280,0,32,32,0,0,0,1,17,0
157,200,280,0,32,32,0,0,0,1,21,0
157,168,248,0,32,32,0,0,0,1,28,0
157,376,280,0,32,32,0,0,0,1,34,0
157,208,0,0,144,32,0,0,0,1,35,0
157,536,272,0,32,32,0,0,0,1,38,0
157,496,296,0,32,32,0,0,0,1,43,0
157,248,344,0,32,32,0,0,0,1,48,0
157,280,280,0,16,32,0,0,0,1,49,0
157,232,280,0,32,32,0,0,0,1,56,0
157,568,272,0,32,32,0,0,0,1,66,0
157,624,96,0,32,32,0,0,0,1,69,0
157,528,240,0,32,32,0,0,0,1,72,0
157,504,224,0,32,32,0,0,0,1,91,0
169,448,256,0,0,0,0,0,0,1,4,1
169,320,264,0,0,0,0,0,0,1,15,1
169,256,264,0,0,0,0,0,0,1,81,1
166,224,288,0,0,0,0,0,0,1,26,1
166,368,200,0,0,0,0,0,0,1,37,1
166,0,64,0,0,0,0,0,0,1,52,1
166,0,88,0,0,0,0,0,0,1,64,1
166,0,360,0,0,0,0,0,0,1,70,1
166,272,360,0,0,0,0,0,0,1,71,1
237,320,0,0,16777215,300,0,0,0,1,18,0
255,520,304,0,128,128,1,0,0,1,73,0
253,438,125,0,16777215,0,0,0,0,1,92,0
1234567890
24,496,0,64,352,512,112,10000,0,0,0,0
24,0,320,192,32,176,80,10000,0,0,0,0
24,0,160,128,32,176,48,10000,0,0,0,0
24,0,160,128,32,304,48,10000,0,0,0,0
24,112,288,64,64,32,208,10000,0,0,0,0
24,0,0,64,176,112,192,10000,0,0,0,0
24,0,0,64,176,112,16,10000,0,0,0,0
24,0,320,64,32,32,160,10000,0,0,0,0
24,0,320,64,32,16,96,10000,0,0,0,0
24,464,64,48,16,48,64,10000,0,0,0,0
24,496,0,48,48,32,0,10000,0,0,0,0
24,496,0,48,48,32,320,10000,0,0,0,0
24,288,112,16,16,288,112,10000,0,0,0,0
24,288,112,16,16,304,112,10000,0,0,0,0
24,288,112,16,16,320,112,10000,0,0,0,0
24,288,112,16,16,336,128,10000,0,0,0,0
24,288,112,16,16,352,128,10000,0,0,0,0
24,288,112,16,16,352,144,10000,0,0,0,0
24,288,112,16,16,368,144,10000,0,0,0,0
24,288,112,16,16,368,160,10000,0,0,0,0
24,288,112,16,16,384,160,10000,0,0,0,0
24,288,112,16,16,400,176,10000,0,0,0,0
24,288,112,16,16,400,192,10000,0,0,0,0
24,288,112,16,16,416,208,10000,0,0,0,0
24,288,112,16,16,416,224,10000,0,0,0,0
24,288,112,16,16,416,240,10000,0,0,0,0
24,288,112,16,16,400,240,10000,0,0,0,0
24,288,112,16,16,400,256,10000,0,0,0,0
24,288,112,16,16,384,256,10000,0,0,0,0
24,288,112,16,16,368,256,10000,0,0,0,0
24,288,112,16,16,352,256,10000,0,0,0,0
24,288,112,16,16,336,256,10000,0,0,0,0
24,288,112,16,16,336,272,10000,0,0,0,0
24,288,112,16,16,336,288,10000,0,0,0,0
24,288,112,16,16,336,304,10000,0,0,0,0
24,288,112,16,16,320,304,10000,0,0,0,0
24,288,112,16,16,304,304,10000,0,0,0,0
24,112,208,32,80,304,224,10000,0,0,0,0
987654321
LDEGKyEM
ISQLMSg=
KikYKy8=
Ny0LISg=

