UVx6TlN0AGU9Z2MeY0lIKEBgbV1cBzZHDnd4GlElf1liZml8NTghenh/cUNi
160,416,64,0,0,16777215,0,0,0,1,8,0
123,48,144,0,128,0,0,0,0,1,98,0
100,288,224,0,400,0,0,206,0,1,120,0
195,208,207,0,0,128,270,0,108,1,107,0
123,216,128,0,128,0,0,0,0,1,92,0
197,304,72,0,2,22,0,0,0,1,19,0
197,416,336,0,2,0,0,0,0,1,138,0
197,8,248,0,2,0,0,0,0,1,90,0
197,312,304,0,2,0,0,0,0,1,111,0
174,272,72,0,1,10,0,0,0,0,18,1
174,544,272,0,1,136,135,134,0,0,162,1
174,528,88,0,1,161,0,0,0,0,189,1
174,176,144,0,1,37,44,0,0,0,40,1
189,568,16,0,0,65,270,0,0,1,190,0
205,216.50,144,0,1,0,0.50,0,0,1,30,0
186,160,296,0,32,32,0,0,0,1,115,0
219,304,56,0,32,32,0,0,0,1,10,1
219,384,288,0,32,32,0,0,0,1,134,1
219,416,288,0,32,32,0,0,0,1,135,1
219,448,288,0,32,32,0,0,0,1,136,1
188,408,144,0,0,59,0,0,0,1,58,0
185,176,24,0,0,32,1,0,0,1,25,0
185,176,64,0,0,16,1,0,0,1,26,0
185,88,160,0,0,16,1,0,0,1,75,0
185,250,220,0,0,16,1,0,0,1,202,0
185,184,224,0,0,16,1,0,0,1,203,0
185,104,256,0,0,16,1,0,0,1,204,0
242,136,208,0,32,32,0,0,0,1,76,0
242,352,256,0,32,32,0,0,0,1,128,0
179,336,56,0,0,32,32,0,0,1,212,0
158,336,72,0,0,16777215,0,1,0,1,2,0
210,112,80,0,0,0,0,0,0,1,83,0
210,64,216,0,83,0,0,0,0,1,81,0
210,464,72,0,0,0,0,0,0,1,159,0
210,504,336,0,159,0,0,0,0,1,149,0
157,336,88,0,32,32,0,0,0,1,15,0
157,368,88,0,32,32,0,0,0,1,3,0
157,368,56,0,32,32,0,0,0,1,4,0
157,368,24,0,32,32,0,0,0,1,5,0
157,400,88,0,32,32,0,0,0,1,6,0
157,432,88,0,32,32,0,0,0,1,7,0
157,304,88,0,32,32,0,0,0,1,11,0
157,272,88,0,32,32,0,0,0,1,17,0
157,176,88,0,32,32,0,0,0,1,24,0
157,216,160,0,32,32,0,0,0,1,29,0
157,248,160,0,32,32,0,0,0,1,31,0
157,280,160,0,32,32,0,0,0,1,32,0
157,312,160,0,32,32,0,0,0,1,33,0
157,184,160,0,32,32,0,0,0,1,34,0
157,272,96,0,32,32,0,0,0,1,39,0
157,344,160,0,32,32,0,0,0,1,43,0
157,352,96,0,32,32,0,0,0,1,46,0
157,376,160,0,32,32,0,0,0,1,47,0
157,408,160,0,32,32,0,0,0,1,55,0
157,440,160,0,32,32,0,0,0,1,56,0
157,120,128,0,32,32,0,0,0,1,61,0
157,144,96,0,32,32,0,0,0,1,62,0
157,120,160,0,32,32,0,0,0,1,67,0
157,184,192,0,32,32,0,0,0,1,68,0
157,136,240,0,32,32,0,0,0,1,69,0
157,64,232,0,32,32,0,0,0,1,74,0
157,112,96,0,32,32,0,0,0,1,82,0
157,40,184,0,32,32,0,0,0,1,84,0
157,8,264,0,32,32,0,0,0,1,85,0
157,40,304,0,32,32,0,0,0,1,91,0
157,72,312,0,32,32,0,0,0,1,103,0
157,104,312,0,32,32,0,0,0,1,104,0
157,136,312,0,32,32,0,0,0,1,112,0
157,168,312,0,32,32,0,0,0,1,113,0
157,200,312,0,32,32,0,0,0,1,114,0
157,232,328,0,32,32,0,0,0,1,125,0
157,264,352,0,32,32,0,0,0,1,126,0
157,312,320,0,32,32,0,0,0,1,127,0
157,352,288,0,32,32,0,0,0,1,129,0
157,416,352,0,32,32,0,0,0,1,137,0
157,384,320,0,32,32,0,0,0,1,139,0
157,480,264,0,32,32,0,0,0,1,141,0
157,448,352,0,32,32,0,0,0,1,143,0
157,440,128,0,32,32,0,0,0,1,146,0
157,480,352,0,32,32,0,0,0,1,147,0
157,512,352,0,32,32,0,0,0,1,148,0
157,544,320,0,32,32,0,0,0,1,150,0
157,544,288,0,32,32,0,0,0,1,151,0
157,512,264,0,32,32,0,0,0,1,152,0
157,464,88,0,32,32,0,0,0,1,153,0
157,440,120,0,32,32,0,0,0,1,154,0
157,496,88,0,32,32,0,0,0,1,155,0
157,496,56,0,32,32,0,0,0,1,156,0
157,496,24,0,32,32,0,0,0,1,157,0
157,432,0,0,144,32,0,0,0,1,158,0
157,514,234,0,32,32,0,0,0,1,168,0
157,520,203,0,32,32,0,0,0,1,169,0
157,528,168,0,32,32,0,0,0,1,170,0
157,560,168,0,32,32,0,0,0,1,172,0
157,576,288,0,32,32,0,0,0,1,173,0
157,608,288,0,80,32,0,0,0,1,174,0
157,624,128,0,32,32,0,0,0,1,175,0
157,528,99,0,32,32,0,0,0,1,176,0
157,624,208,0,32,32,0,0,0,1,196,0
172,224,80,0,0,0,0,0,0,1,20,1
172,192,80,0,0,0,0,0,0,1,22,1
169,256,112,0,0,0,0,0,0,0,37,1
169,344,112,0,1,0,0,0,0,1,44,1
172,136,144,0,0,0,0,0,0,1,59,1
169,448,304,0,0,0,0,0,0,1,144,1
166,208,183,0,0,0,269,0,0,0,108,1
166,240,184,0,0,0,325,0,0,0,109,1
166,224,184,0,0,0,300,0,0,0,110,1
166,544,200,0,0,0,266,0,0,1,161,1
1234567890
25,208,128,16,16,384,208,10002,0,0,0,0
25,208,128,16,16,400,224,10002,0,0,0,0
25,208,128,16,16,416,224,10002,0,0,0,0
25,208,128,16,16,432,224,10002,0,0,0,0
25,208,128,16,16,448,224,10002,0,0,0,0
25,208,128,16,16,432,192,10002,0,0,0,0
25,208,128,16,16,464,192,10002,0,0,0,0
25,208,128,16,16,480,192,10002,0,0,0,0
25,208,128,16,16,448,192,10002,0,0,0,0
25,208,128,16,16,416,192,10002,0,0,0,0
25,208,128,16,16,400,192,10002,0,0,0,0
25,208,128,16,16,400,208,10002,0,0,0,0
25,208,128,16,16,416,208,10002,0,0,0,0
25,208,128,16,16,432,208,10002,0,0,0,0
25,208,128,16,16,448,208,10002,0,0,0,0
25,208,128,16,16,480,224,10002,0,0,0,0
25,208,128,16,16,496,224,10002,0,0,0,0
25,208,128,16,16,464,224,10002,0,0,0,0
25,208,128,16,16,480,208,10002,0,0,0,0
25,208,128,16,16,464,208,10002,0,0,0,0
24,352,32,16,16,320,224,10000,0,0,0,0
24,352,32,16,16,320,240,10000,0,0,0,0
24,352,32,16,16,336,176,10000,0,0,0,0
24,352,32,16,16,336,224,10000,0,0,0,0
24,352,32,16,16,336,208,10000,0,0,0,0
24,352,32,16,16,320,208,10000,0,0,0,0
24,352,32,16,16,320,192,10000,0,0,0,0
24,352,32,16,16,336,192,10000,0,0,0,0
24,352,32,16,16,352,192,10000,0,0,0,0
24,352,32,16,16,368,192,10000,0,0,0,0
24,352,32,16,16,352,208,10000,0,0,0,0
24,352,32,16,16,336,256,10000,0,0,0,0
24,352,32,16,16,336,240,10000,0,0,0,0
24,352,32,16,16,352,240,10000,0,0,0,0
24,352,32,16,16,352,224,10000,0,0,0,0
24,352,32,16,16,368,224,10000,0,0,0,0
987654321

