UVx6TlN0AGU9Z0BHIF9IKH4teFMeS3xhFml4DUwTbQYmKys0KSQ9ZmRjbV9+STsqAHQ=
160,312,112,0,0,16777215,0,0,0,1,24,0
123,168,96,0,200,33023,0,0,0,1,205,0
123,328,240,0,200,15205072,0,0,0,1,184,0
123,480,96,0,200,65280,0,0,0,1,207,0
123,168,240,0,200,33023,0,0,0,1,185,0
123,312,48,0,200,15205072,0,0,0,1,206,0
123,480,240,0,200,65280,0,0,0,1,186,0
197,376,112,0,2,0,0,0,0,1,67,0
197,248,112,0,2,0,0,0,0,1,66,0
174,280,224,0,1,195,193,0,0,0,77,1
174,368,224,0,1,193,195,0,0,0,78,1
219,24,296,0,32,16,0,0,0,1,141,1
185,96,239,0,0,32,1,0,0,1,65,0
185,248,240,0,0,32,1,0,0,1,70,0
185,400,240,0,0,32,1,0,0,1,73,0
185,544,240,0,0,32,1,0,0,1,76,0
242,304,208,0,32,32,0,0,0,1,171,0
242,344,208,0,32,32,0,0,0,1,172,0
242,152,208,0,32,32,0,0,0,1,177,0
242,192,208,0,32,32,0,0,0,1,178,0
242,456,208,0,32,32,0,0,0,1,179,0
176,57,288,0,141,32,32,0,0,1,145,0
176,24,248,0,141,32,32,0,0,1,147,0
176,56,256,0,141,32,32,0,0,1,146,0
158,24,288,0,0,16777215,0,1,0,1,23,0
210,304,328,0,44,0,0,0,0,1,30,0
210,320,328,0,42,0,0,0,0,1,36,0
210,352,328,0,39,0,0,0,0,1,34,0
210,288,328,0,40,0,0,0,0,1,31,0
210,240,328,0,109,0,0,0,0,1,79,0
210,224,328,0,110,0,0,0,0,1,101,0
210,208,328,0,111,0,0,0,0,1,100,0
210,192,328,0,112,0,0,0,0,1,99,0
210,176,328,0,113,0,0,0,0,1,98,0
210,160,328,0,114,0,0,0,0,1,97,0
210,144,328,0,115,0,0,0,0,1,96,0
210,128,328,0,116,0,0,0,0,1,95,0
210,128,144,0,0,180,0,0,0,1,116,0
210,112,328,0,117,0,0,0,0,1,94,0
210,96,144,0,0,180,0,0,0,1,118,0
210,96,328,0,118,0,0,0,0,1,93,0
210,32,144,0,0,180,0,0,0,1,139,0
210,0,144,0,0,180,0,0,0,1,151,0
210,0,328,0,151,0,0,0,0,1,144,0
210,400,328,0,122,0,0,0,0,1,88,0
210,416,328,0,124,0,0,0,0,1,85,0
210,448,328,0,126,0,0,0,0,1,86,0
210,576,328,0,134,0,0,0,0,1,103,0
210,592,328,0,135,0,0,0,0,1,102,0
210,624,144,0,0,180,0,0,0,1,137,0
210,624,328,0,137,0,0,0,0,1,107,0
210,608,144,0,0,180,0,0,0,1,136,0
210,80,328,0,119,0,0,0,0,1,92,0
210,64,328,0,120,0,0,0,0,1,91,0
210,16,328,0,140,0,0,0,0,1,143,0
210,32,328,0,139,0,0,0,0,1,142,0
210,48,328,0,121,0,0,0,0,1,90,0
210,256,328,0,45,0,0,0,0,1,29,0
210,272,328,0,43,0,0,0,0,1,32,0
210,336,328,0,41,0,0,0,0,1,35,0
210,640,328,0,138,0,0,0,0,1,108,0
210,432,328,0,125,0,0,0,0,1,87,0
210,384,328,0,123,0,0,0,0,1,89,0
210,496,144,0,0,180,0,0,0,1,129,0
210,544,328,0,132,0,0,0,0,1,105,0
210,504,112,0,0,0,0,0,0,1,191,0
210,208,144,0,0,180,0,0,0,1,111,0
210,560,144,0,0,180,0,0,0,1,133,0
210,576,144,0,0,180,0,0,0,1,134,0
210,592,144,0,0,180,0,0,0,1,135,0
210,640,144,0,0,180,0,0,0,1,138,0
210,592,272,0,191,0,0,0,0,1,189,0
210,608,272,0,192,0,0,0,0,1,190,0
210,512,144,0,0,180,0,0,0,1,130,0
210,544,144,0,0,180,0,0,0,1,132,0
210,528,144,0,0,180,0,0,0,1,131,0
210,480,328,0,128,0,0,0,0,1,80,0
210,496,328,0,129,0,0,0,0,1,81,0
210,528,328,0,131,0,0,0,0,1,83,0
210,512,328,0,130,0,0,0,0,1,84,0
210,464,328,0,127,0,0,0,0,1,82,0
210,520,112,0,0,0,0,0,0,1,192,0
210,368,328,0,37,0,0,0,0,1,33,0
210,144,144,0,0,180,0,0,0,1,115,0
210,112,144,0,0,180,0,0,0,1,117,0
210,64,144,0,0,180,0,0,0,1,120,0
210,560,328,0,133,0,0,0,0,1,104,0
210,608,328,0,136,0,0,0,0,1,106,0
216,88,72,0,4,0,1,0,0,1,210,0
210,80,144,0,0,180,0,0,0,1,119,0
210,16,144,0,0,180,0,0,0,1,140,0
210,48,144,0,0,180,0,0,0,1,121,0
210,160,144,0,0,180,0,0,0,1,114,0
210,176,144,0,0,180,0,0,0,1,113,0
210,192,144,0,0,180,0,0,0,1,112,0
210,224,144,0,0,180,0,0,0,1,110,0
210,240,144,0,0,180,0,0,0,1,109,0
210,256,144,0,0,180,0,0,0,1,45,0
210,272,144,0,0,180,0,0,0,1,43,0
210,288,144,0,0,180,0,0,0,1,40,0
210,304,144,0,0,180,0,0,0,1,44,0
210,320,144,0,0,180,0,0,0,1,42,0
210,336,144,0,0,180,0,0,0,1,41,0
210,352,144,0,0,180,0,0,0,1,39,0
210,368,144,0,0,180,0,0,0,1,37,0
210,384,144,0,0,180,0,0,0,1,123,0
210,400,144,0,0,180,0,0,0,1,122,0
210,416,144,0,0,180,0,0,0,1,124,0
210,432,144,0,0,180,0,0,0,1,125,0
210,448,144,0,0,180,0,0,0,1,126,0
210,464,144,0,0,180,0,0,0,1,127,0
210,480,144,0,0,180,0,0,0,1,128,0
157,368,344,0,32,32,0,0,0,1,16,0
157,400,344,0,32,32,0,0,0,1,2,0
157,336,344,0,32,32,0,0,0,1,3,0
157,240,344,0,32,32,0,0,0,1,4,0
157,272,344,0,32,32,0,0,0,1,5,0
157,304,344,0,32,32,0,0,0,1,6,0
157,432,344,0,32,32,0,0,0,1,7,0
157,176,344,0,32,32,0,0,0,1,8,0
157,144,344,0,32,32,0,0,0,1,9,0
157,112,344,0,32,32,0,0,0,1,10,0
157,208,344,0,32,32,0,0,0,1,11,0
157,80,344,0,32,32,0,0,0,1,12,0
157,48,344,0,32,32,0,0,0,1,13,0
157,16,344,0,32,32,0,0,0,1,14,0
157,464,344,0,32,32,0,0,0,1,17,0
157,496,344,0,32,32,0,0,0,1,18,0
157,528,344,0,32,32,0,0,0,1,19,0
157,560,344,0,32,32,0,0,0,1,20,0
157,592,344,0,32,32,0,0,0,1,21,0
157,624,344,0,32,32,0,0,0,1,22,0
157,296,128,0,32,32,0,0,0,1,25,0
157,328,128,0,32,32,0,0,0,1,26,0
157,360,128,0,32,32,0,0,0,1,27,0
157,264,128,0,32,32,0,0,0,1,28,0
157,232,128,0,32,32,0,0,0,1,46,0
157,488,128,0,32,32,0,0,0,1,48,0
157,456,128,0,32,32,0,0,0,1,50,0
157,8,128,0,32,32,0,0,0,1,51,0
157,424,128,0,32,32,0,0,0,1,52,0
157,392,128,0,32,32,0,0,0,1,53,0
157,168,128,0,32,32,0,0,0,1,54,0
157,40,128,0,32,32,0,0,0,1,55,0
157,104,128,0,32,32,0,0,0,1,56,0
157,136,128,0,32,32,0,0,0,1,57,0
157,72,128,0,32,32,0,0,0,1,58,0
157,200,128,0,32,32,0,0,0,1,59,0
157,584,128,0,32,32,0,0,0,1,60,0
157,616,128,0,32,32,0,0,0,1,61,0
157,640,128,0,32,32,0,0,0,1,62,0
157,128,240,0,16,32,0,0,0,1,63,0
157,64,240,0,16,32,0,0,0,1,64,0
157,280,240,0,16,32,0,0,0,1,68,0
157,216,240,0,16,32,0,0,0,1,69,0
157,432,240,0,16,32,0,0,0,1,71,0
157,368,240,0,16,32,0,0,0,1,72,0
157,576,240,0,16,32,0,0,0,1,74,0
157,512,240,0,16,32,0,0,0,1,75,0
157,520,128,0,32,32,0,0,0,1,182,0
157,552,128,0,32,32,0,0,0,1,183,0
157,592,280,0,16,16,0,0,0,1,187,0
157,608,280,0,16,16,0,0,0,1,188,0
157,584,152,0,32,16,0,0,0,1,197,0
157,616,152,0,32,16,0,0,0,1,198,0
157,640,152,0,32,16,0,0,0,1,199,0
157,576,272,0,16,32,0,0,0,1,200,0
169,568,192,0,1,0,0,0,0,1,193,1
169,568,160,0,0,0,0,0,0,1,195,1
253,280,240,0,255,0,2,0,0,1,149,0
253,368,240,0,255,180,2,0,0,1,150,0
253,368,240,0,255,0,2,0,0,1,152,0
253,280,240,0,255,180,2,0,0,1,154,0
1234567890
25,0,0,48,48,0,0,10002,0,0,0,0
25,0,0,48,48,48,0,10002,0,0,0,0
25,0,0,48,48,96,0,10002,0,0,0,0
25,0,0,48,48,144,0,10002,0,0,0,0
25,0,0,48,48,192,0,10002,0,0,0,0
25,0,0,48,48,240,0,10002,0,0,0,0
25,0,0,48,48,288,0,10002,0,0,0,0
25,0,0,48,48,336,0,10002,0,0,0,0
25,0,0,48,48,384,0,10002,0,0,0,0
25,0,0,48,48,432,0,10002,0,0,0,0
25,0,0,48,48,480,0,10002,0,0,0,0
25,0,0,48,48,528,0,10002,0,0,0,0
25,0,0,48,48,576,0,10002,0,0,0,0
25,0,0,48,48,624,0,10002,0,0,0,0
25,0,0,48,48,624,48,10002,0,0,0,0
25,0,0,48,48,576,48,10002,0,0,0,0
25,0,0,48,48,576,96,10002,0,0,0,0
25,0,0,48,48,624,96,10002,0,0,0,0
25,0,0,48,48,528,48,10002,0,0,0,0
25,0,0,48,48,528,96,10002,0,0,0,0
25,0,0,48,96,480,48,10002,0,0,0,0
25,0,0,48,96,432,48,10002,0,0,0,0
25,0,0,48,96,384,48,10002,0,0,0,0
25,0,0,48,96,336,48,10002,0,0,0,0
25,0,0,48,96,288,48,10002,0,0,0,0
25,0,0,48,96,240,48,10002,0,0,0,0
25,0,0,48,96,192,48,10002,0,0,0,0
25,0,0,48,96,144,48,10002,0,0,0,0
25,0,0,48,96,96,48,10002,0,0,0,0
25,0,0,48,96,48,48,10002,0,0,0,0
25,0,0,48,96,0,48,10002,0,0,0,0
25,0,0,48,96,0,144,10002,0,0,0,0
25,0,0,48,96,0,240,10002,0,0,0,0
25,0,0,48,96,48,240,10002,0,0,0,0
25,0,0,48,96,48,144,10002,0,0,0,0
25,0,0,48,96,96,144,10002,0,0,0,0
25,0,0,48,96,144,144,10002,0,0,0,0
25,0,0,48,96,192,144,10002,0,0,0,0
25,0,0,48,96,240,144,10002,0,0,0,0
25,0,0,48,96,288,144,10002,0,0,0,0
25,0,0,48,96,336,144,10002,0,0,0,0
25,0,0,48,96,384,144,10002,0,0,0,0
25,0,0,48,96,432,144,10002,0,0,0,0
25,0,0,48,96,480,144,10002,0,0,0,0
25,0,0,48,96,528,144,10002,0,0,0,0
25,0,0,48,96,576,144,10002,0,0,0,0
25,0,0,48,96,624,144,10002,0,0,0,0
25,0,0,48,96,576,240,10002,0,0,0,0
25,0,0,48,96,624,240,10002,0,0,0,0
25,0,0,48,96,528,240,10002,0,0,0,0
25,0,0,48,96,480,240,10002,0,0,0,0
25,0,0,48,96,432,240,10002,0,0,0,0
25,0,0,48,96,384,240,10002,0,0,0,0
25,0,0,48,96,336,240,10002,0,0,0,0
25,0,0,48,96,288,240,10002,0,0,0,0
25,0,0,48,96,240,240,10002,0,0,0,0
25,0,0,48,96,192,240,10002,0,0,0,0
25,0,0,48,96,144,240,10002,0,0,0,0
25,0,0,48,96,96,240,10002,0,0,0,0
987654321
KhFqDAEvVWlsOC1jMlMD
Lk8nQlJyHg==
LkgmCxYnECBra0tcMkVOPxo=
Lk8nQgFiVihra2JIc2ZILlUgO39LHyICKmp7EVp

