VVh6UkxxBnkpcyFcOEpDLltgb0pPFz5NH2FyGVp9PFliZml8NTghenh/cQ==
259,268,24,0,8,16,0,0,0,1,87,0
259,1764,328,0,220,64,0,0,0,1,5907,0
160,1808,160,0,0,16777215,0,0,0,1,1661,0
178,354,149,0,32,32,0,0,0,0,10922,0
178,354,84,0,32,32,0,0,0,0,10973,0
178,490,117,0,32,32,0,0,0,0,2453,0
178,490,53,0,32,32,0,0,0,0,2406,0
100,305,180,0,256,0,0,270,213,1,208,0
100,207,0,0,256,0,0,270,0,0,83,0
100,168,163,0,350,8388608,0,90,0,1,125,0
100,128,0,0,256,0,0,270,0,0,37,0
100,38,0,0,256,0,0,270,0,1,11,0
123,544,288,0,128,0,0,0,0,1,11089,0
123,1040,304,0,128,0,0,0,0,1,11124,0
197,45,211,0,2,159,0,0,0,1,163,0
197,828,259,0,2,208,0,0,0,1,590,0
197,386,165,0,1,6953,0,0,0,1,2382,0
197,1710,165,0,2,6024,0,0,0,1,1685,0
174,240,132,0,1,66,64,65,63,0,90,1
174,92,134,0,1,132,0,0,0,0,135,1
174,1840,320,0,1,3331,2770,2504,6895,0,6806,1
174,1856,320,0,1,3651,3562,3389,3171,0,6599,1
174,1664,320,0,1,2859,6023,6022,6021,0,6024,1
174,1664,360,0,1,6024,0,7224,7343,0,6953,1
174,1680,360,0,1,7342,7341,7340,7339,0,7224,1
174,1696,360,0,1,0,7865,7315,7295,0,7343,1
174,1712,360,0,1,9947,10066,10137,10162,0,7865,1
174,1712,320,0,1,5299,6020,5996,6358,0,6021,1
174,1728,360,0,1,10584,10669,10717,10670,0,7339,1
174,1744,320,0,1,3979,4007,4453,4933,0,6573,1
174,1744,360,0,1,9600,9648,9445,9421,0,7295,1
174,1776,360,0,1,10090,9834,9624,9733,0,7315,1
174,1792,360,0,1,8300,8343,8428,8452,0,10800,1
174,1792,320,0,1,4215,4069,3893,3917,0,6358,1
174,1776,320,0,1,2406,2453,0,0,0,6895,1
174,1808,360,0,1,10510,10019,9971,9991,0,7341,1
174,1824,320,0,1,4886,4862,4838,4745,0,5996,1
174,1728,320,0,1,6573,6574,6594,6599,0,6020,1
174,1760,360,0,1,0,10270,10157,9799,0,7342,1
174,1752,336,0,1,10860,10800,10824,10825,0,10752,1
174,1760,320,0,1,6806,3063,3260,3307,0,6574,1
174,1760,336,0,1,8622,9055,8766,8621,0,10825,1
174,1808,320,0,1,4617,4589,4523,4725,0,6594,1
174,1696,320,0,1,5546,5503,5079,5256,0,6022,1
174,1680,320,0,1,5715,5691,5644,5597,0,6023,1
174,1856,360,0,1,898,9156,9090,10752,0,7340,1
174,1840,360,0,1,8901,8627,8057,8211,0,10824,1
174,1824,360,0,1,2859,10922,10973,11008,0,10860,1
174,791,259,0,1,599,609,0,0,0,568,1
205,1071.50,326,0,1,0,0.50,0,0,1,826,0
205,577.50,322,0,1,0,0.40,0,0,1,229,0
220,684,84,0,32,32,0,0,0,0,4069,1
220,684,116,0,32,32,0,0,0,0,3893,1
220,684,147,0,32,32,0,0,0,0,3917,1
220,585,116,0,32,32,0,0,0,0,3063,1
220,552,116,0,32,32,0,0,0,0,3260,1
220,552,148,0,32,32,0,0,0,0,3307,1
220,1303,82,0,32,32,0,0,0,0,5256,1
220,651,116,0,32,32,0,0,0,0,3651,1
220,651,148,0,32,32,0,0,0,0,3562,1
220,618,148,0,32,32,0,0,0,0,3389,1
220,585,148,0,32,32,0,0,0,0,3171,1
220,552,84,0,32,32,0,0,0,0,3331,1
220,490,21,0,32,32,0,0,0,0,2770,1
220,490,149,0,32,32,0,0,0,0,2504,1
220,913,115,0,32,32,0,0,0,0,3979,1
220,1045,115,0,32,32,0,0,0,0,4617,1
220,1012,115,0,32,32,0,0,0,0,4589,1
220,979,115,0,32,32,0,0,0,0,4523,1
220,946,115,0,32,32,0,0,0,0,4725,1
220,1303,115,0,32,32,0,0,0,0,5079,1
220,1369,116,0,32,32,0,0,0,0,5546,1
220,1501,116,0,32,32,0,0,0,0,5715,1
220,1468,116,0,32,32,0,0,0,0,5691,1
220,1435,116,0,32,32,0,0,0,0,5644,1
220,1402,116,0,32,32,0,0,0,0,5597,1
220,913,147,0,32,32,0,0,0,0,4007,1
220,781,147,0,32,32,0,0,0,0,4215,1
220,1335,148,0,32,32,0,0,0,0,5503,1
220,913,50,0,32,32,0,0,0,0,4453,1
220,1303,50,0,32,32,0,0,0,0,5299,1
220,1045,50,0,32,32,0,0,0,0,4886,1
220,1012,50,0,32,32,0,0,0,0,4862,1
220,979,50,0,32,32,0,0,0,0,4838,1
220,946,50,0,32,32,0,0,0,0,4745,1
220,913,17,0,32,32,0,0,0,0,4933,1
220,1369,148,0,32,32,0,0,0,0,8057,1
220,1402,116,0,32,32,0,0,0,0,8211,1
220,1435,83,0,32,32,0,0,0,0,8300,1
220,1468,116,0,32,32,0,0,0,0,8343,1
220,1502,83,0,32,32,0,0,0,0,8428,1
220,1533,51,0,32,32,0,0,0,0,8452,1
220,1178,147,0,32,32,0,0,0,0,8627,1
220,1112,147,0,32,32,0,0,0,0,9055,1
220,880,147,0,32,32,0,0,0,0,9421,1
220,847,147,0,32,32,0,0,0,0,9799,1
220,814,147,0,32,32,0,0,0,0,9648,1
220,749,147,0,32,32,0,0,0,0,9834,1
220,684,147,0,32,32,0,0,0,0,9947,1
220,521,148,0,32,32,0,0,0,0,10670,1
220,717,17,0,32,32,0,0,0,0,10066,1
220,717,84,0,32,32,0,0,0,0,10137,1
220,717,116,0,32,32,0,0,0,0,10162,1
220,521,21,0,32,32,0,0,0,0,10584,1
220,521,53,0,32,32,0,0,0,0,10669,1
220,521,116,0,32,32,0,0,0,0,10717,1
220,814,17,0,32,32,0,0,0,0,9600,1
220,880,17,0,32,32,0,0,0,0,9445,1
220,750,17,0,32,32,0,0,0,0,10090,1
220,782,50,0,32,32,0,0,0,0,9624,1
220,781,115,0,32,32,0,0,0,0,9733,1
220,651,16,0,32,32,0,0,0,0,10510,1
220,651,50,0,32,32,0,0,0,0,10019,1
220,651,116,0,32,32,0,0,0,0,9971,1
220,684,17,0,32,32,0,0,0,0,9991,1
220,847,50,0,32,32,0,0,0,0,10270,1
220,847,83,0,32,32,0,0,0,0,10157,1
220,1112,82,0,32,32,0,0,0,0,8622,1
220,1145,82,0,32,32,0,0,0,0,8766,1
220,1178,82,0,32,32,0,0,0,0,8621,1
220,913,50,0,32,32,0,0,0,0,9156,1
220,913,115,0,32,32,0,0,0,0,9090,1
220,1178,115,0,32,32,0,0,0,0,8901,1
219,1205,180,0,1896,32,0,0,0,1,225,1
219,536,243,0,8,32,0,0,0,1,484,1
219,409,244,0,8,32,0,0,0,1,448,1
188,548,323,0,0,223,221,358,364,1,234,0
188,1040,328,0,0,657,661,643,663,1,764,0
188,1040,328,0,0,647,655,651,653,1,785,0
188,1040,328,0,0,633,645,659,649,1,743,0
188,1040,328,0,0,1039,985,1037,1150,1,1275,0
188,1040,328,0,0,1180,1031,1041,0,1,1336,0
242,386,149,0,32,32,0,0,0,1,10444,0
242,168,256,0,32,32,0,0,0,1,554,0
242,883,240,0,32,32,0,0,0,1,2347,0
176,96,24,0,37,32,32,0,0,1,38,0
176,96,24,0,83,32,32,0,0,1,84,0
176,96,24,0,11,32,32,0,0,1,26,0
176,96,24,0,115,32,32,0,0,1,117,0
176,96,24,0,111,32,32,0,0,1,118,0
176,96,24,0,17,32,32,0,0,1,22,0
176,15,17,0,5,32,32,0,0,1,9,0
176,521,84,0,10922,32,32,0,0,0,11008,0
176,219,242,0,314,32,32,0,0,1,292,0
176,220,243,0,213,32,32,0,0,1,209,0
176,220,243,0,189,32,32,0,0,1,199,0
176,221,243,0,170,32,32,0,0,1,178,0
176,221,243,0,191,32,32,0,0,1,200,0
176,1992,240,0,191,32,32,0,0,1,1390,0
154,8,36,0,1,0.80,16,8,1,1,7,1
154,74,56,0,2,2,8,32,1,0,17,1
154,14,112,0,3,0.50,16,48,1,0,111,1
154,14,64,0,4,0.70,16,48,1,0,115,1
154,168,179,0,5,0.50,32,32,1,0,132,1
154,88,215,0,6,0.50,128,8,1,0,159,1
154,652,267,0,7,0.20,1000,16,1,0,170,1
154,367,0,0,8,0.21,32,32,-1,0,189,1
154,305,180,0,9,0.20,32,32,-1,0,213,1
154,188,203,0,10,0.10,8,80,1,0,314,1
154,520,336,0,11,10,8,8,1,1,346,1
154,326,47.50,0,12,0.50,32,32,-1,1,2890,1
210,1991,259,0,1537,0,0,0,0,1,1425,0
210,1985,163,0,0,0,0,0,0,1,1537,0
158,9,32,0,0,16777215,0,1,0,1,2,0
157,304,148,0,32,32,0,0,0,1,92,0
157,304,116,0,32,32,0,0,0,1,93,0
157,304,54,0,32,32,0,0,0,1,95,0
157,304,85,0,32,32,0,0,0,1,94,0
157,242,148,0,32,32,0,0,0,1,67,0
157,274,148,0,32,32,0,0,0,1,91,0
157,241,179,0,32,32,0,0,0,1,74,0
157,224,179,0,32,32,0,0,0,1,73,0
157,200,179,0,32,32,0,0,0,1,62,0
157,136,179,0,32,32,0,0,0,1,61,0
157,104,179,0,32,32,0,0,0,1,71,0
157,94,150,0,32,32,0,0,0,1,68,0
157,266,243,0,32,32,0,0,0,1,417,0
157,256,56,0,32,32,0,0,0,1,76,0
157,224,56,0,32,32,0,0,0,1,75,0
157,192,56,0,32,32,0,0,0,1,46,0
157,192,88,0,32,32,0,0,0,1,49,0
157,192,120,0,32,32,0,0,0,1,59,0
157,144,56,0,32,32,0,0,0,1,30,0
157,144,88,0,32,32,0,0,0,1,48,0
157,144,120,0,32,32,0,0,0,1,58,0
157,112,56,0,32,32,0,0,0,1,29,0
157,93,179,0,32,32,0,0,0,1,72,0
157,86,56,0,32,32,0,0,0,1,12,0
157,62,150,0,32,32,0,0,0,1,98,0
157,38,150,0,32,32,0,0,0,1,99,0
157,38,118,0,32,32,0,0,0,1,100,0
157,38,87,0,32,32,0,0,0,1,101,0
157,38,56,0,32,32,0,0,0,1,102,0
157,304,23,0,32,32,0,0,0,1,96,0
157,304,0,0,32,32,0,0,0,1,97,0
157,264,36,0,16,8,0,0,0,1,80,0
157,268,8,0,8,16,0,0,0,1,79,0
157,652,243,0,32,32,0,0,0,1,394,0
157,580,338,0,32,32,0,0,0,1,228,0
157,548,338,0,32,32,0,0,0,1,227,0
157,516,338,0,32,32,0,0,0,1,226,0
157,577,224,0,8,8,0,0,0,1,502,0
157,1303,147,0,32,32,0,0,0,1,898,0
157,1072,343,0,32,32,0,0,0,1,726,0
157,1041,343,0,32,32,0,0,0,1,721,0
155,8,36,0,1,1,0,0,0,0,5,0
155,78,36,0,2,1,0,0,0,0,6,0
155,74,56,0,1,2,0,0,0,1,15,0
155,66,56,0,2,2,0,0,0,1,16,0
155,66,16,0,3,2,0,0,0,1,19,0
155,74,16,0,4,2,0,0,0,0,23,0
155,14,112,0,1,3,0,0,0,1,109,0
155,14,16,0,2,3,0,0,0,1,110,0
155,14,64,0,1,4,0,0,0,1,113,0
155,14,16,0,2,4,0,0,0,1,114,0
155,46,16,0,3,4,0,0,0,0,119,0
155,30,16,0,3,3,0,0,0,0,120,0
155,168,179,0,1,5,0,0,0,1,130,0
155,168,227,0,2,5,0,0,0,0,131,0
155,88,215,0,1,6,0,0,0,1,157,0
155,88,263,0,2,6,0,0,0,0,158,0
155,652,267,0,1,7,0,0,0,1,168,0
155,1992,267,0,2,7,0,0,0,1,169,0
155,367,0,0,1,8,0,0,0,1,187,0
155,1600,0,0,2,8,0,0,0,1,188,0
155,305,180,0,1,9,0,0,0,1,211,0
155,1784,180,0,2,9,0,0,0,1,212,0
169,540,227,0,1,0,0,0,0,1,221,1
169,540,195,0,0,0,0,0,0,1,223,1
155,188,203,0,1,10,0,0,0,1,312,0
155,188,235,0,2,10,0,0,0,0,313,0
155,520,336,0,1,11,0,0,0,0,344,0
155,552,336,0,2,11,0,0,0,0,345,0
169,600,196,0,0,0,0,0,0,1,358,1
169,600,228,0,1,0,0,0,0,1,364,1
169,850,196,0,0,0,0,0,0,1,599,1
169,850,227,0,1,0,0,0,0,1,609,1
172,901,243,0,0,0,0,0,0,1,633,1
172,1093,243,0,0,0,0,0,0,1,643,1
172,933,243,0,0,0,0,0,0,1,645,1
172,1157,243,0,0,0,0,0,0,1,647,1
172,997,243,0,0,0,0,0,0,1,649,1
172,1221,243,0,0,0,0,0,0,1,651,1
172,1253,243,0,0,0,0,0,0,1,653,1
172,1189,243,0,0,0,0,0,0,1,655,1
172,1029,243,0,0,0,0,0,0,1,657,1
172,965,243,0,0,0,0,0,0,1,659,1
172,1061,243,0,0,0,0,0,0,1,661,1
172,1125,243,0,0,0,0,0,0,1,663,1
172,1317,243,0,0,0,0,0,0,1,985,1
172,1445,243,0,0,0,0,0,0,1,1031,1
172,1349,243,0,0,0,0,0,0,1,1037,1
172,1285,243,0,0,0,0,0,0,1,1039,1
172,1477,243,0,0,0,0,0,0,1,1041,1
172,1381,243,0,0,0,0,0,0,1,1150,1
172,1413,243,0,0,0,0,0,0,1,1180,1
155,326,16,0,1,12,0,0,0,1,2888,0
155,326,155,0,2,12,0,0,0,1,2889,0
166,110,163,0,0,0,0,0,0,1,63,1
166,226,154,0,0,0,180,0,0,1,64,1
166,110,146,0,0,0,0,0,0,1,65,1
166,226,137,0,0,0,180,0,0,1,66,1
166,367,0,0,189,0,270,0,0,0,191,1
166,632,256,0,0,0,180,0,0,1,403,1
166,326,47,0,2890,0,0,0,0,0,2859,1
253,184,56,0,16777215,0,3,0,0,1,47,0
253,176,80,0,16777215,90,7,0,0,1,54,0
253,176,112,0,16777215,90,7,0,0,1,55,0
253,176,96,0,16777215,90,7,0,0,1,56,0
253,176,128,0,16777215,90,7,0,0,1,57,0
253,152,56,0,16777215,0,2,0,0,1,45,0
253,160,80,0,16777215,270,7,0,0,1,50,0
253,160,96,0,16777215,270,7,0,0,1,51,0
253,160,128,0,16777215,270,7,0,0,1,52,0
253,160,112,0,16777215,270,7,0,0,1,53,0
157,1010,343,0,32,32,0,0,0,1,720,0
176,720,232,0,208,32,32,0,0,1,540,0
1234567890
25,144,112,16,16,16,224,10002,0,0,0,0
25,0,224,16,16,16,240,10002,0,0,0,0
25,0,224,16,16,16,256,10002,0,0,0,0
25,0,224,16,16,32,272,10002,0,0,0,0
25,0,224,16,16,48,256,10002,0,0,0,0
25,0,224,16,16,64,272,10002,0,0,0,0
25,0,224,16,16,80,256,10002,0,0,0,0
25,0,224,16,16,80,240,10002,0,0,0,0
25,0,224,16,16,112,240,10002,0,0,0,0
25,0,224,16,16,112,272,10002,0,0,0,0
25,144,128,16,16,32,288,10002,0,0,0,0
25,144,128,16,16,64,288,10002,0,0,0,0
25,144,112,16,16,80,224,10002,0,0,0,0
25,576,32,16,16,112,224,10002,0,0,0,0
25,576,48,16,16,112,288,10002,0,0,0,0
25,560,64,16,16,112,256,10002,0,0,0,0
25,16,240,16,16,128,224,10002,0,0,0,0
25,160,112,16,16,128,256,10002,0,0,0,0
25,160,112,16,16,144,288,10002,0,0,0,0
25,160,112,16,16,144,224,10002,0,0,0,0
25,32,240,16,16,128,288,10002,0,0,0,0
25,144,112,16,16,176,224,10002,0,0,0,0
25,0,224,16,32,176,240,10002,0,0,0,0
25,0,224,16,16,176,272,10002,0,0,0,0
25,576,48,16,16,176,288,10002,0,0,0,0
25,32,240,16,16,192,288,10002,0,0,0,0
25,160,112,16,16,208,288,10002,0,0,0,0
25,0,224,16,32,240,240,10002,0,0,0,0
25,0,224,16,16,240,272,10002,0,0,0,0
25,576,32,16,16,240,224,10002,0,0,0,0
25,576,48,16,16,240,288,10002,0,0,0,0
25,32,240,16,16,256,224,10002,0,0,0,0
25,32,240,16,16,256,288,10002,0,0,0,0
25,160,112,16,16,272,224,10002,0,0,0,0
25,160,112,16,16,272,288,10002,0,0,0,0
25,16,240,32,16,320,224,10002,0,0,0,0
25,16,240,32,16,320,288,10002,0,0,0,0
25,576,48,16,16,304,288,10002,0,0,0,0
25,576,32,16,16,304,224,10002,0,0,0,0
25,0,224,16,16,304,240,10002,0,0,0,0
25,0,224,16,16,304,256,10002,0,0,0,0
25,0,224,16,16,304,272,10002,0,0,0,0
25,0,224,16,16,352,272,10002,0,0,0,0
25,0,224,16,16,352,256,10002,0,0,0,0
25,0,224,16,16,352,240,10002,0,0,0,0
25,576,0,16,16,352,224,10002,0,0,0,0
25,576,16,16,16,352,288,10002,0,0,0,0
25,144,128,16,16,384,288,10002,0,0,0,0
25,0,224,16,32,384,256,10002,0,0,0,0
25,0,224,16,16,448,256,10002,0,0,0,0
25,0,224,16,16,448,272,10002,0,0,0,0
25,144,112,16,16,400,224,10002,0,0,0,0
25,144,112,16,16,432,224,10002,0,0,0,0
25,144,128,16,16,448,288,10002,0,0,0,0
25,0,224,16,16,480,240,10002,0,0,0,0
25,0,224,16,16,480,272,10002,0,0,0,0
25,576,32,16,16,480,224,10002,0,0,0,0
25,576,48,16,16,480,288,10002,0,0,0,0
25,560,64,16,16,480,256,10002,0,0,0,0
25,160,112,16,16,496,256,10002,0,0,0,0
25,160,112,16,16,512,224,10002,0,0,0,0
25,160,112,16,16,512,288,10002,0,0,0,0
25,16,240,16,16,496,224,10002,0,0,0,0
25,16,240,16,16,496,288,10002,0,0,0,0
25,0,224,16,16,384,240,10002,0,0,0,0
25,0,224,16,16,448,240,10002,0,0,0,0
25,144,128,16,16,416,240,10002,0,0,0,0
987654321

TQ==

