VlpyUkxxBnkpcyFcOEpDLltgWlRPEGMTVTU7SBJhIEV+enVgKSQ=
259,16,262,0,32,100,0,0,0,1,41,0
259,119,197,0,275,32,0,0,0,1,47,0
259,240,181,0,32,32,0,0,0,1,55,0
259,118,29,0,275,64,0,0,0,1,85,0
160,672,96,0,0,16777215,0,0,0,1,233,0
195,218,248,0,0,128,270,29,35,1,25,0
178,960,112,0,640,32,0,0,0,0,610,0
178,961,307,0,640,8,0,0,0,0,680,0
178,335,100,0,544,8,0,0,0,0,251,0
100,208,328,0,256,0,0,90,0,1,857,0
224,723,60,0,128,0,0,0,0,0,751,0
123,126,121,0,128,0,0,0,0,1,101,0
123,144,280,0,128,0,0,0,0,1,804,0
197,1194,358,0,2,680,0,0,0,1,749,0
197,944,358,0,2,752,0,0,0,1,747,0
197,671,357,0,2,751,0,0,0,1,746,0
197,295,296,0,2,23,0,0,0,1,177,0
197,208,328,0,8,23,0,0,0,1,32,0
197,626,97,0,2,251,0,0,0,1,235,0
197,312,296,0,2,182,0,0,0,1,178,0
174,1264,99,0,1,610,653,0,0,0,597,1
174,163,166,0,1,127,67,77,148,0,65,0
174,448,328,0,1,831,791,0,0,0,844,1
174,432,216,0,1,68,223,218,225,0,217,1
174,70,328,0,1,107,0,0,0,0,106,1
205,546.50,165,0,1,0,0.50,0,0,1,73,0
205,566.50,165,0,1,0,0.50,0,0,1,74,0
205,79.50,44,0,1,0,0.50,0,0,1,84,0
219,944,200,0,600,8,0,0,0,1,666,1
219,240,264,0,32,32,0,0,0,1,166,1
219,240,296,0,32,32,0,0,0,1,158,1
186,1240,96,0,32,32,0,0,0,1,596,0
219,984,256,0,600,8,0,0,0,1,679,1
219,920,80,0,32,32,0,0,0,1,653,1
188,8,165,0,0,35,137,0,0,1,48,0
188,186,34,0,0,252,0,0,0,1,253,0
188,1051,196,0,0,481,0,0,0,1,743,0
188,1112,197,0,0,504,0,0,0,1,742,0
188,1176,198,0,0,567,0,0,0,1,741,0
188,986,197,0,0,481,0,0,0,1,744,0
188,920,96,0,0,516,463,481,492,1,728,0
188,920,96,0,0,533,527,504,498,1,727,0
188,920,96,0,0,567,539,627,580,1,623,0
188,856,196,0,0,539,0,0,0,1,765,0
185,473,231,0,0,32,1,0,0,1,229,0
185,536,88,0,0,16,1,0,0,1,268,0
185,472,88,0,0,16,1,0,0,1,265,0
185,400,88,0,0,16,1,0,0,1,266,0
185,327,88,0,0,16,1,0,0,1,270,0
185,438,30,0,0,16,1,0,0,1,269,0
185,363,30,0,0,16,1,0,0,1,267,0
242,664,24,0,32,32,0,0,0,1,778,0
242,432,200,0,32,32,0,0,0,1,282,0
242,8,200,0,32,32,0,0,0,0,148,0
176,272,312,0,831,32,32,0,0,1,830,0
176,48,328,0,59,32,32,0,0,1,62,0
176,676,329,0,680,32,32,0,0,1,682,0
154,178,320,0,1,0.50,32,32,-1,1,29,1
154,48,360,0,2,0.25,32,32,1,0,59,1
154,576,181,0,3,0.50,128,32,1,1,69,1
154,176,176,0,4,0.50,8,8,1,0,111,1
154,176,176,0,5,0.50,8,8,1,0,121,1
154,252,185,0,6,0.50,8,8,1,0,127,1
154,28,289,0,7,0.50,8,8,1,1,139,1
154,256,240,0,8,0.50,32,32,-1,0,182,1
154,957,304,0,9,5,32,32,-1,1,467,1
154,971,304,0,10,7,32,32,-1,1,485,1
154,960,304,0,11,3,32,32,-1,1,490,1
154,1194.25,304,0,12,5.75,32,32,-1,1,496,1
154,696,304,0,13,12,32,32,-1,1,502,1
154,959,304,0,14,1,32,32,-1,1,520,1
154,844.54,304,0,15,7.37,32,32,-1,1,525,1
154,1113.50,304,0,16,9.50,32,32,-1,1,531,1
154,866.10,304,0,17,3.30,32,32,-1,1,537,1
154,670,304,0,18,14,32,32,-1,1,565,1
154,691,344,0,19,8,32,32,-1,1,582,1
154,1260,124,0,20,0.50,75,8,1,0,627,1
210,646,22,0,0,270,0,0,0,1,307,0
210,1247,357,0,307,0,0,0,0,1,750,0
210,31,29,0,307,0,0,0,0,1,294,0
158,48,344,0,0,16777215,0,1,0,1,39,0
157,336,264,0,32,32,0,0,0,1,192,0
157,336,296,0,32,32,0,0,0,1,193,0
157,432,232,0,32,32,0,0,0,1,216,0
157,644,160,0,8,600,0,0,0,1,306,0
157,664,112,0,32,32,0,0,0,1,319,0
157,625,112,0,32,32,0,0,0,1,234,0
157,304,344,0,32,32,0,0,0,1,175,0
157,304,304,0,32,16,0,0,0,1,176,0
157,963,359,0,640,8,0,0,0,1,681,0
157,368,304,0,32,16,0,0,0,1,204,0
157,368,344,0,32,32,0,0,0,1,202,0
157,336,344,0,32,32,0,0,0,1,191,0
157,448,344,0,32,32,0,0,0,1,220,0
157,272,344,0,32,32,0,0,0,1,90,0
157,240,228,0,32,32,0,0,0,1,19,0
157,240,344,0,32,32,0,0,0,1,22,0
157,252,169,0,8,8,0,0,0,1,96,0
157,239,45,0,32,32,0,0,0,1,83,0
157,148,181,0,200,32,0,0,0,1,45,0
157,208,228,0,32,32,0,0,0,1,18,0
157,208,344,0,32,32,0,0,0,1,9,0
157,207,45,0,32,32,0,0,0,1,82,0
157,176,228,0,32,32,0,0,0,1,17,0
157,176,344,0,32,32,0,0,0,1,8,0
157,175,45,0,32,32,0,0,0,1,81,0
157,144,228,0,32,32,0,0,0,1,16,0
157,144,344,0,32,32,0,0,0,1,7,0
157,143,45,0,32,32,0,0,0,1,80,0
157,112,228,0,32,32,0,0,0,1,15,0
157,112,344,0,32,32,0,0,0,1,6,0
157,111,45,0,32,32,0,0,0,1,79,0
157,80,228,0,32,32,0,0,0,1,14,0
157,80,344,0,32,32,0,0,0,1,5,0
157,48,228,0,32,32,0,0,0,1,13,0
157,47,45,0,32,32,0,0,0,1,76,0
157,40,181,0,32,32,0,0,0,1,50,0
157,24,220,0,16,16,0,0,0,1,12,0
157,24,258,0,16,32,0,0,0,1,11,0
157,24,276,0,16,8,0,0,0,1,36,0
157,24,296,0,16,32,0,0,0,1,10,0
157,16,344,0,32,32,0,0,0,1,3,0
157,15,45,0,32,32,0,0,0,1,75,0
157,9,173,0,32,16,0,0,0,1,51,0
157,1240,112,0,32,32,0,0,0,1,479,0
172,224,312,0,1,0,0,0,0,1,23,1
155,240,296,0,1,1,0,0,0,1,27,0
155,216,320,0,2,1,0,0,0,1,28,0
155,136,320,0,3,1,0,0,0,1,31,0
155,48,360,0,1,2,0,0,0,1,57,0
155,48,344,0,2,2,0,0,0,0,58,0
155,576,181,0,1,3,0,0,0,0,67,0
155,320,181,0,2,3,0,0,0,0,68,0
172,63,44,0,1,0,0,0,0,1,77,1
169,25,133,0,1,0,0,0,0,0,107,1
155,176,176,0,1,4,0,0,0,1,109,0
155,176,176,0,2,4,0,0,0,0,110,0
155,176,176,0,3,4,0,0,0,1,117,0
155,176,176,0,1,5,0,0,0,1,119,0
155,176,176,0,2,5,0,0,0,0,120,0
155,252,185,0,1,6,0,0,0,1,125,0
155,252,177,0,2,6,0,0,0,0,126,0
155,28,289,0,1,7,0,0,0,0,137,0
155,176,289,0,2,7,0,0,0,1,138,0
155,256,240,0,1,8,0,0,0,1,180,0
155,256,312,0,2,8,0,0,0,1,181,0
169,400,296,0,1,0,0,0,0,1,218,1
169,400,264,0,1,0,0,0,0,1,223,1
169,400,328,0,1,0,0,0,0,1,225,1
155,576,181,0,3,3,0,0,0,0,230,0
155,576,344,0,4,3,0,0,0,0,231,0
155,528,344,0,5,3,0,0,0,0,232,0
155,1272,304,0,1,9,0,0,0,1,465,0
155,648,304,0,2,9,0,0,0,1,466,0
155,648,304,0,1,10,0,0,0,1,483,0
155,1272,304,0,2,10,0,0,0,1,484,0
155,648,304,0,1,11,0,0,0,1,488,0
155,1272,304,0,2,11,0,0,0,1,489,0
155,648,304,0,1,12,0,0,0,1,494,0
155,1272,304,0,2,12,0,0,0,1,495,0
155,648,304,0,1,13,0,0,0,1,500,0
155,1272,304,0,2,13,0,0,0,1,501,0
155,1272,304,0,1,14,0,0,0,1,518,0
155,648,304,0,2,14,0,0,0,1,519,0
155,648,304,0,1,15,0,0,0,1,523,0
155,1272,304,0,2,15,0,0,0,1,524,0
155,648,304,0,1,16,0,0,0,1,529,0
155,1272,304,0,2,16,0,0,0,1,530,0
155,648,304,0,1,17,0,0,0,1,535,0
155,1272,304,0,2,17,0,0,0,1,536,0
155,1272,304,0,1,18,0,0,0,1,563,0
155,648,304,0,2,18,0,0,0,1,564,0
155,651,344,0,1,19,0,0,0,1,580,0
155,1264,344,0,2,19,0,0,0,1,581,0
155,1260,124,0,1,20,0,0,0,1,625,0
155,1260,192,0,2,20,0,0,0,1,626,0
155,695,192,0,3,20,0,0,0,1,640,0
166,7,320,0,0,0,0,0,0,0,35,1
166,256,240,0,182,0,0,0,0,1,157,1
166,3,16,0,0,0,0,0,0,0,252,1
166,728,128,0,0,467,0,0,0,1,463,1
166,792,128,0,0,485,0,0,0,1,481,1
166,856,128,0,0,490,0,0,0,1,492,1
166,920,128,0,0,496,0,0,0,1,498,1
166,984,128,0,0,502,0,0,0,1,504,1
166,664,128,0,0,520,0,0,0,1,516,1
166,1048,128,0,0,525,0,0,0,1,527,1
166,1112,128,0,0,531,0,0,0,1,533,1
166,1176,128,0,0,537,0,0,0,1,539,1
166,1240,128,0,0,565,0,0,0,1,567,1
166,683,344,0,582,0,90,0,0,1,584,1
166,632,168,0,0,0,180,0,0,1,791,1
166,256,168,0,0,0,0,0,0,0,831,1
237,320,0,0,16777215,270,0,0,0,0,752,0
157,1048,112,0,32,32,0,0,0,1,476,0
157,856,112,0,32,32,0,0,0,1,473,0
157,1176,112,0,32,32,0,0,0,1,478,0
157,1112,112,0,32,32,0,0,0,1,477,0
157,696,112,0,32,32,0,0,0,1,480,0
157,728,112,0,32,32,0,0,0,1,469,0
157,792,112,0,32,32,0,0,0,1,471,0
157,920,112,0,32,32,0,0,0,1,474,0
157,984,112,0,32,32,0,0,0,1,475,0
157,1272,112,0,32,32,0,0,0,1,472,0
1234567890
25,528,288,16,16,0,288,10002,0,0,0,0
25,528,288,16,16,0,272,10002,0,0,0,0
25,528,288,16,16,0,256,10002,0,0,0,0
25,528,288,16,16,0,240,10002,0,0,0,0
25,528,288,16,16,0,224,10002,0,0,0,0
25,528,288,16,16,0,208,10002,0,0,0,0
25,528,288,16,16,0,192,10002,0,0,0,0
25,528,288,16,16,0,176,10002,0,0,0,0
25,176,0,32,48,192,240,10002,0,0,0,0
25,176,0,32,48,160,240,10002,0,0,0,0
25,176,0,32,48,128,240,10002,0,0,0,0
25,176,0,32,48,96,240,10002,0,0,0,0
25,176,0,32,48,64,240,10002,0,0,0,0
25,176,0,32,48,32,240,10002,0,0,0,0
25,176,0,32,48,32,288,10002,0,0,0,0
25,176,0,32,48,64,288,10002,0,0,0,0
25,176,0,32,48,96,288,10002,0,0,0,0
25,176,0,32,48,128,288,10002,0,0,0,0
25,176,0,32,48,160,288,10002,0,0,0,0
25,176,0,32,48,192,288,10002,0,0,0,0
25,176,0,32,48,32,336,10002,0,0,0,0
25,464,112,32,32,0,304,10002,0,0,0,0
25,544,304,16,16,16,176,10002,0,0,0,0
25,544,304,16,16,16,192,10002,0,0,0,0
25,544,304,16,16,16,224,10002,0,0,0,0
25,544,304,16,16,16,240,10002,0,0,0,0
25,544,304,16,16,32,192,10002,0,0,0,0
25,544,304,16,16,48,192,10002,0,0,0,0
25,544,304,16,16,64,192,10002,0,0,0,0
25,544,304,16,16,80,192,10002,0,0,0,0
25,544,304,16,16,96,192,10002,0,0,0,0
25,544,304,16,16,112,192,10002,0,0,0,0
25,544,304,16,16,128,192,10002,0,0,0,0
25,544,304,16,16,144,192,10002,0,0,0,0
25,544,304,16,16,160,192,10002,0,0,0,0
25,544,304,16,16,176,192,10002,0,0,0,0
25,544,304,16,16,192,192,10002,0,0,0,0
25,544,304,16,16,208,192,10002,0,0,0,0
25,544,304,16,16,240,192,10002,0,0,0,0
25,544,304,16,16,224,192,10002,0,0,0,0
25,544,304,16,16,240,208,10002,0,0,0,0
25,544,304,16,16,224,208,10002,0,0,0,0
25,544,304,16,16,208,208,10002,0,0,0,0
25,544,304,16,16,192,208,10002,0,0,0,0
25,544,304,16,16,176,208,10002,0,0,0,0
25,544,304,16,16,160,208,10002,0,0,0,0
25,544,304,16,16,144,208,10002,0,0,0,0
25,544,304,16,16,128,208,10002,0,0,0,0
25,544,304,16,16,112,208,10002,0,0,0,0
25,544,304,16,16,96,208,10002,0,0,0,0
25,544,304,16,16,80,208,10002,0,0,0,0
25,544,304,16,16,64,208,10002,0,0,0,0
25,544,304,16,16,48,208,10002,0,0,0,0
25,544,304,16,16,32,208,10002,0,0,0,0
25,544,304,16,16,16,208,10002,0,0,0,0
25,544,304,16,16,240,176,10002,0,0,0,0
25,272,0,64,48,192,128,10002,0,0,0,0
25,272,0,64,48,128,128,10002,0,0,0,0
25,272,0,64,48,64,128,10002,0,0,0,0
25,272,0,64,48,0,128,10002,0,0,0,0
25,272,0,64,48,0,80,10002,0,0,0,0
25,272,0,64,48,0,32,10002,0,0,0,0
25,272,0,64,48,64,32,10002,0,0,0,0
25,272,0,64,48,128,32,10002,0,0,0,0
25,272,0,64,48,192,32,10002,0,0,0,0
25,272,0,64,48,192,80,10002,0,0,0,0
25,272,0,64,48,128,80,10002,0,0,0,0
25,272,0,64,48,64,80,10002,0,0,0,0
25,272,16,64,32,0,0,10002,0,0,0,0
25,272,16,64,32,64,0,10002,0,0,0,0
25,272,16,64,32,128,0,10002,0,0,0,0
25,272,16,64,32,192,0,10002,0,0,0,0
25,16,240,32,16,656,336,10002,0,0,0,0
25,16,240,32,16,688,336,10002,0,0,0,0
25,16,240,32,16,720,336,10002,0,0,0,0
25,16,240,32,16,752,336,10002,0,0,0,0
25,16,240,32,16,784,336,10002,0,0,0,0
25,16,240,32,16,816,336,10002,0,0,0,0
25,16,240,32,16,848,336,10002,0,0,0,0
25,16,240,32,16,880,336,10002,0,0,0,0
25,16,240,32,16,912,336,10002,0,0,0,0
25,16,240,32,16,944,336,10002,0,0,0,0
25,16,240,32,16,976,336,10002,0,0,0,0
25,16,240,32,16,1008,336,10002,0,0,0,0
25,16,240,32,16,1040,336,10002,0,0,0,0
25,16,240,32,16,1072,336,10002,0,0,0,0
25,16,240,32,16,1104,336,10002,0,0,0,0
25,16,240,32,16,1136,336,10002,0,0,0,0
25,16,240,32,16,1168,336,10002,0,0,0,0
25,16,240,32,16,1200,336,10002,0,0,0,0
25,16,240,32,16,1232,336,10002,0,0,0,0
25,160,128,16,16,640,336,10002,0,0,0,0
25,160,112,16,16,1264,336,10002,0,0,0,0
987654321

TQ==

