UVx6TlN0AGU9Z19BNEpANVhgS1FNFjFBGHdzShJhIEV+enVgKSQ9ZmRj
259,192,176,0,32,32,0,0,0,1,7,0
259,416,144,0,32,32,0,0,0,1,8,0
259,288,208,0,32,32,0,0,0,1,9,0
259,288,272,0,32,32,0,0,0,1,10,0
259,256,240,0,32,32,0,0,0,1,11,0
259,224,208,0,32,32,0,0,0,1,12,0
259,256,208,0,32,32,0,0,0,1,13,0
259,352,272,0,32,32,0,0,0,1,14,0
259,320,240,0,32,32,0,0,0,1,15,0
259,192,208,0,32,32,0,0,0,1,16,0
259,192,144,0,32,32,0,0,0,1,17,0
259,384,144,0,32,32,0,0,0,1,18,0
259,256,144,0,32,32,0,0,0,1,19,0
259,352,144,0,32,32,0,0,0,1,20,0
259,320,144,0,32,32,0,0,0,1,21,0
259,288,144,0,32,32,0,0,0,1,22,0
259,224,144,0,32,32,0,0,0,1,23,0
259,224,80,0,32,32,0,0,0,1,24,0
259,192,80,0,32,32,0,0,0,1,25,0
259,256,80,0,32,32,0,0,0,1,26,0
259,320,80,0,32,32,0,0,0,1,27,0
259,384,80,0,32,32,0,0,0,1,28,0
259,352,80,0,32,32,0,0,0,1,29,0
259,288,80,0,32,32,0,0,0,1,30,0
259,448,112,0,32,32,0,0,0,1,31,0
259,448,80,0,32,32,0,0,0,1,32,0
259,416,80,0,32,32,0,0,0,1,33,0
259,448,144,0,32,32,0,0,0,1,34,0
259,96,304,0,32,32,0,0,0,1,35,0
259,128,144,0,32,32,0,0,0,1,36,0
259,128,176,0,32,32,0,0,0,1,37,0
259,128,80,0,32,32,0,0,0,1,38,0
259,160,80,0,32,32,0,0,0,1,39,0
259,32,304,0,32,32,0,0,0,1,40,0
259,128,112,0,32,32,0,0,0,1,42,0
259,64,304,0,32,32,0,0,0,1,43,0
259,128,272,0,32,32,0,0,0,1,44,0
259,128,240,0,32,32,0,0,0,1,45,0
259,128,304,0,32,32,0,0,0,1,46,0
259,128,208,0,32,32,0,0,0,1,47,0
259,176,304,0,32,32,0,0,0,1,152,0
259,272,304,0,32,32,0,0,0,1,153,0
259,208,304,0,32,32,0,0,0,1,154,0
259,264,328,0,32,32,0,0,0,1,155,0
259,304,304,0,32,32,0,0,0,1,156,0
259,328,304,0,16,32,0,0,0,1,157,0
259,320,208,0,32,32,0,0,0,1,173,0
259,352,240,0,32,32,0,0,0,1,174,0
259,240,304,0,32,32,0,0,0,1,175,0
259,288,328,0,32,32,0,0,0,1,176,0
259,256,328,0,32,32,0,0,0,1,177,0
259,320,328,0,32,32,0,0,0,1,178,0
259,128,336,0,32,32,0,0,0,1,181,0
160,568,312,0,1,65408,0,0,0,1,123,0
123,328,80,0,48,0,0,0,0,1,145,0
195,280,80,0,0,72,1,0,142,1,143,0
197,32,320,0,3,0,0,0,0,1,147,0
174,88,320,0,1,150,0,0,0,0,160,1
154,128,283,0,1,0.50,32,32,1,1,138,1
158,384,320,0,0,16777215,0,1,0,1,122,0
210,608,296,0,0,90,0,0,0,1,170,0
210,608,312,0,0,90,0,0,0,1,169,0
210,336,336,0,169,90,0,0,0,1,168,0
210,336,320,0,170,90,0,0,0,1,167,0
157,504,336,0,272,32,0,0,0,1,104,0
157,624,240,0,32,32,0,0,0,1,2,0
157,624,304,0,32,32,0,0,0,1,3,0
157,624,272,0,32,32,0,0,0,1,4,0
157,352,336,0,32,32,0,0,0,1,5,0
157,352,304,0,32,32,0,0,0,1,6,0
157,296,112,0,288,32,0,0,0,1,48,0
157,160,112,0,32,32,0,0,0,1,49,0
157,96,80,0,32,32,0,0,0,1,50,0
157,96,48,0,32,32,0,0,0,1,51,0
157,352,48,0,480,32,0,0,0,1,52,0
157,96,144,0,32,32,0,0,0,1,53,0
157,96,208,0,32,32,0,0,0,1,54,0
157,96,176,0,32,32,0,0,0,1,55,0
157,96,112,0,32,32,0,0,0,1,56,0
157,96,272,0,32,32,0,0,0,1,57,0
157,96,240,0,32,32,0,0,0,1,58,0
157,64,272,0,32,32,0,0,0,1,59,0
157,32,272,0,32,32,0,0,0,1,60,0
157,160,176,0,32,32,0,0,0,1,61,0
157,192,240,0,96,32,0,0,0,1,62,0
157,160,208,0,32,32,0,0,0,1,63,0
157,208,272,0,128,32,0,0,0,1,65,0
157,0,272,0,32,32,0,0,0,1,66,0
157,0,304,0,32,32,0,0,0,1,67,0
157,16,240,0,128,32,0,0,0,1,69,0
157,384,176,0,32,32,0,0,0,1,70,0
157,160,144,0,32,32,0,0,0,1,71,0
157,352,176,0,32,32,0,0,0,1,72,0
157,416,208,0,32,32,0,0,0,1,73,0
157,384,208,0,32,32,0,0,0,1,74,0
157,224,176,0,32,32,0,0,0,1,75,0
157,256,176,0,32,32,0,0,0,1,77,0
157,320,176,0,32,32,0,0,0,1,78,0
157,288,176,0,32,32,0,0,0,1,79,0
157,448,208,0,32,32,0,0,0,1,80,0
157,480,208,0,32,32,0,0,0,1,81,0
157,352,208,0,32,32,0,0,0,1,105,0
157,640,144,0,32,32,0,0,0,1,106,0
157,640,176,0,32,32,0,0,0,1,107,0
157,640,208,0,32,32,0,0,0,1,108,0
157,632,48,0,32,32,0,0,0,1,109,0
157,640,112,0,32,32,0,0,0,1,110,0
157,640,80,0,32,32,0,0,0,1,111,0
157,608,48,0,32,32,0,0,0,1,112,0
157,608,80,0,32,32,0,0,0,1,114,0
157,512,176,0,224,32,0,0,0,1,115,0
157,544,144,0,160,32,0,0,0,1,116,0
157,512,80,0,32,32,0,0,0,1,117,0
157,544,80,0,32,32,0,0,0,1,118,0
157,576,80,0,32,32,0,0,0,1,119,0
157,544,112,0,160,32,0,0,0,1,120,0
157,480,80,0,32,32,0,0,0,1,121,0
157,312,16,0,656,32,0,0,0,1,124,0
157,40,48,0,80,32,0,0,0,1,129,0
157,40,112,0,80,32,0,0,0,1,130,0
157,40,176,0,80,32,0,0,0,1,131,0
157,40,208,0,80,32,0,0,0,1,132,0
157,40,144,0,80,32,0,0,0,1,133,0
157,40,80,0,80,32,0,0,0,1,134,0
157,240,360,0,192,32,0,0,0,1,140,0
157,56,336,0,112,32,0,0,0,1,141,0
157,192,336,0,96,32,0,0,0,1,163,0
157,320,272,0,32,32,0,0,0,1,165,0
157,288,240,0,32,32,0,0,0,1,166,0
155,128,336,0,1,1,0,0,0,1,136,0
155,128,112,0,2,1,0,0,0,1,137,0
169,144,288,0,0,0,0,0,0,1,150,1
166,456,72,0,0,0,180,0,0,0,142,1
1234567890
25,96,256,48,48,576,192,10002,0,0,0,0
25,96,256,48,48,528,192,10002,0,0,0,0
25,96,256,48,48,560,240,10002,0,0,0,0
25,96,256,48,48,560,288,10002,0,0,0,0
25,96,256,48,48,512,240,10002,0,0,0,0
25,96,256,48,48,512,288,10002,0,0,0,0
25,96,256,48,48,480,192,10002,0,0,0,0
25,96,256,48,48,464,240,10002,0,0,0,0
25,96,256,48,48,464,288,10002,0,0,0,0
25,96,256,48,48,416,288,10002,0,0,0,0
25,96,256,48,48,416,240,10002,0,0,0,0
25,96,256,48,48,432,192,10002,0,0,0,0
25,96,256,48,48,384,192,10002,0,0,0,0
25,96,256,48,48,368,288,10002,0,0,0,0
25,96,256,48,48,368,240,10002,0,0,0,0
25,400,0,64,48,304,240,10002,0,0,0,0
25,400,0,64,48,304,192,10002,0,0,0,0
25,400,0,64,48,240,192,10002,0,0,0,0
25,400,0,64,48,208,240,10002,0,0,0,0
25,400,0,64,48,176,176,10002,0,0,0,0
25,400,0,64,48,176,128,10002,0,0,0,0
25,400,0,64,48,240,128,10002,0,0,0,0
25,400,0,64,48,304,128,10002,0,0,0,0
25,400,0,64,48,368,128,10002,0,0,0,0
25,400,0,64,48,432,128,10002,0,0,0,0
25,400,0,64,48,432,80,10002,0,0,0,0
25,400,0,64,48,368,64,10002,0,0,0,0
25,400,0,64,48,304,64,10002,0,0,0,0
25,400,0,64,48,192,64,10002,0,0,0,0
25,400,0,64,48,432,32,10002,0,0,0,0
25,400,0,64,48,128,64,10002,0,0,0,0
25,400,0,64,48,64,64,10002,0,0,0,0
25,400,0,64,48,112,112,10002,0,0,0,0
25,400,0,64,48,80,160,10002,0,0,0,0
25,400,0,64,48,112,208,10002,0,0,0,0
25,400,0,64,48,80,256,10002,0,0,0,0
25,400,0,64,48,16,272,10002,0,0,0,0
25,400,0,64,48,96,304,10002,0,0,0,0
25,176,176,80,48,160,288,10002,0,0,0,0
25,176,176,80,48,240,288,10002,0,0,0,0
25,176,176,80,48,272,336,10002,0,0,0,0
25,176,176,80,48,192,336,10002,0,0,0,0
25,176,176,16,16,320,288,10002,0,0,0,0
25,208,240,16,16,320,304,10002,0,0,0,0
25,208,240,16,16,320,320,10002,0,0,0,0
25,208,192,16,32,288,256,10002,0,0,0,0
25,176,240,16,16,272,256,10002,0,0,0,0
25,176,208,16,16,272,272,10002,0,0,0,0
25,544,192,16,16,624,352,10002,0,0,0,0
25,544,192,16,16,608,352,10002,0,0,0,0
25,544,192,16,16,592,352,10002,0,0,0,0
25,128,288,16,16,368,224,10002,0,0,0,0
987654321
LwFr
LkgrD0AQUS9kLmEOAEJDMRpiNQ==
Mw05FkE=
JgYuQg0jQGg=

