UVx6TlRyAGU9Z2NPJ0NMNAd9KQoeUiJHFHw7SRJhIEV+enVgKSQ9Zg==
160,80,56,0,1,16777215,0,0,0,1,72,0
195,72,168,0,0,228,0,0,943,1,20,0
178,128,68,0,16,8,0,0,0,0,944,0
123,0,344,0,128,8421504,0,0,0,1,7,0
100,0,120,0,256,32896,0,0,0,1,13,0
123,400,352,0,128,8421504,0,0,0,1,100,0
100,16,32,0,256,32768,0,0,0,1,118,0
100,104,136,0,264,0,0,0,0,1,942,0
123,256,272,0,128,255,0,0,0,1,44,0
123,304,120,0,128,16512,0,0,0,1,84,0
123,392,80,0,236,12615680,0,0,0,1,58,0
174,192,296,0,1,0,68,0,70,0,62,1
174,576,128,0,1,86,944,0,0,0,98,1
174,488,248,0,1,97,0,0,0,0,85,1
205,383.50,248,0,1,0,0.50,0,0,1,74,0
188,576,32,0,0,0,0,0,0,1,95,0
188,328,248,0,0,109,0,0,0,1,110,0
188,544,248,0,0,79,0,0,0,1,81,0
185,200,232,0,0,32,1,0,0,1,38,0
185,304,120,0,0,32,1,0,0,1,39,0
185,200,360,0,0,32,1,0,0,1,42,0
185,160,88,0,0,32,1,0,0,1,119,0
185,504,336,0,0,32,1,0,0,1,96,0
185,624,24,0,0,32,1,0,0,1,90,0
185,624,72,0,0,32,1,0,0,1,91,0
210,576,0,0,0,180,0,0,0,1,88,0
210,544,360,0,0,0,0,0,0,1,87,0
158,32,264,0,0,16777215,0,1,0,1,12,0
157,32,288,0,32,32,0,0,0,1,936,0
157,64,288,0,32,32,0,0,0,1,2,0
157,96,288,0,32,32,0,0,0,1,3,0
157,128,280,0,32,32,0,0,0,1,4,0
157,136,248,0,32,32,0,0,0,1,5,0
157,128,312,0,32,32,0,0,0,1,6,0
157,160,216,0,32,32,0,0,0,1,8,0
157,16,184,0,32,32,0,0,0,1,9,0
157,48,168,0,32,32,0,0,0,1,10,0
157,8,288,0,32,32,0,0,0,1,11,0
157,16,96,0,32,32,0,0,0,1,14,0
157,16,152,0,32,32,0,0,0,1,15,0
157,48,136,0,32,32,0,0,0,1,16,0
157,224,42,0,32,32,0,0,0,1,17,0
157,80,128,0,32,32,0,0,0,1,18,0
157,80,136,0,32,32,0,0,0,1,19,0
157,80,80,0,32,32,0,0,0,1,22,0
157,104,80,0,32,32,0,0,0,1,23,0
157,48,80,0,32,32,0,0,0,1,24,0
157,193,42,0,32,32,0,0,0,1,25,0
157,32,352,0,32,32,0,0,0,1,26,0
157,119,342,0,32,32,0,0,0,1,27,0
157,256,42,0,32,32,0,0,0,1,28,0
157,192,192,0,32,32,0,0,0,1,29,0
157,296,232,0,32,32,0,0,0,1,30,0
157,160,248,0,32,32,0,0,0,1,31,0
157,160,280,0,32,32,0,0,0,1,32,0
157,160,312,0,32,32,0,0,0,1,33,0
157,160,344,0,32,32,0,0,0,1,34,0
157,136,344,0,32,32,0,0,0,1,35,0
157,120,320,0,32,32,0,0,0,1,36,0
157,120,360,0,32,32,0,0,0,1,37,0
157,272,360,0,32,32,0,0,0,1,40,0
157,240,352,0,32,32,0,0,0,1,41,0
157,193,312,0,32,32,0,0,0,1,43,0
157,296,200,0,32,32,0,0,0,1,45,0
157,224,200,0,32,32,0,0,0,1,46,0
157,304,264,0,32,32,0,0,0,1,47,0
157,336,264,0,32,32,0,0,0,1,48,0
157,376,344,0,32,32,0,0,0,1,51,0
157,366,360,0,32,32,0,0,0,1,52,0
157,304,42,0,64,32,0,0,0,1,56,0
157,408,42,0,144,32,0,0,0,1,57,0
157,368,72,0,32,32,0,0,0,1,59,0
157,112,0,0,32,32,0,0,0,1,64,0
157,8,64,0,32,32,0,0,0,1,65,0
157,368,264,0,32,32,0,0,0,1,82,0
157,296,168,0,32,32,0,0,0,1,83,0
157,16,0,0,32,32,0,0,0,1,112,0
157,48,0,0,32,32,0,0,0,1,113,0
157,80,0,0,32,32,0,0,0,1,114,0
157,0,32,0,32,32,0,0,0,1,115,0
157,0,200,0,32,32,0,0,0,1,120,0
157,0,224,0,32,32,0,0,0,1,121,0
157,0,256,0,32,32,0,0,0,1,122,0
157,32,280,0,32,32,0,0,0,1,123,0
157,400,324,0,32,32,0,0,0,1,49,0
157,416,296,0,32,32,0,0,0,1,50,0
157,464,264,0,64,32,0,0,0,1,67,0
157,440,344,0,32,32,0,0,0,1,101,0
157,436,312,0,32,32,0,0,0,1,102,0
157,416,72,0,32,32,0,0,0,1,60,0
157,504,120,0,32,32,0,0,0,1,106,0
157,576,144,0,32,32,0,0,0,1,89,0
157,632,48,0,32,32,0,0,0,1,92,0
157,624,312,0,32,32,0,0,0,1,105,0
157,624,344,0,32,32,0,0,0,1,103,0
157,624,264,0,32,32,0,0,0,1,104,0
157,544,376,0,32,32,0,0,0,1,941,0
169,440,216,0,0,0,0,0,0,1,68,1
169,440,184,0,0,0,0,0,0,1,70,1
172,520,248,0,0,0,0,0,0,1,79,1
172,560,32,0,0,0,0,0,0,1,93,1
166,0,320,0,0,0,0,0,0,1,66,1
166,440,288,0,0,0,0,0,0,1,86,1
166,596,352,0,0,0,107,0,0,1,97,1
166,296,288,0,0,0,316,0,0,1,109,1
166,256,64,0,0,0,270,0,0,0,943,1
237,320,0,0,16777215,300,0,0,0,1,21,0
255,258,246,0,128,128,1,0,0,1,76,0
255,544,376,0,128,128,1,0,0,1,99,0
253,112,96,0,16777215,0,0,0,0,1,77,0
253,80,152,0,16777215,0,0,0,0,1,107,0
253,32,16,0,16777215,0,0,0,0,1,116,0
196,296.50,288,0,0,0,0,0,0,0,0,0
1234567890
25,208,176,16,16,48,144,10002,0,0,0,0
25,272,256,16,16,128,320,10002,0,0,0,0
25,272,304,64,48,16,192,10002,0,0,0,0
25,272,304,64,48,16,240,10002,0,0,0,0
25,240,288,32,64,80,208,10002,0,0,0,0
25,592,304,32,32,16,16,10002,0,0,0,0
25,464,304,64,32,48,336,10002,0,0,0,0
25,528,320,32,16,16,48,10002,0,0,0,0
25,528,320,32,16,48,48,10002,0,0,0,0
25,528,320,32,16,16,64,10002,0,0,0,0
25,528,320,32,16,80,0,10002,0,0,0,0
25,528,320,32,16,80,16,10002,0,0,0,0
25,176,176,80,80,176,208,10002,0,0,0,0
25,176,176,80,80,256,208,10002,0,0,0,0
25,176,176,80,80,176,288,10002,0,0,0,0
25,176,176,80,80,256,288,10002,0,0,0,0
25,176,176,80,80,336,288,10002,0,0,0,0
25,256,80,16,160,208,32,10002,0,0,0,0
25,256,80,16,160,224,32,10002,0,0,0,0
25,256,80,16,160,192,32,10002,0,0,0,0
25,256,80,16,160,176,32,10002,0,0,0,0
25,256,80,16,160,112,-16,10002,0,0,0,0
25,256,80,16,160,112,144,10002,0,0,0,0
25,144,256,64,64,240,144,10002,0,0,0,0
25,144,256,64,64,240,80,10002,0,0,0,0
25,144,256,64,64,240,16,10002,0,0,0,0
25,144,256,64,64,304,16,10002,0,0,0,0
25,144,256,64,64,304,80,10002,0,0,0,0
25,144,256,64,64,304,144,10002,0,0,0,0
25,144,256,64,64,336,208,10002,0,0,0,0
25,144,256,64,64,368,144,10002,0,0,0,0
25,144,256,64,64,368,80,10002,0,0,0,0
25,144,256,64,64,368,16,10002,0,0,0,0
25,144,256,64,64,400,208,10002,0,0,0,0
25,144,256,64,64,432,144,10002,0,0,0,0
25,144,256,64,64,464,208,10002,0,0,0,0
25,144,256,64,64,528,208,10002,0,0,0,0
25,144,256,64,64,592,208,10002,0,0,0,0
25,144,256,64,64,496,144,10002,0,0,0,0
25,144,256,64,64,560,144,10002,0,0,0,0
25,144,256,64,64,624,144,10002,0,0,0,0
987654321
Fwc/EEAuVWlxPnlBc05JM0ApO1RLCDVOWWB5WFgjbRsxKzAjJWZ0JichNQooWWF1WTc0dg==
T0g9FRdsQz1gKmFaO0lMKUAtaVwAHT9PVmN4Cks8Ixw8LjwoK2R5JncnLh87Gg==
Wll/U05yEGAlKGJeOk5felgpO1RHGz4CHGtjCltxYBAhaikxd3F/Ii0gJBw=
BQckQgonRWlka3lBJlg=

