UVx6TlN0AGU9Z0hCKk1ENEAkcl1CUhFMGGt2CxJhIEV+enVgKSQ9ZmRj
160,440,104,0,1,16777215,0,0,0,1,8,0
100,48,176,0,256,255,0,228,0,1,314,0
123,360,88,0,128,0,0,0,0,1,317,0
123,288,264,0,128,0,0,0,0,1,316,0
100,128,104,0,256,8388608,0,228,0,1,3,0
100,456,144,0,256,4194432,0,229,0,1,315,0
100,120,208,0,256,33023,0,228,0,1,322,0
123,168,248,0,128,0,0,0,0,1,2,0
195,216,88,0,0,128,211,0,129,1,95,0
100,192,104,0,256,65280,0,228,0,1,166,0
197,32,304,0,2,21,0,0,0,1,11,0
197,440,192,0,2,0,0,0,0,1,292,0
197,168,48,0,2,0,0,0,0,1,169,0
174,120,320,0,1,82,0,0,0,0,93,1
174,312,208,0,1,134,0,0,0,0,163,1
174,208,256,0,1,0,180,0,0,0,179,1
205,304.50,320,0,1,0,0.50,0,0,1,277,0
189,232,240,0,173,128,184,0,179,1,5,0
185,32,184.50,0,78,16,1,0,0,1,6,0
154,32,184.50,0,1,0.50,32,32,-1,1,78,0
154,312,24.50,0,2,0.50,16,16,-1,1,155,1
154,207.50,240,1,3,0.50,16,16,-1,1,173,1
158,48,74,0,0,16777215,0,1,0,1,7,0
210,368,296,0,296,90,0,0,0,1,279,0
210,368,312,0,296,90,0,0,0,1,278,0
210,376,288,0,278,0,0,0,0,1,296,0
210,408,280,0,297,90,0,0,0,1,280,0
210,464,232,0,288,90,0,0,0,1,283,0
210,464,184,0,282,90,0,0,0,1,289,0
210,384,54,0,283,180,0,0,0,1,305,0
210,296,208,0,185,0,0,0,0,1,184,0
210,280,48,0,184,0,0,0,0,1,185,0
210,464,248,0,289,90,0,0,0,1,282,0
210,416,256,0,280,0,0,0,0,1,297,0
210,384,200,0,280,270,0,0,0,1,301,0
210,440,144,0,305,180,0,0,0,1,306,0
210,352,232,0,289,270,0,0,0,1,286,0
210,464,168,0,283,90,0,0,0,1,288,0
210,408,264,0,297,90,0,0,0,1,281,0
210,352,216,0,288,270,0,0,0,1,287,0
157,47,90,0,32,32,0,0,0,1,8,0
157,288,336,0,32,32,0,0,0,1,12,0
157,256,336,0,32,32,0,0,0,1,13,0
157,224,336,0,32,32,0,0,0,1,14,0
157,192,336,0,32,32,0,0,0,1,15,0
157,160,336,0,32,32,0,0,0,1,16,0
157,128,336,0,32,32,0,0,0,1,17,0
157,96,336,0,32,32,0,0,0,1,18,0
157,64,320,0,32,32,0,0,0,1,19,0
157,16,320,0,32,32,0,0,0,1,20,0
157,144,272,0,32,32,0,0,0,1,23,0
157,144,224,0,32,32,0,0,0,1,24,0
157,144,192,0,32,32,0,0,0,1,25,0
157,144,160,0,32,32,0,0,0,1,26,0
157,144,96,0,32,32,0,0,0,1,28,0
157,144,64,0,32,32,0,0,0,1,29,0
157,144,32,0,32,32,0,0,0,1,30,0
157,112,24,0,32,32,0,0,0,1,31,0
157,80,24,0,32,32,0,0,0,1,32,0
157,48,24,0,32,32,0,0,0,1,33,0
157,16,32,0,32,32,0,0,0,1,34,0
157,16,64,0,32,32,0,0,0,1,35,0
157,15,90,0,32,32,0,0,0,1,36,0
157,0,160,0,32,32,0,0,0,1,38,0
157,0,192,0,32,32,0,0,0,1,39,0
157,0,224,0,32,32,0,0,0,1,40,0
157,0,256,0,32,32,0,0,0,1,41,0
157,0,288,0,32,32,0,0,0,1,42,0
157,48,320,0,32,32,0,0,0,1,43,0
157,64,336,0,32,32,0,0,0,1,56,0
157,32,336,0,32,32,0,0,0,1,57,0
157,8,336,0,32,32,0,0,0,1,58,0
157,144,240,0,32,32,0,0,0,1,60,0
157,0,120,0,32,32,0,0,0,1,74,0
157,64,256,0,32,32,0,0,0,1,84,0
157,64,224,0,32,32,0,0,0,1,85,0
157,64,192,0,32,32,0,0,0,1,86,0
157,64,160,0,32,32,0,0,0,1,87,0
157,272,256,0,32,32,0,0,0,1,98,0
157,208,272,0,32,32,0,0,0,1,99,0
157,320,336,0,32,32,0,0,0,1,100,0
157,352,336,0,32,32,0,0,0,1,101,0
157,384,336,0,32,32,0,0,0,1,102,0
157,416,336,0,32,32,0,0,0,1,103,0
157,448,336,0,32,32,0,0,0,1,104,0
157,448,304,0,32,32,0,0,0,1,105,0
157,448,272,0,32,32,0,0,0,1,106,0
157,480,336,0,32,32,0,0,0,1,107,0
157,480,304,0,32,32,0,0,0,1,108,0
157,480,272,0,32,32,0,0,0,1,109,0
157,480,240,0,32,32,0,0,0,1,110,0
157,480,144,0,32,32,0,0,0,1,111,0
157,472,208,0,32,32,0,0,0,1,112,0
157,480,176,0,32,32,0,0,0,1,113,0
157,384,304,0,32,32,0,0,0,1,114,0
157,424,272,0,32,32,0,0,0,1,115,0
157,416,304,0,32,32,0,0,0,1,116,0
157,272,272,0,32,32,0,0,0,1,117,0
157,176,160,0,32,32,0,0,0,1,118,0
157,208,160,0,32,32,0,0,0,1,119,0
157,240,160,0,32,32,0,0,0,1,120,0
157,208,64,0,32,32,0,0,0,1,123,0
157,176,64,0,32,32,0,0,0,1,124,0
157,272,160,0,32,32,0,0,0,1,125,0
157,272,88,0,32,32,0,0,0,1,126,0
157,272,64,0,32,32,0,0,0,1,127,0
157,240,64,0,32,32,0,0,0,1,128,0
157,272,96,0,32,32,0,0,0,1,131,0
157,336,160,0,32,32,0,0,0,1,135,0
157,336,128,0,32,32,0,0,0,1,136,0
157,336,96,0,32,32,0,0,0,1,137,0
157,336,64,0,32,32,0,0,0,1,138,0
157,336,32,0,32,32,0,0,0,1,139,0
157,16,8,0,32,32,0,0,0,1,140,0
157,48,8,0,32,32,0,0,0,1,141,0
157,80,8,0,32,32,0,0,0,1,142,0
157,112,8,0,32,32,0,0,0,1,143,0
157,144,10,0,32,32,0,0,0,1,144,0
157,176,0,0,32,32,0,0,0,1,145,0
157,208,0,0,32,32,0,0,0,1,146,0
157,232,0,0,32,32,0,0,0,1,147,0
157,264,0,0,32,32,0,0,0,1,148,0
157,288,0,0,32,32,0,0,0,1,149,0
157,312,0,0,32,32,0,0,0,1,150,0
157,336,0,0,32,32,0,0,0,1,151,0
157,272,192,0,32,32,0,0,0,1,158,0
157,272,224,0,32,32,0,0,0,1,159,0
157,304,224,0,32,32,0,0,0,1,160,0
157,336,224,0,32,32,0,0,0,1,161,0
157,336,192,0,32,32,0,0,0,1,162,0
157,512,336,0,32,32,0,0,0,1,189,0
157,512,304,0,32,32,0,0,0,1,190,0
157,512,272,0,32,32,0,0,0,1,191,0
157,512,240,0,32,32,0,0,0,1,192,0
157,502,208,0,32,32,0,0,0,1,193,0
157,512,176,0,32,32,0,0,0,1,194,0
157,512,144,0,32,32,0,0,0,1,195,0
157,480,112,0,32,32,0,0,0,1,196,0
157,512,112,0,32,32,0,0,0,1,197,0
157,480,80,0,32,32,0,0,0,1,198,0
157,480,48,0,32,32,0,0,0,1,199,0
157,448,40,0,32,32,0,0,0,1,200,0
157,416,40,0,32,32,0,0,0,1,201,0
157,384,40,0,32,32,0,0,0,1,202,0
157,360,40,0,32,32,0,0,0,1,203,0
157,368,16,0,32,32,0,0,0,1,204,0
157,400,16,0,32,32,0,0,0,1,205,0
157,432,16,0,32,32,0,0,0,1,206,0
157,456,16,0,32,32,0,0,0,1,207,0
157,480,16,0,32,32,0,0,0,1,208,0
157,512,80,0,32,32,0,0,0,1,209,0
157,512,48,0,32,32,0,0,0,1,210,0
157,512,16,0,32,32,0,0,0,1,211,0
157,544,16,0,32,32,0,0,0,1,212,0
157,576,16,0,32,32,0,0,0,1,213,0
157,608,16,0,32,32,0,0,0,1,214,0
157,624,16,0,32,32,0,0,0,1,215,0
157,544,48,0,32,32,0,0,0,1,216,0
157,544,80,0,32,32,0,0,0,1,217,0
157,544,112,0,32,32,0,0,0,1,218,0
157,544,176,0,32,32,0,0,0,1,219,0
157,544,144,0,32,32,0,0,0,1,220,0
157,544,208,0,32,32,0,0,0,1,221,0
157,544,240,0,32,32,0,0,0,1,222,0
157,544,272,0,32,32,0,0,0,1,223,0
157,544,304,0,32,32,0,0,0,1,224,0
157,544,336,0,32,32,0,0,0,1,225,0
157,576,336,0,32,32,0,0,0,1,226,0
157,608,336,0,32,32,0,0,0,1,227,0
157,608,304,0,32,32,0,0,0,1,228,0
157,576,304,0,32,32,0,0,0,1,229,0
157,576,272,0,32,32,0,0,0,1,230,0
157,608,272,0,32,32,0,0,0,1,231,0
157,608,240,0,32,32,0,0,0,1,232,0
157,576,240,0,32,32,0,0,0,1,233,0
157,576,208,0,32,32,0,0,0,1,234,0
157,608,208,0,32,32,0,0,0,1,235,0
157,608,176,0,32,32,0,0,0,1,236,0
157,576,176,0,32,32,0,0,0,1,237,0
157,576,144,0,32,32,0,0,0,1,238,0
157,576,112,0,32,32,0,0,0,1,239,0
157,576,80,0,32,32,0,0,0,1,240,0
157,576,48,0,32,32,0,0,0,1,241,0
157,608,48,0,32,32,0,0,0,1,242,0
157,608,80,0,32,32,0,0,0,1,243,0
157,608,112,0,32,32,0,0,0,1,244,0
157,608,144,0,32,32,0,0,0,1,245,0
157,640,48,0,32,32,0,0,0,1,246,0
157,640,80,0,32,32,0,0,0,1,247,0
157,640,112,0,32,32,0,0,0,1,248,0
157,640,144,0,32,32,0,0,0,1,249,0
157,640,176,0,32,32,0,0,0,1,250,0
157,640,208,0,32,32,0,0,0,1,251,0
157,640,232,0,32,32,0,0,0,1,252,0
157,640,256,0,32,32,0,0,0,1,253,0
157,640,288,0,32,32,0,0,0,1,254,0
157,640,320,0,32,32,0,0,0,1,255,0
157,640,352,0,32,32,0,0,0,1,256,0
157,608,360,0,32,32,0,0,0,1,257,0
157,576,360,0,32,32,0,0,0,1,258,0
157,552,360,0,32,32,0,0,0,1,259,0
157,520,360,0,32,32,0,0,0,1,260,0
157,488,360,0,32,32,0,0,0,1,261,0
157,456,360,0,32,32,0,0,0,1,262,0
157,424,360,0,32,32,0,0,0,1,263,0
157,392,360,0,32,32,0,0,0,1,264,0
157,360,360,0,32,32,0,0,0,1,265,0
157,328,360,0,32,32,0,0,0,1,266,0
157,296,360,0,32,32,0,0,0,1,267,0
157,272,360,0,32,32,0,0,0,1,268,0
157,240,360,0,32,32,0,0,0,1,269,0
157,208,360,0,32,32,0,0,0,1,270,0
157,176,360,0,32,32,0,0,0,1,271,0
157,144,360,0,32,32,0,0,0,1,272,0
157,112,360,0,32,32,0,0,0,1,273,0
157,80,360,0,32,32,0,0,0,1,274,0
157,48,360,0,32,32,0,0,0,1,275,0
157,16,360,0,32,32,0,0,0,1,276,0
157,448,128,0,32,32,0,0,0,1,284,0
157,416,128,0,32,32,0,0,0,1,285,0
157,440,208,0,32,32,0,0,0,1,290,0
157,368,192,0,32,32,0,0,0,1,291,0
157,512,208,0,32,32,0,0,0,1,310,0
157,0,136,0,32,32,0,0,0,1,323,0
169,56,272,0,0,0,0,0,0,1,21,1
155,104,288,0,1,1,0,0,0,1,76,0
155,104,128,0,2,1,0,0,0,1,77,0
169,144,288,0,0,0,0,0,0,1,82,1
155,32,128,0,3,1,0,0,0,1,88,0
155,32,288,0,4,1,0,0,0,1,89,0
155,104,288,0,5,1,0,0,0,1,90,0
169,256,112,0,0,0,0,0,0,0,129,1
155,312,24,0,1,2,0,0,0,1,153,0
155,312,168,0,2,2,0,0,0,1,154,0
155,176,240,0,1,3,0,0,0,1,171,0
155,240,240,0,2,3,0,0,0,1,172,0
155,240,304,0,3,3,0,0,0,1,175,0
155,176,304,0,4,3,0,0,0,1,176,0
155,176,240,0,5,3,0,0,0,1,177,0
155,240,240,0,6,3,0,0,0,1,178,0
169,272,288,0,0,0,0,0,0,1,180,1
166,312,24,0,155,0,180,0,0,1,134,1
1234567890
25,0,0,48,48,16,256,10002,0,0,0,0
25,0,0,48,48,64,256,10002,0,0,0,0
25,0,0,48,48,16,208,10002,0,0,0,0
25,0,0,48,48,16,160,10002,0,0,0,0
25,0,0,48,48,16,112,10002,0,0,0,0
25,0,0,48,48,16,16,10002,0,0,0,0
25,0,0,48,48,64,16,10002,0,0,0,0
25,0,0,48,48,112,16,10002,0,0,0,0
25,0,0,48,48,112,64,10002,0,0,0,0
25,0,0,48,48,64,64,10002,0,0,0,0
25,0,0,48,48,16,64,10002,0,0,0,0
25,48,0,48,48,112,112,10002,0,0,0,0
25,48,0,48,48,112,160,10002,0,0,0,0
25,48,0,48,48,112,208,10002,0,0,0,0
25,48,0,48,48,112,256,10002,0,0,0,0
25,48,0,48,48,112,304,10002,0,0,0,0
25,0,0,48,48,64,112,10002,0,0,0,0
25,0,0,48,48,64,160,10002,0,0,0,0
25,0,0,48,48,64,208,10002,0,0,0,0
25,0,0,48,48,64,304,10002,0,0,0,0
25,96,0,48,48,160,112,10002,0,0,0,0
25,96,0,48,48,208,112,10002,0,0,0,0
25,96,0,48,48,208,64,10002,0,0,0,0
25,96,0,48,48,160,64,10002,0,0,0,0
25,336,96,64,48,160,0,10002,0,0,0,0
25,336,96,64,48,224,0,10002,0,0,0,0
25,336,96,64,48,288,64,10002,0,0,0,0
25,336,96,64,48,288,16,10002,0,0,0,0
25,96,304,48,48,160,272,10002,0,0,0,0
25,96,304,48,48,160,224,10002,0,0,0,0
25,96,304,48,48,160,176,10002,0,0,0,0
25,96,304,48,48,208,176,10002,0,0,0,0
25,96,304,48,48,208,224,10002,0,0,0,0
25,96,304,48,48,208,272,10002,0,0,0,0
25,96,256,48,48,256,272,10002,0,0,0,0
25,96,256,48,48,304,272,10002,0,0,0,0
25,96,256,48,48,304,224,10002,0,0,0,0
25,96,256,48,48,256,224,10002,0,0,0,0
25,96,256,48,48,352,272,10002,0,0,0,0
25,96,256,48,48,352,224,10002,0,0,0,0
25,96,256,48,48,352,176,10002,0,0,0,0
25,96,256,48,48,400,272,10002,0,0,0,0
25,96,256,48,48,400,224,10002,0,0,0,0
25,96,256,48,48,448,224,10002,0,0,0,0
25,96,256,48,48,400,176,10002,0,0,0,0
25,96,256,48,48,448,176,10002,0,0,0,0
25,96,256,48,48,416,128,10002,0,0,0,0
25,96,256,48,48,368,128,10002,0,0,0,0
25,96,256,48,48,320,128,10002,0,0,0,0
25,272,96,64,48,256,112,10002,0,0,0,0
25,272,96,64,48,256,160,10002,0,0,0,0
25,144,0,32,48,352,80,10002,0,0,0,0
25,144,0,32,48,384,80,10002,0,0,0,0
25,144,0,32,48,416,80,10002,0,0,0,0
25,144,0,32,48,448,80,10002,0,0,0,0
25,144,0,32,48,352,32,10002,0,0,0,0
25,144,0,32,48,384,32,10002,0,0,0,0
25,144,0,32,48,416,32,10002,0,0,0,0
25,144,0,32,48,448,32,10002,0,0,0,0
24,112,320,48,32,192,16,10000,0,0,0,0
24,64,256,32,32,192,224,10000,0,0,0,0
24,64,256,32,32,336,304,10000,0,0,0,0
24,64,256,32,32,368,256,10000,0,0,0,0
24,112,160,16,32,432,224,10000,0,0,0,0
24,288,176,32,32,288,16,10000,0,0,0,0
24,160,80,48,16,304,288,10000,0,0,0,0
24,80,32,16,32,240,176,10000,0,0,0,0
24,80,64,16,16,240,208,10000,0,0,0,0
24,80,64,16,16,240,224,10000,0,0,0,0
24,80,64,16,16,240,240,10000,0,0,0,0
24,80,64,16,16,240,256,10000,0,0,0,0
24,80,64,16,16,240,272,10000,0,0,0,0
24,80,64,16,16,240,288,10000,0,0,0,0
24,80,80,16,16,240,304,10000,0,0,0,0
24,352,224,16,16,32,32,10000,0,0,0,0
24,96,96,32,32,80,32,10000,0,0,0,0
24,496,224,16,64,80,144,10000,0,0,0,0
24,496,224,16,64,80,208,10000,0,0,0,0
24,128,160,32,32,16,272,10000,0,0,0,0
24,416,160,16,16,288,288,10000,0,0,0,0
24,320,16,16,16,368,80,10000,0,0,0,0
24,432,144,32,16,96,144,10000,0,0,0,0
24,64,256,32,32,96,272,10000,0,0,0,0
24,112,160,16,32,80,288,10000,0,0,0,0
24,512,224,32,64,192,80,10000,0,0,0,0
987654321
LR05FkAjEDtkJWlBPgtdNlU1fkoOETYCDW1+Cx42bRg3ZA==

