UVx6TlN0AGU9Z09HJUJIKEdgVFVMDDVRVTU7SBJhIEV+enVgKSQ=
259,72,224,0,32,32,0,0,0,1,23,0
259,40,224,0,32,32,0,0,0,1,24,0
259,8,224,0,32,32,0,0,0,1,25,0
259,112,360,0,32,32,0,0,0,1,26,0
259,144,360,0,32,32,0,0,0,1,27,0
259,152,360,0,32,32,0,0,0,1,28,0
259,184,224,0,32,32,0,0,0,1,29,0
259,216,224,0,32,32,0,0,0,1,30,0
259,248,224,0,32,32,0,0,0,1,31,0
259,256,224,0,32,32,0,0,0,1,32,0
259,384,224,0,32,32,0,0,0,1,33,0
259,440,224,0,32,32,0,0,0,1,34,0
259,416,224,0,32,32,0,0,0,1,35,0
259,376,360,0,32,32,0,0,0,1,36,0
259,408,360,0,32,32,0,0,0,1,37,0
259,416,360,0,32,32,0,0,0,1,38,0
259,616,288,0,32,32,0,0,0,1,39,0
259,632,288,0,32,32,0,0,0,1,41,0
259,552,288,0,32,32,0,0,0,1,42,0
259,56,192,0,32,32,0,0,0,1,43,0
259,56,128,0,32,32,0,0,0,1,44,0
259,80,128,0,32,32,0,0,0,1,45,0
259,176,104,0,32,32,0,0,0,1,46,0
259,208,104,0,32,32,0,0,0,1,47,0
259,224,104,0,32,32,0,0,0,1,48,0
259,288,104,0,32,32,0,0,0,1,49,0
259,312,104,0,32,32,0,0,0,1,50,0
259,328,104,0,32,32,0,0,0,1,51,0
259,392,104,0,32,32,0,0,0,1,52,0
259,416,104,0,32,32,0,0,0,1,53,0
259,432,104,0,32,32,0,0,0,1,54,0
259,496,104,0,32,32,0,0,0,1,55,0
259,560,104,0,32,32,0,0,0,1,56,0
259,528,104,0,32,32,0,0,0,1,57,0
259,624,104,0,32,32,0,0,0,1,61,0
160,624,168,0,0,16777215,0,0,0,1,18,0
100,0,208,0,256,0,0,56,0,1,124,0
197,464,88,0,2,0,0,0,0,1,60,0
174,144,88,0,1,118,122,0,0,0,119,1
189,12,152,0,0,128,299,0,0,1,125,0
158,32,344,0,0,16777215,0,1,0,1,17,0
157,48,352,0,96,16,0,0,0,1,101,0
157,216,352,0,96,16,0,0,0,1,2,0
157,312,352,0,96,16,0,0,0,1,3,0
157,480,352,0,96,16,0,0,0,1,4,0
157,576,352,0,96,16,0,0,0,1,5,0
157,600,352,0,96,16,0,0,0,1,6,0
157,496,216,0,80,16,0,0,0,1,7,0
157,328,216,0,80,16,0,0,0,1,8,0
157,312,216,0,80,16,0,0,0,1,9,0
157,128,216,0,80,16,0,0,0,1,10,0
157,144,96,0,32,16,0,0,0,1,11,0
157,256,96,0,32,16,0,0,0,1,12,0
157,360,96,0,32,16,0,0,0,1,13,0
157,464,96,0,32,16,0,0,0,1,14,0
157,592,96,0,32,16,0,0,0,1,16,0
157,552,224,0,32,32,0,0,0,1,19,0
157,584,288,0,32,32,0,0,0,1,20,0
157,112,104,0,32,32,0,0,0,1,21,0
157,56,160,0,32,32,0,0,0,1,22,0
157,112,232,0,48,16,0,0,0,1,104,0
157,144,232,0,48,16,0,0,0,1,105,0
157,296,232,0,48,16,0,0,0,1,106,0
157,344,232,0,48,16,0,0,0,1,107,0
157,480,232,0,48,16,0,0,0,1,108,0
157,512,232,0,48,16,0,0,0,1,109,0
157,464,112,0,32,16,0,0,0,1,110,0
157,360,112,0,32,16,0,0,0,1,111,0
157,256,112,0,32,16,0,0,0,1,112,0
157,144,112,0,32,16,0,0,0,1,113,0
157,592,112,0,32,16,0,0,0,1,114,0
157,64,216,0,48,16,0,0,0,1,115,0
157,16,216,0,48,16,0,0,0,1,116,0
157,552,256,0,32,32,0,0,0,1,117,0
157,584,128,0,16,16,0,0,0,1,126,0
166,1,248,0,0,0,0,0,0,1,58,1
166,8,128,0,0,0,0,0,0,0,118,1
166,160,8,0,0,0,270,0,0,1,122,1
1234567890
24,368,208,32,16,96,288,10000,0,0,0,0
24,368,208,32,16,352,288,10000,0,0,0,0
24,368,208,32,16,400,288,10000,0,0,0,0
24,368,208,32,16,144,288,10000,0,0,0,0
24,368,208,32,16,608,304,10000,0,0,0,0
24,368,208,32,16,416,160,10000,0,0,0,0
24,368,208,32,16,368,160,10000,0,0,0,0
24,368,208,32,16,240,160,10000,0,0,0,0
24,368,208,32,16,176,160,10000,0,0,0,0
24,368,208,32,16,208,160,10000,0,0,0,0
24,368,208,32,16,64,96,10000,0,0,0,0
24,368,208,32,16,160,32,10000,0,0,0,0
24,368,208,32,16,208,32,10000,0,0,0,0
24,368,208,32,16,272,32,10000,0,0,0,0
24,368,208,32,16,304,32,10000,0,0,0,0
24,368,208,32,16,384,32,10000,0,0,0,0
24,368,208,32,16,416,32,10000,0,0,0,0
24,368,208,32,16,480,32,10000,0,0,0,0
24,368,208,32,16,544,32,10000,0,0,0,0
24,368,208,32,16,512,32,10000,0,0,0,0
24,368,208,32,16,608,64,10000,0,0,0,0
24,256,240,48,16,32,176,10000,0,0,0,0
24,112,160,16,32,624,320,10000,0,0,0,0
24,0,256,64,32,96,48,10000,0,0,0,0
24,352,16,16,16,128,176,10000,0,0,0,0
24,352,16,16,16,112,176,10000,0,0,0,0
24,352,16,16,16,96,176,10000,0,0,0,0
24,352,16,16,16,80,176,10000,0,0,0,0
24,288,0,32,32,320,176,10000,0,0,0,0
24,288,176,32,32,496,272,10000,0,0,0,0
24,0,288,464,32,0,0,10000,0,0,0,0
24,0,288,464,32,464,0,10000,0,0,0,0
24,432,64,32,32,64,304,10000,0,0,0,0
24,128,160,32,32,0,160,10000,0,0,0,0
24,112,224,32,32,160,64,10000,0,0,0,0
24,112,320,48,32,272,256,10000,0,0,0,0
24,416,192,16,32,48,320,10000,0,0,0,0
24,416,192,16,32,48,288,10000,0,0,0,0
24,416,192,16,32,48,256,10000,0,0,0,0
24,416,192,16,32,48,224,10000,0,0,0,0
24,416,192,16,32,32,320,10000,0,0,0,0
24,416,192,16,32,32,288,10000,0,0,0,0
24,416,192,16,32,32,256,10000,0,0,0,0
24,416,192,16,32,32,224,10000,0,0,0,0
24,320,240,48,16,320,320,10000,0,0,0,0
24,320,240,48,16,240,176,10000,0,0,0,0
24,32,192,32,32,176,192,10000,0,0,0,0
987654321
LQ1qEQErQ2l1Kn4=
KQckQhAuRTo=
KQckQhAuWTo=
MwlqBRUnRSVg

