XlF4Tll7AmU9Z0NLJllCMlU2ekpKUiNKGGFyCxJhIEV+enVgKSQ9ZmRj
160,128,960,0,0,16777215,0,0,0,1,7,0
178,312,816,0,16,32,0,0,0,0,239,0
100,352,440,0,492,0,0,222,0,1,432,0
100,192,808,0,444,0,0,323,0,1,278,0
123,240,704,0,104,0,0,0,0,1,159,0
123,40,872,0,173,8421504,0,0,0,1,29,0
123,40,648,0,144,0,0,0,0,1,164,0
123,672,864,0,196,16777215,0,0,0,1,89,0
123,56,560,0,124,8421504,0,0,0,1,404,0
123,480,176,0,164,0,0,0,0,1,295,0
123,720,176,0,160,0,0,0,0,1,291,0
197,40,112,0,2,0,0,0,0,1,17,0
197,616,320,0,2,0,0,0,0,1,382,0
197,712,896,0,2,0,0,0,0,1,381,0
174,824,824,0,1,264,248,246,247,0,231,1
174,200,672,0,1,104,198,0,0,0,141,1
174,672,776,0,1,0,239,0,54,0,98,1
174,240,880,0,1,54,0,0,0,0,58,1
174,88,112,0,1,15,0,0,0,0,18,1
174,736,224,0,1,384,397,396,395,0,383,1
194,528,16,0,0,216,270,0,0,1,396,0
194,616,17,0,0,216,270,0,0,1,397,0
181,856.50,360,0,343,184,0,0,0,1,339,0
181,228.84,652.06,0,365,128,0,0,0,1,153,0
181,612.80,788.82,0,421,128,0,0,0,1,425,0
181,594,912,0,81,144,0,0,0,1,74,0
181,540.25,359.19,0,353,168,0,0,0,1,355,0
186,936,768,0,32,32,0,0,0,1,256,0
186,264,592,0,32,32,0,0,0,1,38,0
219,616,288,0,32,96,0,0,0,1,384,1
219,568,96,0,144,32,0,0,0,1,395,1
188,912,896,0,0,222,0,0,0,1,257,0
188,224,880,0,0,32,0,0,0,1,37,0
242,192,947,0,32,32,0,0,0,1,320,0
242,50,870,0,32,32,0,0,0,1,332,0
242,672,776,0,32,32,0,0,0,1,331,0
242,192,656,0,32,32,0,0,0,1,328,0
154,304,888,0,1,0.50,64,16,1,0,54,1
154,612,736,0,2,0.50,32,32,-1,1,81,1
154,656,904,0,4,0.50,96,16,1,0,222,1
154,582,360,0,5,0.75,32,32,-1,1,343,1
154,770,360,0,6,0.75,32,32,-1,1,353,1
154,280,731.50,0,3,0.50,32,32,-1,1,365,1
154,387,880,0,7,0.50,32,32,-1,1,421,1
210,136,616,0,126,0,0,0,0,1,124,0
210,152,616,0,127,0,0,0,0,1,125,0
210,944,264,0,0,0,0,0,0,1,287,0
210,192,696,0,286,90,0,0,0,1,206,0
210,192,712,0,287,90,0,0,0,1,207,0
210,32,568,0,206,270,0,0,0,1,205,0
210,232,632,0,0,180,0,0,0,1,126,0
210,248,632,0,0,180,0,0,0,1,127,0
210,152,96,0,13,0,0,0,0,1,12,0
210,40,880,0,12,0,0,0,0,1,13,0
210,32,584,0,207,270,0,0,0,1,204,0
210,960,264,0,0,0,0,0,0,1,286,0
158,48,960,0,0,16777215,0,1,0,1,2,0
157,496,976,0,384,64,0,0,0,1,62,0
157,320,696,0,16,240,0,0,0,1,169,0
157,120,784,0,208,32,0,0,0,1,41,0
157,104,824,0,176,48,0,0,0,1,31,0
157,16,448,0,32,896,0,0,0,1,8,0
157,152,976,0,304,32,0,0,0,1,4,0
157,136,888,0,272,16,0,0,0,1,6,0
157,16,928,0,32,64,0,0,0,1,5,0
157,272,608,0,224,32,0,0,0,1,102,0
157,112,624,0,416,16,0,0,0,1,123,0
157,168,680,0,112,16,0,0,0,1,140,0
157,208,712,0,32,48,0,0,0,1,193,0
157,176,728,0,32,16,0,0,0,1,138,0
157,144,728,0,32,16,0,0,0,1,139,0
157,96,736,0,64,32,0,0,0,1,118,0
157,64,736,0,32,32,0,0,0,1,113,0
157,72,608,0,112,32,0,0,0,1,103,0
157,672,792,0,32,32,0,0,0,1,93,0
157,808,976,0,480,64,0,0,0,1,106,0
157,664,424,0,608,32,0,0,0,1,310,0
157,376,392,0,32,32,0,0,0,1,309,0
157,632,328,0,432,16,0,0,0,1,411,0
157,984,544,0,32,1216,0,0,0,1,107,0
157,936,784,0,16,32,0,0,0,1,264,0
157,648,56,0,16,112,0,0,0,1,393,0
172,48,112,0,1,0,0,0,0,1,15,1
169,176,848,0,1,0,0,0,0,1,32,1
155,304,888,0,1,1,30,0,0,1,52,1
155,624,784,0,2,1,50,0,0,1,53,0
155,728,736,0,1,2,0,0,0,1,79,0
155,512,736,0,2,2,0,0,0,1,80,0
155,376,736,0,3,2,0,0,0,1,85,0
172,128,592,0,0,0,0,0,0,1,104,1
169,112,688,0,0,0,0,0,0,1,198,1
155,656,904,0,1,4,50,0,0,1,220,0
155,656,904,0,2,4,120,0,0,1,221,0
155,384,904,0,3,4,50,0,0,1,271,0
155,408,360,0,1,5,0,0,0,1,341,0
155,928,360,0,2,5,0,0,0,1,342,0
155,944,360,0,1,6,0,0,0,1,351,0
155,392,360,0,2,6,0,0,0,1,352,0
155,240,656,0,1,3,0,0,0,1,363,0
155,280,656,0,2,3,0,0,0,1,364,0
155,280,808,0,3,3,0,0,0,1,367,0
155,376,832,0,4,2,0,0,0,1,374,0
155,464,848,0,1,7,0,0,0,1,419,0
155,464,880,0,2,7,0,0,0,1,420,0
155,384,880,0,3,7,0,0,0,1,423,0
155,584,880,0,4,7,0,0,0,1,424,0
155,464,880,0,5,7,0,0,0,1,439,0
155,464,848,0,6,7,0,0,0,1,440,0
155,320,848,0,7,7,0,0,0,1,441,0
155,376,736,0,5,2,0,0,0,1,442,0
155,512,736,0,6,2,0,0,0,1,443,0
155,728,736,0,7,2,0,0,0,1,444,0
155,728,856,0,8,2,0,0,0,1,445,0
155,544,856,0,9,2,0,0,0,1,446,0
166,528,720,0,0,0,270,0,0,0,246,1
166,568,720,0,0,0,270,0,0,0,247,1
166,488,720,0,0,0,270,0,0,0,248,1
166,392,400,0,0,0,0,0,0,1,311,1
166,968,384,0,0,0,180,0,0,1,312,1
255,256,936,0,128,128,1,0,0,1,133,0
255,64,928,0,128,128,1,0,0,1,132,0
253,216,784,0,16777088,0,2,0,0,1,181,0
157,776,840,0,64,144,0,0,0,1,230,0
157,728,904,0,48,16,0,0,0,1,229,0
157,824,840,0,32,32,0,0,0,1,232,0
157,856,840,0,32,32,0,0,0,1,255,0
157,936,904,0,192,16,0,0,0,1,391,0
157,616,256,0,32,32,0,0,0,1,290,0
157,448,256,0,32,32,0,0,0,1,294,0
157,512,232,0,32,32,0,0,0,1,293,0
157,880,248,0,32,32,0,0,0,1,302,0
157,736,240,0,32,32,0,0,0,1,289,0
157,784,216,0,32,32,0,0,0,1,288,0
157,952,280,0,32,32,0,0,0,1,285,0
157,488,56,0,16,112,0,0,0,1,392,0
157,176,112,0,32,32,0,0,0,1,14,0
157,128,112,0,64,32,0,0,0,1,11,0
157,96,120,0,32,16,0,0,0,1,20,0
157,40,120,0,32,16,0,0,0,1,10,0
242,839,812,0,64,80,0,0,0,1,330,0
242,294,575,0,32,32,0,0,0,1,329,0
242,952,248,0,32,32,0,0,0,1,319,0
253,112,0,0,16777215,0,0,0,0,1,27,0
253,48,0,0,16777215,0,0,0,0,1,26,0
100,112,0,0,256,0,0,272,0,1,453,0
100,48,0,0,256,0,0,272,0,1,454,0
1234567890
24,160,128,48,64,128,784,10000,0,0,0,0
24,432,96,32,16,240,880,10000,0,0,0,0
24,432,96,32,16,320,912,10000,0,0,0,0
24,256,144,16,16,320,864,10000,0,0,0,0
24,288,176,32,32,272,880,10000,0,0,0,0
24,288,176,32,32,288,832,10000,0,0,0,0
25,0,0,144,96,32,432,10002,0,0,0,0
25,0,0,144,96,176,432,10002,0,0,0,0
25,0,0,144,96,32,336,10002,0,0,0,0
25,0,0,144,96,176,336,10002,0,0,0,0
25,0,0,144,96,176,240,10002,0,0,0,0
25,0,0,144,96,32,240,10002,0,0,0,0
25,0,0,144,96,176,48,10002,0,0,0,0
25,0,0,144,96,32,48,10002,0,0,0,0
25,0,0,144,48,32,0,10002,0,0,0,0
25,0,0,144,48,176,0,10002,0,0,0,0
25,0,0,144,48,320,0,10002,0,0,0,0
25,0,0,144,48,320,48,10002,0,0,0,0
25,0,0,144,48,320,96,10002,0,0,0,0
25,0,0,144,48,320,144,10002,0,0,0,0
25,0,0,144,48,320,192,10002,0,0,0,0
25,0,0,144,48,320,240,10002,0,0,0,0
25,0,0,144,48,320,288,10002,0,0,0,0
25,0,0,144,48,464,96,10002,0,0,0,0
25,0,0,144,48,464,240,10002,0,0,0,0
25,0,0,144,96,32,144,10002,0,0,0,0
25,0,0,144,96,176,144,10002,0,0,0,0
25,0,0,144,96,752,0,10002,0,0,0,0
25,0,0,144,96,896,0,10002,0,0,0,0
25,0,0,144,96,896,96,10002,0,0,0,0
25,0,0,144,96,896,192,10002,0,0,0,0
25,0,0,144,96,896,288,10002,0,0,0,0
25,0,0,144,96,752,96,10002,0,0,0,0
25,0,0,144,96,752,192,10002,0,0,0,0
25,0,0,144,96,896,384,10002,0,0,0,0
25,0,0,144,96,320,336,10002,0,0,0,0
25,0,0,144,96,320,432,10002,0,0,0,0
25,0,0,144,96,464,144,10002,0,0,0,0
25,0,0,144,96,752,288,10002,0,0,0,0
25,0,0,144,96,752,384,10002,0,0,0,0
25,0,0,144,96,464,0,10002,0,0,0,0
25,0,0,144,96,608,0,10002,0,0,0,0
25,0,0,144,96,608,96,10002,0,0,0,0
25,0,0,144,96,608,192,10002,0,0,0,0
25,0,0,144,96,608,288,10002,0,0,0,0
25,0,0,144,96,608,384,10002,0,0,0,0
25,0,0,144,96,464,288,10002,0,0,0,0
25,0,0,144,96,464,384,10002,0,0,0,0
25,0,0,144,96,608,480,10002,0,0,0,0
25,0,0,144,96,752,480,10002,0,0,0,0
25,0,0,144,96,896,480,10002,0,0,0,0
25,0,0,144,96,464,480,10002,0,0,0,0
25,0,0,144,96,896,576,10002,0,0,0,0
25,0,0,144,96,752,576,10002,0,0,0,0
25,0,0,144,96,608,576,10002,0,0,0,0
25,0,0,144,96,464,576,10002,0,0,0,0
25,0,0,144,96,896,672,10002,0,0,0,0
25,0,0,144,96,752,672,10002,0,0,0,0
25,0,0,144,96,608,672,10002,0,0,0,0
25,0,0,144,96,464,672,10002,0,0,0,0
25,0,0,144,96,896,768,10002,0,0,0,0
25,0,0,144,96,752,768,10002,0,0,0,0
25,0,0,144,96,608,768,10002,0,0,0,0
25,0,0,144,96,464,768,10002,0,0,0,0
25,0,0,144,96,896,864,10002,0,0,0,0
25,0,0,144,96,752,864,10002,0,0,0,0
25,0,0,144,96,608,864,10002,0,0,0,0
25,0,0,144,96,464,864,10002,0,0,0,0
25,0,0,144,96,176,864,10002,0,0,0,0
25,0,0,144,96,32,864,10002,0,0,0,0
25,0,0,144,96,32,768,10002,0,0,0,0
25,0,0,144,96,176,768,10002,0,0,0,0
25,0,0,144,96,320,768,10002,0,0,0,0
25,0,0,144,96,176,672,10002,0,0,0,0
25,0,0,144,96,32,672,10002,0,0,0,0
25,0,0,144,96,32,576,10002,0,0,0,0
25,0,0,144,96,176,576,10002,0,0,0,0
25,0,0,144,96,320,576,10002,0,0,0,0
25,0,0,144,96,320,672,10002,0,0,0,0
25,0,0,144,48,32,528,10002,0,0,0,0
25,0,0,144,48,176,528,10002,0,0,0,0
25,0,0,144,48,320,528,10002,0,0,0,0
25,0,0,144,96,320,864,10002,0,0,0,0
24,112,176,16,16,368,928,10000,0,0,0,0
24,112,176,16,16,736,304,10000,0,0,0,0
24,160,288,304,32,640,96,10000,0,0,0,0
24,336,304,128,16,464,720,10000,0,0,0,0
987654321

