UVx6TlN6BGU9Z2xcMFJePxggdFQCTnwSVTU7SBJhIEV+eg==
259,96,199,0,200,400,0,0,0,1,137,0
259,248,80,0,100,192,0,0,0,1,145,0
259,471,143,0,208,240,0,0,0,1,146,0
259,288,272,0,192,144,0,0,0,1,147,0
259,416,304,0,64,64,0,0,0,1,150,0
160,72,152,0,0,16777215,0,0,0,1,125,0
195,544,128,0,0,126,185,0,44,1,38,0
195,80,312,0,0,82,0,0,124,1,118,0
123,272,232,0,128,0,0,0,0,1,89,0
123,384,128,0,128,0,0,0,0,1,37,0
123,160,256,0,128,0,0,0,0,1,117,0
174,224,144,0,1,30,0,0,0,0,27,1
174,416,320,0,1,112,0,0,0,0,111,1
185,243,136,0,0,16,1,0,0,1,17,0
185,296,88,0,0,16,1,0,0,1,40,0
185,248,64,0,0,16,1,0,0,1,42,0
185,96,264,0,0,16,1,0,0,1,161,0
242,320,240,0,32,32,0,0,0,1,153,0
242,384,144,0,32,32,0,0,0,1,154,0
242,384,304,0,32,32,0,0,0,1,155,0
242,176,304,0,32,32,0,0,0,1,158,0
158,336,192,0,0,16777215,0,1,0,1,19,0
157,312,200,0,96,16,0,0,0,1,4,0
157,352,216,0,96,32,0,0,0,1,2,0
157,248,168,0,32,64,0,0,0,1,3,0
157,296,128,0,16,32,0,0,0,1,5,0
157,296,48,0,16,32,0,0,0,1,6,0
157,304,72,0,16,32,0,0,0,1,7,0
157,296,40,0,16,32,0,0,0,1,8,0
157,280,24,0,16,16,0,0,0,1,9,0
157,312,160,0,16,32,0,0,0,1,10,0
157,304,96,0,16,32,0,0,0,1,11,0
157,264,24,0,16,16,0,0,0,1,12,0
157,269,29,0,16,16,0,0,0,1,13,0
157,232,24,0,16,16,0,0,0,1,14,0
157,240,24,0,16,16,0,0,0,1,15,0
157,248,24,0,16,16,0,0,0,1,16,0
157,312,136,0,16,32,0,0,0,1,18,0
157,216,160,0,32,32,0,0,0,1,20,0
157,192,128,0,32,32,0,0,0,1,21,0
157,192,80,0,32,32,0,0,0,1,22,0
157,184,96,0,32,32,0,0,0,1,23,0
157,200,48,0,32,32,0,0,0,1,24,0
157,208,24,0,32,32,0,0,0,1,25,0
157,336,112,0,32,32,0,0,0,1,26,0
157,400,176,0,96,32,0,0,0,1,28,0
157,368,112,0,32,32,0,0,0,1,29,0
157,192,128,0,32,32,0,0,0,1,32,0
157,368,104,0,32,32,0,0,0,1,34,0
157,400,104,0,32,32,0,0,0,1,35,0
157,392,40,0,32,32,0,0,0,1,46,0
157,392,72,0,32,32,0,0,0,1,47,0
157,360,40,0,32,32,0,0,0,1,48,0
157,328,40,0,32,32,0,0,0,1,49,0
157,304,40,0,32,32,0,0,0,1,50,0
157,360,72,0,32,32,0,0,0,1,51,0
157,320,104,0,32,32,0,0,0,1,52,0
157,352,80,0,32,32,0,0,0,1,53,0
157,328,72,0,32,32,0,0,0,1,54,0
157,520,248,0,32,32,0,0,0,1,56,0
157,496,32,0,32,32,0,0,0,1,57,0
157,392,8,0,32,32,0,0,0,1,58,0
157,576,160,0,32,32,0,0,0,1,59,0
157,560,96,0,32,32,0,0,0,1,60,0
157,472,32,0,32,32,0,0,0,1,64,0
157,440,32,0,32,32,0,0,0,1,65,0
157,544,224,0,32,32,0,0,0,1,66,0
157,528,80,0,32,32,0,0,0,1,67,0
157,512,48,0,32,32,0,0,0,1,68,0
157,416,32,0,32,32,0,0,0,1,69,0
157,576,128,0,32,32,0,0,0,1,70,0
157,464,256,0,32,32,0,0,0,1,71,0
157,431,258,0,32,32,0,0,0,1,72,0
157,544,160,0,32,32,0,0,0,1,73,0
157,488,248,0,32,32,0,0,0,1,74,0
157,544,192,0,32,32,0,0,0,1,75,0
157,384,264,0,32,32,0,0,0,1,77,0
157,360,264,0,32,32,0,0,0,1,78,0
157,400,264,0,32,32,0,0,0,1,79,0
157,464,184,0,32,32,0,0,0,1,80,0
157,296,160,0,16,32,0,0,0,1,82,0
157,336,264,0,32,32,0,0,0,1,83,0
157,240,336,0,32,32,0,0,0,1,86,0
157,408,200,0,96,32,0,0,0,1,87,0
157,320,272,0,32,48,0,0,0,1,88,0
157,272,336,0,32,32,0,0,0,1,90,0
157,224,280,0,32,32,0,0,0,1,91,0
157,336,336,0,32,32,0,0,0,1,92,0
157,368,336,0,32,32,0,0,0,1,93,0
157,304,336,0,32,32,0,0,0,1,94,0
157,208,336,0,32,32,0,0,0,1,95,0
157,232,200,0,32,32,0,0,0,1,98,0
157,176,336,0,32,32,0,0,0,1,99,0
157,192,232,0,32,32,0,0,0,1,100,0
157,176,272,0,32,32,0,0,0,1,101,0
157,240,184,0,16,64,0,0,0,1,103,0
157,432,336,0,32,32,0,0,0,1,109,0
157,400,336,0,32,32,0,0,0,1,110,0
157,112,280,0,16,16,0,0,0,1,114,0
157,144,336,0,32,32,0,0,0,1,115,0
157,112,336,0,32,32,0,0,0,1,116,0
157,88,288,0,32,32,0,0,0,1,119,0
157,24,312,0,32,32,0,0,0,1,120,0
157,80,336,0,32,32,0,0,0,1,121,0
157,88,256,0,32,32,0,0,0,1,122,0
157,56,288,0,32,32,0,0,0,1,123,0
157,56,168,0,32,32,0,0,0,1,126,0
157,88,168,0,32,32,0,0,0,1,127,0
157,88,216,0,32,48,0,0,0,1,128,0
157,224,184,0,32,32,0,0,0,1,140,0
157,200,208,0,32,32,0,0,0,1,141,0
157,200,160,0,32,32,0,0,0,1,142,0
157,200,184,0,32,32,0,0,0,1,143,0
169,368,128,0,0,0,0,0,0,1,30,1
169,176,288,0,0,0,0,0,0,1,112,1
166,320,152,0,0,0,0,0,0,0,44,1
166,248,288,0,0,0,0,0,0,1,107,1
166,48,312,0,0,0,0,0,0,0,124,1
1234567890
25,64,64,16,16,208,48,10002,0,0,0,0
25,64,64,16,16,208,32,10002,0,0,0,0
25,64,64,16,16,224,32,10002,0,0,0,0
25,64,64,16,16,256,16,10002,0,0,0,0
25,64,64,16,16,272,32,10002,0,0,0,0
25,64,64,16,16,272,48,10002,0,0,0,0
25,64,64,16,16,256,32,10002,0,0,0,0
25,64,64,16,16,256,64,10002,0,0,0,0
25,64,64,16,16,256,48,10002,0,0,0,0
25,64,64,16,16,272,64,10002,0,0,0,0
25,64,64,16,16,288,64,10002,0,0,0,0
25,64,64,16,16,288,80,10002,0,0,0,0
25,64,64,16,16,288,96,10002,0,0,0,0
25,64,64,16,16,272,80,10002,0,0,0,0
25,64,64,16,16,272,96,10002,0,0,0,0
25,64,64,16,16,256,144,10002,0,0,0,0
25,64,64,16,16,272,112,10002,0,0,0,0
25,64,64,16,16,256,128,10002,0,0,0,0
25,64,64,16,16,256,112,10002,0,0,0,0
25,64,64,16,16,256,96,10002,0,0,0,0
25,64,64,16,16,240,112,10002,0,0,0,0
25,64,64,16,16,256,80,10002,0,0,0,0
25,64,64,16,16,240,96,10002,0,0,0,0
25,64,64,16,16,224,128,10002,0,0,0,0
25,64,64,16,16,240,128,10002,0,0,0,0
25,64,64,16,16,224,96,10002,0,0,0,0
25,64,64,16,16,208,128,10002,0,0,0,0
25,64,64,16,16,224,112,10002,0,0,0,0
25,64,64,16,16,208,96,10002,0,0,0,0
25,64,64,16,16,208,112,10002,0,0,0,0
25,64,64,16,16,240,80,10002,0,0,0,0
25,64,64,16,16,224,48,10002,0,0,0,0
25,64,64,16,16,224,80,10002,0,0,0,0
25,64,64,16,16,240,32,10002,0,0,0,0
25,64,64,16,16,240,64,10002,0,0,0,0
25,64,64,16,16,240,48,10002,0,0,0,0
25,64,64,16,16,224,64,10002,0,0,0,0
25,64,64,16,16,208,64,10002,0,0,0,0
25,64,64,16,16,208,80,10002,0,0,0,0
25,64,64,16,16,192,80,10002,0,0,0,0
25,64,64,16,16,192,96,10002,0,0,0,0
25,64,64,16,16,272,128,10002,0,0,0,0
25,64,64,16,16,272,160,10002,0,0,0,0
25,64,64,16,16,256,160,10002,0,0,0,0
25,64,64,16,16,256,176,10002,0,0,0,0
25,64,64,16,16,272,176,10002,0,0,0,0
25,64,64,16,16,272,144,10002,0,0,0,0
25,64,64,16,16,288,144,10002,0,0,0,0
25,64,64,16,16,288,160,10002,0,0,0,0
25,64,64,16,16,320,176,10002,0,0,0,0
25,64,64,16,16,320,160,10002,0,0,0,0
25,64,64,16,16,320,144,10002,0,0,0,0
25,64,64,16,16,320,128,10002,0,0,0,0
25,64,64,16,16,336,128,10002,0,0,0,0
25,64,64,16,16,336,160,10002,0,0,0,0
25,64,64,16,16,336,176,10002,0,0,0,0
25,64,64,16,16,336,144,10002,0,0,0,0
25,64,64,16,16,352,144,10002,0,0,0,0
25,64,64,16,16,352,128,10002,0,0,0,0
25,64,64,16,16,352,160,10002,0,0,0,0
25,64,64,16,16,384,144,10002,0,0,0,0
25,64,64,16,16,384,160,10002,0,0,0,0
25,64,64,16,16,400,160,10002,0,0,0,0
25,64,64,16,16,384,128,10002,0,0,0,0
25,64,64,16,16,384,112,10002,0,0,0,0
25,64,64,16,16,400,112,10002,0,0,0,0
25,64,64,16,16,400,128,10002,0,0,0,0
25,64,64,16,16,400,144,10002,0,0,0,0
25,64,64,16,16,416,144,10002,0,0,0,0
25,64,64,16,16,416,160,10002,0,0,0,0
25,192,112,16,16,368,160,10002,0,0,0,0
25,544,320,16,16,304,176,10002,0,0,0,0
25,544,320,16,16,288,176,10002,0,0,0,0
25,544,272,16,16,352,240,10002,0,0,0,0
25,544,256,16,16,352,224,10002,0,0,0,0
25,528,256,16,16,336,224,10002,0,0,0,0
25,528,272,16,16,336,240,10002,0,0,0,0
25,544,256,16,16,320,224,10002,0,0,0,0
25,544,272,16,16,320,240,10002,0,0,0,0
25,528,256,16,16,304,224,10002,0,0,0,0
25,528,272,16,16,304,240,10002,0,0,0,0
25,544,256,16,16,384,224,10002,0,0,0,0
25,544,272,16,16,384,240,10002,0,0,0,0
25,528,256,16,16,368,224,10002,0,0,0,0
25,528,272,16,16,368,240,10002,0,0,0,0
25,192,128,16,16,368,144,10002,0,0,0,0
25,192,112,16,16,368,128,10002,0,0,0,0
25,192,128,16,16,176,304,10002,0,0,0,0
25,192,112,16,16,176,288,10002,0,0,0,0
987654321
DkgmCwsnED1wOXlCNlg=
DkgmCwsnED1tIn4ONEpAPxQtaE9LEjw=
DkgmCwsnEDkxJW4aOBhe
DkguDQ5lRGlpImZLc1lIKlg1O19HDDxR

