UVx6TlN0AGU9Z3RBJllAL1l+Lg0ZUgNWHGR7DFYTbQYmLys0RntkJDs2bV9+STsqAHQ4J0Mqcic=
259,80,80,0,176,32,0,0,0,1,111,0
259,480,224,0,80,32,0,0,0,1,116,0
259,496,120,0,32,32,0,0,0,1,145,0
259,552,280,0,96,32,0,0,0,1,153,0
259,552,264,0,96,32,0,0,0,1,154,0
259,368,320,0,96,32,0,0,0,1,155,0
259,440,288,0,64,32,0,0,0,1,156,0
259,440,312,0,64,32,0,0,0,1,157,0
259,440,328,0,64,32,0,0,0,1,158,0
160,25,240,0,0,16777215,0,0,0,1,55,0
123,520,40,0,128,0,0,0,0,1,62,0
123,584,296,0,128,0,0,0,0,1,60,0
123,552,192,0,128,0,0,0,0,1,59,0
195,40,0,0,0,160,320,0,98,1,53,0
123,536,144,0,128,0,0,0,0,1,61,0
123,424,200,0,128,0,0,0,0,1,14,0
195,456,120,0,0,156,204,0,56,1,144,0
224,432,152,0,128,0,0,0,0,1,199,0
123,120,104,0,128,0,0,0,0,1,193,0
224,152,80,0,128,0,0,0,0,1,200,0
195,256,72,0,0,120,195,0,98,1,173,0
123,64,120,0,128,0,0,0,0,1,15,0
195,104,88,0,0,148,232,0,98,1,187,0
123,232,128,0,128,0,0,0,0,1,58,0
197,64,240,0,2,0,0,0,0,1,142,0
197,432,96,0,2,0,0,0,0,1,143,0
197,64,160,0,2,126,0,0,0,1,147,0
174,168,32,0,1,50,48,0,0,0,63,1
189,472,48,0,0,112,22,0,0,1,43,0
189,352,24,0,0,80,37,0,0,1,47,0
205,136,160,0,1,0,0.50,0,0,0,98,0
186,560,248,0,32,32,0,0,0,1,128,0
188,560,296,0,0,65,0,0,0,1,141,0
242,336,120,0,32,32,0,0,0,1,180,0
242,304,296,0,32,32,0,0,0,1,181,0
158,224,32,0,0,16777215,0,1,0,1,52,0
210,80,240,0,0,0,0,0,0,1,119,0
210,272,312,0,119,0,0,0,0,1,118,0
157,256,176,0,32,32,0,0,0,1,91,0
157,280,168,0,32,32,0,0,0,1,2,0
157,320,176,0,32,32,0,0,0,1,3,0
157,352,176,0,32,32,0,0,0,1,4,0
157,382,180,0,32,32,0,0,0,1,5,0
157,416,176,0,32,32,0,0,0,1,6,0
157,448,176,0,32,32,0,0,0,1,7,0
157,456,224,0,32,32,0,0,0,1,8,0
157,448,232,0,32,32,0,0,0,1,9,0
157,440,240,0,32,32,0,0,0,1,10,0
157,432,248,0,32,32,0,0,0,1,11,0
157,424,256,0,32,32,0,0,0,1,12,0
157,456,256,0,32,32,0,0,0,1,13,0
157,224,176,0,32,32,0,0,0,1,16,0
157,192,176,0,32,32,0,0,0,1,17,0
157,160,176,0,32,32,0,0,0,1,18,0
157,128,176,0,32,32,0,0,0,1,19,0
157,96,176,0,32,32,0,0,0,1,20,0
157,64,176,0,32,32,0,0,0,1,21,0
157,32,176,0,32,32,0,0,0,1,22,0
157,8,176,0,32,32,0,0,0,1,23,0
157,16,16,0,32,32,0,0,0,1,25,0
157,16,48,0,32,32,0,0,0,1,26,0
157,16,112,0,32,32,0,0,0,1,28,0
157,16,144,0,32,32,0,0,0,1,29,0
157,152,48,0,32,32,0,0,0,1,30,0
157,176,48,0,32,32,0,0,0,1,31,0
157,208,48,0,32,32,0,0,0,1,32,0
157,240,48,0,32,32,0,0,0,1,33,0
157,256,16,0,32,32,0,0,0,1,34,0
157,504,200,0,32,32,0,0,0,1,35,0
157,112,64,0,32,32,0,0,0,1,36,0
157,128,48,0,32,32,0,0,0,1,37,0
157,504,168,0,32,32,0,0,0,1,38,0
157,504,136,0,32,32,0,0,0,1,39,0
157,512,104,0,32,32,0,0,0,1,40,0
157,504,88,0,32,32,0,0,0,1,41,0
157,480,72,0,32,32,0,0,0,1,42,0
157,288,16,0,32,32,0,0,0,1,44,0
157,312,16,0,32,32,0,0,0,1,45,0
157,328,16,0,32,32,0,0,0,1,46,0
157,0,40,0,32,32,0,0,0,1,67,0
157,136,112,0,32,32,0,0,0,1,68,0
157,120,72,0,32,32,0,0,0,1,69,0
157,120,88,0,32,32,0,0,0,1,70,0
157,16,256,0,32,32,0,0,0,1,71,0
157,48,256,0,32,32,0,0,0,1,72,0
157,8,288,0,32,32,0,0,0,1,73,0
157,8,320,0,32,32,0,0,0,1,74,0
157,8,352,0,32,32,0,0,0,1,75,0
157,80,256,0,32,32,0,0,0,1,76,0
157,304,328,0,32,32,0,0,0,1,77,0
157,320,352,0,32,32,0,0,0,1,78,0
157,272,328,0,32,32,0,0,0,1,95,0
157,304,160,0,32,32,0,0,0,1,99,0
157,152,112,0,32,32,0,0,0,1,100,0
157,456,96,0,32,32,0,0,0,1,103,0
157,488,88,0,32,32,0,0,0,1,104,0
157,480,120,0,32,32,0,0,0,1,105,0
157,112,48,0,32,32,0,0,0,1,120,0
157,568,312,0,32,32,0,0,0,1,129,0
157,584,312,0,32,32,0,0,0,1,130,0
157,544,312,0,32,32,0,0,0,1,131,0
157,520,312,0,32,32,0,0,0,1,132,0
157,504,312,0,32,32,0,0,0,1,133,0
157,480,296,0,32,32,0,0,0,1,134,0
157,488,256,0,32,32,0,0,0,1,135,0
157,464,272,0,32,32,0,0,0,1,136,0
157,472,280,0,32,32,0,0,0,1,137,0
157,456,264,0,32,32,0,0,0,1,138,0
157,496,304,0,32,32,0,0,0,1,139,0
157,488,280,0,32,32,0,0,0,1,140,0
157,392,176,0,16,32,0,0,0,1,146,0
157,288,176,0,48,32,0,0,0,1,164,0
157,328,152,0,48,32,0,0,0,1,165,0
157,344,152,0,48,32,0,0,0,1,166,0
172,32,32,0,0,0,0,0,0,1,48,1
172,64,32,0,0,0,0,0,0,1,50,1
169,104,128,0,0,0,0,0,0,1,65,1
172,408,96,0,0,0,0,0,0,1,101,1
172,544,248,0,0,0,0,0,0,1,126,1
166,144,80,0,0,0,0,0,0,0,56,1
237,320,0,0,16777215,300,0,0,0,1,24,0
1234567890
24,32,32,16,16,240,160,10000,0,0,0,0
24,32,32,16,16,256,160,10000,0,0,0,0
24,32,32,16,16,288,160,10000,0,0,0,0
24,32,32,16,16,272,160,10000,0,0,0,0
24,32,32,16,16,192,144,10000,0,0,0,0
24,32,32,16,16,160,160,10000,0,0,0,0
24,32,32,16,16,160,176,10000,0,0,0,0
24,32,32,16,16,224,176,10000,0,0,0,0
24,32,32,16,16,208,176,10000,0,0,0,0
24,32,32,16,16,192,176,10000,0,0,0,0
24,32,32,16,16,224,160,10000,0,0,0,0
24,32,32,16,16,208,160,10000,0,0,0,0
24,32,32,16,16,192,160,10000,0,0,0,0
24,32,32,16,16,176,160,10000,0,0,0,0
24,32,32,16,16,176,176,10000,0,0,0,0
24,32,32,16,16,240,176,10000,0,0,0,0
24,32,32,16,16,256,176,10000,0,0,0,0
24,32,32,16,16,272,176,10000,0,0,0,0
24,32,32,16,16,288,176,10000,0,0,0,0
24,32,32,16,16,304,176,10000,0,0,0,0
24,32,32,16,16,304,160,10000,0,0,0,0
24,32,32,16,16,320,160,10000,0,0,0,0
24,32,32,16,16,320,176,10000,0,0,0,0
24,32,32,16,16,240,144,10000,0,0,0,0
24,32,32,16,16,256,144,10000,0,0,0,0
24,32,32,16,16,272,144,10000,0,0,0,0
24,464,288,32,32,208,192,10000,0,0,0,0
24,464,288,32,32,240,192,10000,0,0,0,0
24,464,288,32,32,272,192,10000,0,0,0,0
24,464,288,32,32,304,192,10000,0,0,0,0
24,464,288,32,32,336,192,10000,0,0,0,0
24,464,288,32,32,368,192,10000,0,0,0,0
24,464,288,32,32,400,192,10000,0,0,0,0
24,464,288,32,32,432,192,10000,0,0,0,0
24,464,288,32,32,464,192,10000,0,0,0,0
24,464,288,32,32,496,192,10000,0,0,0,0
24,464,288,32,32,528,192,10000,0,0,0,0
24,464,288,32,32,560,192,10000,0,0,0,0
24,464,288,32,32,592,192,10000,0,0,0,0
24,464,288,32,32,624,192,10000,0,0,0,0
24,464,288,32,32,176,192,10000,0,0,0,0
24,464,288,32,32,144,192,10000,0,0,0,0
24,464,288,32,32,112,192,10000,0,0,0,0
24,464,288,32,32,80,192,10000,0,0,0,0
24,464,288,32,32,48,192,10000,0,0,0,0
24,464,288,32,32,16,192,10000,0,0,0,0
24,192,48,64,32,320,128,10000,0,0,0,0
24,192,48,64,32,32,128,10000,0,0,0,0
24,192,48,64,32,32,64,10000,0,0,0,0
24,192,48,64,32,32,32,10000,0,0,0,0
24,432,112,32,16,288,288,10000,0,0,0,0
24,432,192,16,16,256,80,10000,0,0,0,0
24,256,240,48,16,192,112,10000,0,0,0,0
24,256,240,48,16,256,240,10000,0,0,0,0
24,432,64,32,32,32,96,10000,0,0,0,0
24,224,48,32,32,64,96,10000,0,0,0,0
24,128,16,64,16,192,64,10000,0,0,0,0
24,128,16,64,16,384,112,10000,0,0,0,0
24,128,16,64,16,32,272,10000,0,0,0,0
24,128,16,64,16,480,224,10000,0,0,0,0
24,304,32,16,32,256,32,10000,0,0,0,0
24,160,288,304,32,96,256,10000,0,0,0,0
24,496,304,64,32,32,0,10000,0,0,0,0
24,0,192,32,32,416,48,10000,0,0,0,0
24,224,160,32,32,288,128,10000,0,0,0,0
24,224,160,32,32,288,96,10000,0,0,0,0
24,224,160,32,32,288,64,10000,0,0,0,0
24,224,160,32,32,288,32,10000,0,0,0,0
24,224,160,32,32,160,128,10000,0,0,0,0
24,224,160,32,32,160,96,10000,0,0,0,0
24,224,160,32,32,160,64,10000,0,0,0,0
24,224,160,32,32,416,272,10000,0,0,0,0
24,224,160,32,32,416,304,10000,0,0,0,0
24,224,160,32,32,416,336,10000,0,0,0,0
24,224,160,32,32,576,320,10000,0,0,0,0
24,224,160,32,32,576,352,10000,0,0,0,0
987654321

