UVx6TlN0AGU9Z29CPERJKVctaRRvEClWEWx5HxJhIEV+enVgKSQ9ZmRj
259,552,144,0,32,32,0,0,0,0,301,0
160,32,328,0,0,16777215,0,0,0,1,168,0
123,440,192,0,128,16711680,0,0,0,1,430,0
123,512,16,0,12,0,0,0,0,1,502,0
100,40,49.60,0,256,0,524,0,524,1,525,0
123,456,192,0,128,16711680,0,0,0,1,431,0
123,640,144,0,32,0,0,0,0,1,564,0
100,247,68,0,256,16777215,182,180,182,1,183,0
100,114,144,0,256,0,195,270,195,1,156,0
100,272,208,0,256,16777215,0,267,0,1,161,0
100,337,128,0,256,16711680,0,270,0,1,472,0
197,272,177,0,1,173,0,0,0,1,170,0
197,281,96,0,1,182,0,0,0,1,169,0
197,192,256,0,1,177,0,0,0,1,171,0
193,248,96,0,1,327,156,179,189,1,329,1
193,464,64,0,1,0,0,400,0,1,308,1
193,392,160,0,1,175,0,0,0,1,172,1
189,456,216,0,0,128,90,0,0,1,445,0
189,440,216,0,0,128,90,0,0,1,438,0
194,472,16,0,0,128,0,0,0,1,479,0
181,16,225.60,0,189,128,0,0,0,1,524,0
205,328,96,0,1,100,0.50,0,0,1,182,0
181,118.50,144,0,554,80,11,0,0,1,195,0
189,272,208,0,0,128,270,166,0,1,162,0
188,216,96,0,0,161,0,0,0,1,517,0
188,328,96,0,0,161,0,0,0,1,470,0
242,193,239,0,32,32,0,0,0,1,236,0
242,264,160,0,32,32,0,0,0,1,242,0
242,352,112,0,32,32,0,0,0,1,250,0
242,352,240,0,32,32,0,0,0,1,257,0
242,80,144,0,32,32,0,0,0,1,336,0
242,576,144,0,32,32,0,0,0,1,393,0
176,536,144,0,192,32,32,0,0,1,379,0
154,329.84,240,0,1,0.28,32,32,-1,1,166,1
154,40,48.80,0,2,0.40,32,32,-1,1,189,1
154,115,144,0,3,0.50,32,32,-1,1,554,1
158,624,160,0,1,16777215,1,0,0,1,157,0
216,560,144,0,23,0,0,0,0,1,184,0
157,224,192,0,32,32,0,0,0,1,160,0
157,224,272,0,32,32,0,0,0,1,2,0
157,257,190,0,32,32,0,0,0,1,3,0
157,288,192,0,32,32,0,0,0,1,4,0
157,376,176,0,32,32,0,0,0,1,5,0
157,160,176,0,32,32,0,0,0,1,6,0
157,160,208,0,32,32,0,0,0,1,7,0
157,160,240,0,32,32,0,0,0,1,8,0
157,288,112,0,32,32,0,0,0,1,9,0
157,384,80,0,32,32,0,0,0,1,10,0
157,320,112,0,32,32,0,0,0,1,11,0
157,160,272,0,32,32,0,0,0,1,12,0
157,160,303,0,32,32,0,0,0,1,13,0
157,160,328,0,32,32,0,0,0,1,14,0
157,160,352,0,32,32,0,0,0,1,15,0
157,160,112,0,32,32,0,0,0,1,16,0
157,160,80,0,32,32,0,0,0,1,17,0
157,256,112,0,32,32,0,0,0,1,18,0
157,224,112,0,32,32,0,0,0,1,19,0
157,160,48,0,32,32,0,0,0,1,20,0
157,192,48,0,32,32,0,0,0,1,21,0
157,384,112,0,32,32,0,0,0,1,22,0
157,368,48,0,32,32,0,0,0,1,23,0
157,319,48,0,32,32,0,0,0,1,24,0
157,288,48,0,32,32,0,0,0,1,25,0
157,224,48,0,32,32,0,0,0,1,26,0
157,256,48,0,32,32,0,0,0,1,27,0
157,336,48,0,32,32,0,0,0,1,28,0
157,312,192,0,32,32,0,0,0,1,29,0
157,416,176,0,32,32,0,0,0,1,30,0
157,480,176,0,32,32,0,0,0,1,32,0
157,512,176,0,32,32,0,0,0,1,33,0
157,544,176,0,32,32,0,0,0,1,34,0
157,544,208,0,32,32,0,0,0,1,35,0
157,416,112,0,32,32,0,0,0,1,36,0
157,448,112,0,32,32,0,0,0,1,37,0
157,608,176,0,32,32,0,0,0,1,38,0
157,640,176,0,32,32,0,0,0,1,39,0
157,512,112,0,32,32,0,0,0,1,41,0
157,480,112,0,32,32,0,0,0,1,42,0
157,544,112,0,32,32,0,0,0,1,43,0
157,576,48,0,32,32,0,0,0,1,44,0
157,632,80,0,32,32,0,0,0,1,45,0
157,552,48,0,32,32,0,0,0,1,46,0
157,640,112,0,32,32,0,0,0,1,47,0
157,608,80,0,32,32,0,0,0,1,48,0
157,608,112,0,32,32,0,0,0,1,49,0
157,464,80,0,32,32,0,0,0,1,50,0
157,464,80,0,32,32,0,0,0,1,51,0
157,464,80,0,32,32,0,0,0,1,52,0
157,432,80,0,32,32,0,0,0,1,53,0
157,400,80,0,32,32,0,0,0,1,54,0
157,128,112,0,32,32,0,0,0,1,55,0
157,128,176,0,32,32,0,0,0,1,56,0
157,128,208,0,32,32,0,0,0,1,57,0
157,128,232,0,32,32,0,0,0,1,58,0
157,128,264,0,32,32,0,0,0,1,59,0
157,128,352,0,32,32,0,0,0,1,60,0
157,128,288,0,32,32,0,0,0,1,61,0
157,128,320,0,32,32,0,0,0,1,62,0
157,160,16,0,32,32,0,0,0,1,63,0
157,128,80,0,32,32,0,0,0,1,64,0
157,128,48,0,32,32,0,0,0,1,65,0
157,128,16,0,32,32,0,0,0,1,66,0
157,16,16,0,32,32,0,0,0,1,67,0
157,96,16,0,32,32,0,0,0,1,68,0
157,80,16,0,32,32,0,0,0,1,69,0
157,80,48,0,32,32,0,0,0,1,70,0
157,48,16,0,32,32,0,0,0,1,71,0
157,96,352,0,32,32,0,0,0,1,72,0
157,64,352,0,32,32,0,0,0,1,73,0
157,32,352,0,32,32,0,0,0,1,74,0
157,8,352,0,32,32,0,0,0,1,75,0
157,96,48,0,32,32,0,0,0,1,76,0
157,80,80,0,32,32,0,0,0,1,77,0
157,80,112,0,32,32,0,0,0,1,78,0
157,96,80,0,32,32,0,0,0,1,79,0
157,96,112,0,32,32,0,0,0,1,80,0
157,96,176,0,32,32,0,0,0,1,81,0
157,80,208,0,32,32,0,0,0,1,82,0
157,80,176,0,32,32,0,0,0,1,83,0
157,104,272,0,32,32,0,0,0,1,84,0
157,96,208,0,32,32,0,0,0,1,85,0
157,96,240,0,32,32,0,0,0,1,86,0
157,80,272,0,32,32,0,0,0,1,87,0
157,80,240,0,32,32,0,0,0,1,88,0
157,80,304,0,32,32,0,0,0,1,89,0
157,80,320,0,32,32,0,0,0,1,90,0
157,106,301,0,32,32,0,0,0,1,91,0
157,102,329,0,32,32,0,0,0,1,92,0
157,384,208,0,32,32,0,0,0,1,93,0
157,384,240,0,32,32,0,0,0,1,94,0
157,192,272,0,32,32,0,0,0,1,95,0
157,320,224,0,32,32,0,0,0,1,96,0
157,304,224,0,32,32,0,0,0,1,97,0
157,256,272,0,32,32,0,0,0,1,98,0
157,288,272,0,32,32,0,0,0,1,99,0
157,352,272,0,32,32,0,0,0,1,100,0
157,320,272,0,32,32,0,0,0,1,101,0
157,384,272,0,32,32,0,0,0,1,102,0
157,224,224,0,32,32,0,0,0,1,103,0
157,240,224,0,32,32,0,0,0,1,104,0
157,416,208,0,32,32,0,0,0,1,105,0
157,632,208,0,32,32,0,0,0,1,106,0
157,416,240,0,32,32,0,0,0,1,107,0
157,576,208,0,32,32,0,0,0,1,108,0
157,608,208,0,32,32,0,0,0,1,109,0
157,480,208,0,32,32,0,0,0,1,110,0
157,520,240,0,32,32,0,0,0,1,111,0
157,512,208,0,32,32,0,0,0,1,112,0
157,424,240,0,32,32,0,0,0,1,113,0
157,448,240,0,32,32,0,0,0,1,114,0
157,608,240,0,32,32,0,0,0,1,115,0
157,576,240,0,32,32,0,0,0,1,116,0
157,512,240,0,32,32,0,0,0,1,117,0
157,480,240,0,32,32,0,0,0,1,118,0
157,544,240,0,32,32,0,0,0,1,119,0
157,640,240,0,32,32,0,0,0,1,120,0
157,432,272,0,72,32,0,0,0,1,121,0
157,224,304,0,72,32,0,0,0,1,122,0
157,296,304,0,72,32,0,0,0,1,123,0
157,440,304,0,72,32,0,0,0,1,124,0
157,368,304,0,72,32,0,0,0,1,125,0
157,483,272,0,32,32,0,0,0,1,126,0
157,584,304,0,72,32,0,0,0,1,127,0
157,496,272,0,72,32,0,0,0,1,128,0
157,608,272,0,72,32,0,0,0,1,129,0
157,512,304,0,72,32,0,0,0,1,130,0
157,536,272,0,72,32,0,0,0,1,131,0
157,280,328,0,72,64,0,0,0,1,132,0
157,280,328,0,72,32,0,0,0,1,133,0
157,208,336,0,72,32,0,0,0,1,134,0
157,208,344,0,72,32,0,0,0,1,135,0
157,208,304,0,72,32,0,0,0,1,136,0
157,608,336,0,72,64,0,0,0,1,137,0
157,536,336,0,72,64,0,0,0,1,138,0
157,472,336,0,72,64,0,0,0,1,139,0
157,624,320,0,72,64,0,0,0,1,140,0
157,477,341,0,72,64,0,0,0,1,141,0
157,482,346,0,72,64,0,0,0,1,142,0
157,487,351,0,72,64,0,0,0,1,143,0
157,492,356,0,72,64,0,0,0,1,144,0
157,424,336,0,72,64,0,0,0,1,145,0
157,351,328,0,72,64,0,0,0,1,146,0
157,356,333,0,72,64,0,0,0,1,147,0
157,543,32,0,72,64,0,0,0,1,148,0
157,544,32,0,72,64,0,0,0,1,149,0
157,416,32,0,72,64,0,0,0,1,150,0
157,616,32,0,72,64,0,0,0,1,151,0
157,216,24,0,72,64,0,0,0,1,152,0
157,360,8,0,72,64,0,0,0,1,153,0
157,288,16,0,72,64,0,0,0,1,154,0
157,192,24,0,72,64,0,0,0,1,155,0
157,424,112,0,32,32,0,0,0,1,191,0
157,224,200,0,32,32,0,0,0,1,210,0
157,312,184,0,32,32,0,0,0,1,211,0
157,400,176,0,32,32,0,0,0,1,230,0
157,312,152,0,32,32,0,0,0,1,243,0
157,312,128,0,32,32,0,0,0,1,244,0
157,432,240,0,32,32,0,0,0,1,256,0
157,576,176,0,32,32,0,0,0,1,275,0
157,400,112,0,32,32,0,0,0,1,281,0
157,448,176,0,8,32,0,0,0,1,455,0
155,216,240,0,1,1,50,0,0,1,164,0
155,336,240,0,2,1,55,0,0,1,165,0
172,336,112,0,0,0,0,0,0,1,173,1
172,328,168,0,0,0,0,0,0,1,175,1
172,176,176,0,0,0,0,0,0,1,177,1
172,175,111,0,0,0,0,0,0,1,179,1
155,8,240,0,1,2,0,0,0,1,187,0
155,8,144,0,2,2,0,0,0,1,188,0
169,504,128,0,0,0,0,0,0,1,192,1
169,64,128,0,0,0,0,0,0,1,327,1
155,40,144,0,3,2,0,0,0,1,526,0
155,40,48,0,4,2,0,0,0,1,527,0
155,96,144,0,1,3,0,0,0,1,552,0
155,192,144,0,2,3,0,0,0,1,553,0
155,192,224,0,3,3,0,0,0,1,556,0
155,40,240,0,5,2,0,0,0,1,557,0
166,584,88,0,0,0,180,0,0,0,400,1
255,568,80,0,64,64,1,0,0,1,401,0
255,584,80,0,64,64,1,0,0,1,402,0
255,512,80,0,64,64,1,0,0,1,403,0
255,528,80,0,64,64,1,0,0,1,404,0
255,528,80,0,64,64,1,0,0,1,405,0
255,504,56,0,64,64,1,0,0,1,406,0
255,576,80,0,64,64,1,0,0,1,413,0
255,544,88,0,64,64,1,0,0,1,420,0
255,576,96,0,64,64,1,0,0,1,421,0
255,571,105,0,64,32,1,0,0,1,422,0
255,496,80,0,128,64,1,0,0,1,423,0
255,488,48,0,128,128,1,0,0,1,493,0
255,472,48,0,128,128,1,0,0,1,494,0
253,536,160,0,255,0,1,0,0,1,266,0
253,592,160,0,255,0,1,0,0,1,267,0
253,640,160,0,255,0,1,0,0,1,268,0
1234567890
25,464,192,16,16,416,128,10002,0,0,0,0
25,464,192,16,16,32,112,10002,0,0,0,0
25,464,192,16,16,16,144,10002,0,0,0,0
25,464,192,16,16,16,128,10002,0,0,0,0
25,464,192,16,16,16,112,10002,0,0,0,0
25,464,192,16,16,16,96,10002,0,0,0,0
25,464,192,16,16,400,128,10002,0,0,0,0
25,464,192,16,16,416,144,10002,0,0,0,0
25,464,192,16,16,416,160,10002,0,0,0,0
25,464,192,16,16,400,144,10002,0,0,0,0
25,464,192,16,16,272,224,10002,0,0,0,0
25,464,192,16,16,256,144,10002,0,0,0,0
24,192,32,16,16,368,144,10000,0,0,0,0
24,192,32,16,16,368,128,10000,0,0,0,0
25,288,64,16,16,368,144,10002,0,0,0,0
25,288,64,16,16,352,144,10002,0,0,0,0
25,288,64,16,16,352,128,10002,0,0,0,0
24,16,0,16,16,352,128,10000,0,0,0,0
24,16,0,16,16,336,144,10000,0,0,0,0
24,16,0,16,16,320,144,10000,0,0,0,0
24,16,0,16,16,320,160,10000,0,0,0,0
24,16,0,16,16,336,128,10000,0,0,0,0
24,16,0,16,16,320,128,10000,0,0,0,0
24,16,0,16,16,336,160,10000,0,0,0,0
24,16,0,16,16,352,160,10000,0,0,0,0
24,16,0,16,16,352,144,10000,0,0,0,0
24,272,80,16,16,384,128,10000,0,0,0,0
24,272,80,16,16,384,144,10000,0,0,0,0
24,272,80,16,16,400,144,10000,0,0,0,0
24,272,80,16,16,400,128,10000,0,0,0,0
24,272,80,16,16,416,144,10000,0,0,0,0
24,272,80,16,16,416,128,10000,0,0,0,0
24,272,80,16,16,432,144,10000,0,0,0,0
24,272,80,16,16,432,128,10000,0,0,0,0
24,272,80,16,16,448,144,10000,0,0,0,0
24,272,80,16,16,448,128,10000,0,0,0,0
24,272,80,16,16,464,144,10000,0,0,0,0
24,272,80,16,16,464,128,10000,0,0,0,0
24,272,80,16,16,480,128,10000,0,0,0,0
24,272,80,16,16,480,144,10000,0,0,0,0
24,272,80,16,16,496,144,10000,0,0,0,0
24,272,80,16,16,496,128,10000,0,0,0,0
24,272,80,16,16,512,144,10000,0,0,0,0
24,272,80,16,16,528,144,10000,0,0,0,0
24,272,80,16,16,608,144,10000,0,0,0,0
24,272,80,16,16,592,144,10000,0,0,0,0
24,272,80,16,16,576,144,10000,0,0,0,0
24,272,80,16,16,560,144,10000,0,0,0,0
24,272,80,16,16,544,144,10000,0,0,0,0
24,272,80,16,16,512,128,10000,0,0,0,0
24,272,80,16,16,528,128,10000,0,0,0,0
24,272,80,16,16,544,128,10000,0,0,0,0
24,272,80,16,16,560,128,10000,0,0,0,0
24,272,80,16,16,576,128,10000,0,0,0,0
24,272,80,16,16,592,128,10000,0,0,0,0
24,272,80,16,16,608,128,10000,0,0,0,0
24,272,80,16,16,624,128,10000,0,0,0,0
24,272,80,16,16,624,144,10000,0,0,0,0
987654321
LkgpEAUjRCwlPGhHIU8NN1U8aBgUVw==

