UVx6TlN0AGU9Z0hcPVhZdlgjd1lCEXwSVTU7SBJhIEV+enVg
259,368,80,0,816,32,0,0,0,1,247,0
259,504,296,0,80,32,0,0,0,1,309,0
259,552,312,0,80,32,0,0,0,1,310,0
160,112,296,0,0,16777215,0,0,0,1,189,0
100,8,128,0,100,0,0,270,0,1,201,0
100,248,112,0,152,0,0,271,0,1,225,0
123,126,140,0,136,0,0,0,0,1,251,0
123,248,208,0,32,0,0,0,0,1,230,0
100,320,216,0,256,0,0,270,0,1,232,0
100,56,216,0,256,0,0,305,0,1,258,0
100,160,216,0,256,0,0,242,0,1,259,0
195,296,184,0,0,112,285,0,240,1,231,0
123,336,120,0,52,0,0,0,0,1,267,0
123,598,272,0,128,0,0,0,0,1,294,0
100,508,166,0,216,0,0,269,0,1,296,0
100,400,128,0,216,0,0,269,0,1,295,0
100,608,152,0,216,0,0,269,0,1,298,0
123,248,256,0,32,0,0,0,0,1,229,0
100,400,216,0,280,0,0,270,0,1,233,0
100,464,144,0,216,0,0,269,0,1,297,0
123,528,240,0,56,0,0,0,0,1,252,0
197,320,160,0,2,0,0,0,0,1,260,0
197,496,272,0,2,208,0,0,0,1,254,0
174,160,176,0,1,187,0,0,0,0,188,1
174,280,160,0,1,204,205,0,0,0,212,1
174,352,160,0,1,0,253,0,0,0,273,1
219,216,144,0,16,32,0,0,0,1,187,1
219,472,240,0,16,32,0,0,0,1,253,1
242,288,288,0,32,32,0,0,0,1,305,0
242,512,256,0,32,32,0,0,0,1,306,0
242,368,145,0,32,32,0,0,0,1,307,0
154,248,270,0,1,0.50,48,16,1,1,206,1
154,560,240.50,0,2,0.50,32,16,1,1,271,1
158,80,176,0,0,16777215,0,1,0,1,190,0
216,368,240,0,3,0,0,0,0,1,308,0
157,128,192,0,160,32,0,0,0,1,184,0
157,64,96,0,32,32,0,0,0,1,2,0
157,96,96,0,32,32,0,0,0,1,3,0
157,128,96,0,160,32,0,0,0,1,4,0
157,216,184,0,16,16,0,0,0,1,5,0
157,216,104,0,16,16,0,0,0,1,6,0
157,216,168,0,16,16,0,0,0,1,7,0
157,216,120,0,16,16,0,0,0,1,8,0
157,184,224,0,16,32,0,0,0,1,10,0
157,184,256,0,16,32,0,0,0,1,11,0
157,184,320,0,16,32,0,0,0,1,12,0
157,184,352,0,16,32,0,0,0,1,13,0
157,280,176,0,16,32,0,0,0,1,15,0
157,248,320,0,528,32,0,0,0,1,17,0
157,40,208,0,16,96,0,0,0,1,18,0
157,40,256,0,16,96,0,0,0,1,19,0
157,40,80,0,16,96,0,0,0,1,20,0
157,576,48,0,1088,32,0,0,0,1,191,0
157,16,288,0,32,32,0,0,0,1,192,0
157,16,256,0,32,32,0,0,0,1,193,0
157,16,224,0,32,32,0,0,0,1,194,0
157,16,192,0,32,32,0,0,0,1,195,0
157,24,168,0,16,16,0,0,0,1,196,0
157,8,168,0,16,16,0,0,0,1,197,0
157,16,112,0,32,32,0,0,0,1,198,0
157,16,80,0,32,32,0,0,0,1,199,0
157,16,48,0,32,32,0,0,0,1,200,0
157,296,168,0,16,16,0,0,0,1,216,0
157,296,120,0,16,16,0,0,0,1,217,0
157,296,104,0,16,16,0,0,0,1,218,0
157,296,136,0,16,16,0,0,0,1,219,0
157,296,152,0,16,16,0,0,0,1,220,0
157,232,104,0,16,16,0,0,0,1,221,0
157,248,104,0,16,16,0,0,0,1,222,0
157,264,104,0,16,16,0,0,0,1,223,0
157,280,104,0,16,16,0,0,0,1,224,0
157,328,168,0,16,16,0,0,0,1,235,0
157,312,168,0,16,16,0,0,0,1,236,0
157,360,168,0,16,16,0,0,0,1,237,0
157,344,168,0,16,16,0,0,0,1,238,0
157,376,168,0,16,16,0,0,0,1,239,0
157,504,280,0,80,16,0,0,0,1,244,0
157,568,328,0,112,16,0,0,0,1,245,0
157,560,296,0,64,16,0,0,0,1,246,0
157,472,264,0,16,16,0,0,0,1,248,0
157,472,216,0,16,16,0,0,0,1,249,0
157,504,200,0,80,16,0,0,0,1,250,0
157,613,80,0,32,32,0,0,0,1,261,0
157,640,296,0,16,16,0,0,0,1,262,0
157,640,312,0,16,16,0,0,0,1,263,0
157,640,264,0,16,16,0,0,0,1,264,0
157,632,328,0,16,16,0,0,0,1,265,0
157,640,280,0,16,16,0,0,0,1,266,0
157,400,176,0,32,16,0,0,0,1,274,0
157,432,184,0,32,16,0,0,0,1,275,0
157,464,192,0,32,16,0,0,0,1,276,0
157,432,104,0,256,16,0,0,0,1,277,0
157,400,120,0,32,16,0,0,0,1,278,0
157,432,128,0,32,16,0,0,0,1,279,0
157,464,136,0,32,16,0,0,0,1,280,0
157,592,144,0,224,16,0,0,0,1,281,0
157,585,200,0,16,16,0,0,0,1,283,0
157,586,222,0,16,32,0,0,0,1,288,0
157,624,240,0,64,32,0,0,0,1,289,0
157,624,248,0,32,32,0,0,0,1,290,0
157,584,352,0,16,16,0,0,0,1,291,0
157,608,208,0,32,32,0,0,0,1,292,0
157,632,208,0,32,32,0,0,0,1,293,0
157,592,120,0,352,32,0,0,0,1,299,0
157,594,103,0,352,32,0,0,0,1,300,0
169,32,128,0,0,0,0,0,0,1,185,1
155,248,168,0,1,1,40,0,0,1,204,0
155,248,296,0,2,1,20,0,0,1,205,0
169,176,272,0,0,0,0,0,0,1,208,1
155,560,272,0,1,2,0,0,0,1,269,0
155,560,200,0,2,2,0,0,0,1,270,0
166,456,216,0,0,206,208,0,0,0,240,1
253,280,160,0,16777215,0,7,0,0,1,226,0
253,280,304,0,16777215,0,7,0,0,1,227,0
253,216,304,0,16777215,0,7,0,0,1,228,0
1234567890
24,128,48,16,64,128,112,10000,0,0,0,0
24,288,176,32,32,80,128,10000,0,0,0,0
25,272,176,144,80,48,96,10002,0,0,0,0
24,416,16,32,16,288,272,10000,0,0,0,0
25,272,176,16,80,192,112,10002,0,0,0,0
25,176,176,80,80,48,208,10002,0,0,0,0
25,176,176,32,80,128,208,10002,0,0,0,0
25,240,176,16,80,160,208,10002,0,0,0,0
25,176,224,80,16,48,288,10002,0,0,0,0
25,176,224,48,16,128,288,10002,0,0,0,0
25,560,304,32,32,0,128,10002,0,0,0,0
24,432,64,32,32,48,256,10000,0,0,0,0
25,0,224,16,32,240,176,10002,0,0,0,0
25,0,224,16,32,240,208,10002,0,0,0,0
25,0,224,16,32,240,240,10002,0,0,0,0
25,0,224,16,32,240,272,10002,0,0,0,0
25,528,320,16,16,512,304,10002,0,0,0,0
25,528,320,16,16,528,304,10002,0,0,0,0
25,528,320,16,16,544,304,10002,0,0,0,0
25,528,320,16,16,576,304,10002,0,0,0,0
25,528,320,16,16,560,304,10002,0,0,0,0
25,272,176,64,48,224,112,10002,0,0,0,0
25,272,176,192,64,272,240,10002,0,0,0,0
25,272,176,192,64,272,176,10002,0,0,0,0
25,272,176,48,80,192,192,10002,0,0,0,0
25,528,320,32,16,496,288,10002,0,0,0,0
25,528,320,32,16,464,288,10002,0,0,0,0
25,272,176,64,64,480,208,10002,0,0,0,0
25,528,256,32,32,624,288,10002,0,0,0,0
25,528,256,32,32,592,288,10002,0,0,0,0
25,528,256,32,32,608,256,10002,0,0,0,0
25,544,320,16,32,592,256,10002,0,0,0,0
24,320,224,32,16,416,288,10000,0,0,0,0
24,512,48,16,16,496,32,10000,0,0,0,0
24,496,32,64,32,320,272,10000,0,0,0,0
25,384,176,32,80,544,208,10002,0,0,0,0
25,272,208,96,48,576,144,10002,0,0,0,0
25,272,208,96,48,480,144,10002,0,0,0,0
25,272,208,96,48,384,128,10002,0,0,0,0
25,272,208,96,48,288,112,10002,0,0,0,0
24,160,288,64,32,480,208,10000,0,0,0,0
24,0,160,32,32,592,288,10000,0,0,0,0
24,0,160,32,32,480,272,10000,0,0,0,0
24,224,160,32,32,544,256,10000,0,0,0,0
24,224,160,32,32,544,224,10000,0,0,0,0
24,224,160,32,32,544,192,10000,0,0,0,0
987654321
Vg==

