VlpyUkxxBnkpcyFDMlNbO1ohekACNjFXF3FyHHY+eQY3Zml8NTghenh/cUNiVSc=
259,512,40,0,96,32,0,0,0,1,17,0
259,448,40,0,32,32,0,0,0,1,18,0
259,272,56,0,448,32,0,0,0,1,19,0
259,56,56,0,80,32,0,0,0,1,20,0
259,48,56,0,64,32,0,0,0,1,21,0
259,632,336,0,16,16,0,0,0,1,55,0
259,632,336,0,16,16,0,0,0,1,56,0
259,656,53,0,32,32,0,0,0,1,73,0
259,656,83,0,32,32,0,0,0,1,74,0
259,656,115,0,32,32,0,0,0,1,75,0
259,656,147,0,32,32,0,0,0,1,76,0
259,656,179,0,32,32,0,0,0,1,77,0
259,656,211,0,32,32,0,0,0,1,78,0
259,656,243,0,32,32,0,0,0,1,79,0
259,656,275,0,32,32,0,0,0,1,80,0
259,656,307,0,32,32,0,0,0,1,81,0
259,656,328,0,32,32,0,0,0,1,82,0
259,608,176,0,32,32,0,0,0,1,134,0
259,608,208,0,32,32,0,0,0,1,140,0
259,608,240,0,32,32,0,0,0,1,141,0
259,608,272,0,32,32,0,0,0,1,142,0
259,608,288,0,32,32,0,0,0,1,143,0
259,608,288,0,32,32,0,0,0,1,144,0
259,608,288,0,32,32,0,0,0,1,145,0
160,979,336,0,0,16777215,0,0,0,1,289,0
100,44,40,0,256,0,0,270,0,1,16,0
100,984,56,0,600,0,268,270,0,1,274,0
197,984,176,0,5,288,0,0,0,1,281,0
174,611,184,0,1,35,0,0,0,0,116,1
174,45,72,0,1,32,0,0,0,0,15,1
181,1091.25,248,0,268,236,0,0,0,1,275,0
185,616,8,0,0,16,1,0,0,1,47,0
185,592,8,0,0,16,1,0,0,1,51,0
185,568,8,0,0,16,1,0,0,1,46,0
185,528,360,0,158,16,1,0,0,1,198,0
185,1128,176,0,0,16,-1,0,0,1,256,0
176,416,328,0,169,32,32,0,0,1,176,0
176,416,328,0,156,32,32,0,0,1,204,0
176,656,328,0,69,32,32,0,0,1,72,0
154,592,101.50,0,1,0.50,64,16,1,1,44,1
154,528,360,0,2,2.50,32,32,-1,1,158,1
154,1001,328,0,3,3,32,32,1,1,244,1
154,1152,171.75,0,4,0.75,32,32,-1,1,268,1
158,608,344,0,0,16777215,1,0,0,1,37,0
157,928,360,0,640,32,0,0,0,1,60,0
157,592,360,0,96,32,0,0,0,1,154,0
157,596,288,0,16,32,0,0,0,1,108,0
157,592,208,0,16,32,0,0,0,1,95,0
157,592,176,0,16,32,0,0,0,1,96,0
157,592,240,0,16,32,0,0,0,1,89,0
157,592,272,0,16,32,0,0,0,1,88,0
157,352,296,0,496,16,0,0,0,1,5,0
157,576,306,0,16,16,0,0,0,1,34,0
157,320,296,0,496,16,0,0,0,1,102,0
157,224,224,0,640,16,0,0,0,1,4,0
157,192,360,0,640,32,0,0,0,1,29,0
157,352,152,0,560,16,0,0,0,1,6,0
157,632,192,0,16,248,0,0,0,1,2,0
157,627,232,0,16,32,0,0,0,1,114,0
157,632,312,0,16,32,0,0,0,1,40,0
157,632,328,0,16,32,0,0,0,1,127,0
157,928,0,0,640,16,0,0,0,1,66,0
157,240,80,0,640,16,0,0,0,1,7,0
157,240,16,0,640,16,0,0,0,1,11,0
157,256,48,0,368,16,0,0,0,1,13,0
157,120,32,0,640,16,0,0,0,1,14,0
157,320,0,0,640,16,0,0,0,1,30,0
157,632,20,0,16,32,0,0,0,1,31,0
157,656,21,0,32,32,0,0,0,1,71,0
157,240,0,0,640,16,0,0,0,1,12,0
157,512,64,0,96,16,0,0,0,1,8,0
157,16,32,0,32,32,0,0,0,1,295,0
157,16,80,0,32,32,0,0,0,1,296,0
157,16,112,0,32,32,0,0,0,1,297,0
157,16,144,0,32,32,0,0,0,1,298,0
157,16,176,0,32,32,0,0,0,1,299,0
157,16,208,0,32,32,0,0,0,1,300,0
157,16,240,0,32,32,0,0,0,1,301,0
157,16,272,0,32,32,0,0,0,1,302,0
157,16,304,0,32,32,0,0,0,1,303,0
157,16,336,0,32,32,0,0,0,1,304,0
157,0,176,0,16,360,0,0,0,1,3,0
157,0,56,0,32,32,0,0,0,1,305,0
157,528,349,0,32,8,0,0,0,1,169,0
157,1240,224,0,16,248,0,0,0,1,233,0
157,1264,240,0,32,248,0,0,0,1,234,0
157,736,24,0,32,32,0,0,0,1,226,0
157,1240,124,0,16,248,0,0,0,1,61,0
157,1264,24,0,32,248,0,0,0,1,235,0
157,976,272,0,80,32,0,0,0,1,288,0
169,624,36,0,0,0,0,0,0,1,32,1
169,568,312,0,0,0,0,0,0,1,35,1
155,592,136,0,1,1,0,0,0,1,42,0
155,592,16,0,2,1,0,0,0,1,43,0
169,672,312,0,0,0,0,0,0,1,69,1
155,528,360,0,1,2,0,0,0,0,156,0
155,528,328,0,2,2,0,0,0,1,157,0
155,40,328,0,3,2,0,0,0,1,160,0
155,40,256,0,4,2,0,0,0,1,167,0
155,560,256,0,5,2,0,0,0,1,168,0
155,560,184,0,6,2,0,0,0,1,183,0
155,40,184,0,7,2,0,0,0,1,184,0
155,40,120,0,8,2,0,0,0,1,191,0
155,1208,328,0,1,3,0,0,0,1,242,0
155,776,328,0,2,3,0,0,0,1,243,0
155,776,24,0,3,3,0,0,0,1,246,0
155,1208,24,0,4,3,0,0,0,1,247,0
155,1208,328,0,5,3,0,0,0,1,248,0
155,1152,120,0,1,4,0,0,0,1,266,0
155,1152,240,0,2,4,0,0,0,1,267,0
155,816,240,0,3,4,0,0,0,1,270,0
155,816,120,0,4,4,0,0,0,1,271,0
155,1152,120,0,5,4,0,0,0,1,272,0
166,776,344,0,0,0,90,0,0,1,250,1
166,1232,336,0,0,0,180,0,0,1,262,1
166,1232,16,0,0,0,180,0,0,1,263,1
166,1216,344,0,0,0,90,0,0,1,264,1
185,856,176,0,0,16,-1,0,0,1,255,0
157,928,272,0,32,32,0,0,0,1,287,0
157,928,296,0,32,32,0,0,0,1,284,0
157,1032,272,0,32,32,0,0,0,1,286,0
157,1032,296,0,32,32,0,0,0,1,285,0
157,992,192,0,272,32,0,0,0,1,249,0
157,680,128,0,16,248,0,0,0,1,67,0
157,680,192,0,16,248,0,0,0,1,68,0
157,688,168,0,16,32,0,0,0,1,215,0
157,688,232,0,16,32,0,0,0,1,212,0
157,688,296,0,16,32,0,0,0,1,210,0
157,688,104,0,16,32,0,0,0,1,217,0
157,728,168,0,16,32,0,0,0,1,214,0
157,728,232,0,16,32,0,0,0,1,213,0
157,728,296,0,16,32,0,0,0,1,211,0
157,736,40,0,32,32,0,0,0,1,227,0
157,728,104,0,16,32,0,0,0,1,216,0
157,744,168,0,16,32,0,0,0,1,219,0
157,744,232,0,16,32,0,0,0,1,220,0
157,744,296,0,16,32,0,0,0,1,221,0
157,744,104,0,16,32,0,0,0,1,218,0
157,1240,188,0,16,248,0,0,0,1,62,0
157,1240,187,0,16,248,0,0,0,1,65,0
219,744,200,0,16,32,0,0,0,1,224,1
219,744,136,0,16,32,0,0,0,1,225,1
219,744,264,0,16,32,0,0,0,1,223,1
219,744,328,0,16,32,0,0,0,1,222,1
219,928,328,0,32,32,0,0,0,1,282,1
219,1032,328,0,32,32,0,0,0,1,283,1
1234567890
25,272,0,64,144,32,0,10002,0,0,0,0
25,272,0,64,144,96,0,10002,0,0,0,0
25,272,0,64,144,160,0,10002,0,0,0,0
25,272,0,64,144,224,0,10002,0,0,0,0
25,272,0,64,144,352,0,10002,0,0,0,0
25,272,0,64,144,416,0,10002,0,0,0,0
25,272,0,64,144,480,0,10002,0,0,0,0
25,272,0,64,144,544,0,10002,0,0,0,0
25,272,0,64,144,608,0,10002,0,0,0,0
25,272,0,64,144,608,144,10002,0,0,0,0
25,272,0,64,144,544,144,10002,0,0,0,0
25,272,0,64,144,160,144,10002,0,0,0,0
25,272,0,64,144,224,144,10002,0,0,0,0
25,272,0,64,144,352,144,10002,0,0,0,0
25,272,0,64,144,416,144,10002,0,0,0,0
25,272,0,64,144,480,144,10002,0,0,0,0
25,272,0,64,144,96,144,10002,0,0,0,0
25,272,0,64,144,32,144,10002,0,0,0,0
25,272,0,64,144,32,288,10002,0,0,0,0
25,272,0,64,144,96,288,10002,0,0,0,0
25,272,0,64,144,160,288,10002,0,0,0,0
25,272,0,64,144,224,288,10002,0,0,0,0
25,272,0,64,144,352,288,10002,0,0,0,0
25,272,0,64,144,416,288,10002,0,0,0,0
25,272,0,64,144,480,288,10002,0,0,0,0
25,272,0,64,144,544,288,10002,0,0,0,0
25,272,0,64,144,608,288,10002,0,0,0,0
25,272,0,64,144,672,0,10002,0,0,0,0
25,272,0,64,144,736,0,10002,0,0,0,0
25,272,0,64,144,800,0,10002,0,0,0,0
25,272,0,64,144,864,0,10002,0,0,0,0
25,272,0,64,144,928,0,10002,0,0,0,0
25,272,0,64,144,992,0,10002,0,0,0,0
25,272,0,64,144,1056,0,10002,0,0,0,0
25,272,0,64,144,1120,0,10002,0,0,0,0
25,272,0,64,144,1184,0,10002,0,0,0,0
25,272,0,64,144,1248,0,10002,0,0,0,0
25,272,0,64,144,1248,144,10002,0,0,0,0
25,272,0,64,144,1248,288,10002,0,0,0,0
25,272,0,64,144,1184,144,10002,0,0,0,0
25,272,0,64,144,1184,288,10002,0,0,0,0
25,272,0,64,144,1120,288,10002,0,0,0,0
25,272,0,64,144,1120,144,10002,0,0,0,0
25,272,0,64,144,1056,144,10002,0,0,0,0
25,272,0,64,144,992,144,10002,0,0,0,0
25,272,0,64,144,928,144,10002,0,0,0,0
25,272,0,64,144,864,144,10002,0,0,0,0
25,272,0,64,144,800,144,10002,0,0,0,0
25,272,0,64,144,736,144,10002,0,0,0,0
25,272,0,64,144,672,144,10002,0,0,0,0
25,272,0,64,144,672,288,10002,0,0,0,0
25,272,0,64,144,736,288,10002,0,0,0,0
25,272,0,64,144,800,288,10002,0,0,0,0
25,272,0,64,144,864,288,10002,0,0,0,0
25,272,0,64,144,928,288,10002,0,0,0,0
25,272,0,64,144,992,288,10002,0,0,0,0
25,272,0,64,144,1056,288,10002,0,0,0,0
24,112,224,32,32,832,144,10000,0,0,0,0
24,496,304,64,32,688,320,10000,0,0,0,0
24,32,192,32,32,1120,144,10000,0,0,0,0
24,368,64,32,16,1200,64,10000,0,0,0,0
24,368,64,32,16,1168,64,10000,0,0,0,0
24,368,64,32,16,1136,64,10000,0,0,0,0
24,320,48,16,48,1120,64,10000,0,0,0,0
24,416,48,16,16,1120,112,10000,0,0,0,0
24,384,80,48,16,1072,64,10000,0,0,0,0
24,336,48,32,16,1072,80,10000,0,0,0,0
24,400,48,16,16,1120,48,10000,0,0,0,0
24,400,48,16,16,1104,48,10000,0,0,0,0
24,384,48,16,16,1072,48,10000,0,0,0,0
24,384,48,16,16,1072,32,10000,0,0,0,0
24,384,48,16,16,1072,16,10000,0,0,0,0
24,384,48,16,16,1072,0,10000,0,0,0,0
24,160,320,48,32,960,128,10000,0,0,0,0
24,0,160,32,32,1008,144,10000,0,0,0,0
24,256,144,32,32,688,16,10000,0,0,0,0
24,0,256,80,32,704,272,10000,0,0,0,0
24,0,256,64,32,944,224,10000,0,0,0,0
24,432,320,64,32,992,96,10000,0,0,0,0
24,432,320,64,32,800,240,10000,0,0,0,0
24,320,256,32,16,1072,96,10000,0,0,0,0
25,272,0,64,144,288,48,10002,0,0,0,0
25,272,0,64,144,288,192,10002,0,0,0,0
25,272,0,64,144,288,336,10002,0,0,0,0
24,432,192,16,16,16,48,10000,0,0,0,0
987654321
EB89FRc1

