VlpyUkxxBnkpcyFDMlNbO1ohekACLj9QDWR7OVk0IEV+enVgKSQ9ZmRjbV8=
160,1208,48,0,0,16777215,0,0,0,1,141,0
210,128,16,0,0,180,0,0,0,1,51,0
210,93,344,0,51,0,0,0,0,1,34,0
210,160,16,0,0,180,0,0,0,1,50,0
210,128,344,0,50,0,0,0,0,1,35,0
210,192,16,0,0,180,0,0,0,1,52,0
210,160,344,0,52,0,0,0,0,1,36,0
210,224,16,0,0,180,0,0,0,1,53,0
210,256,16,0,0,180,0,0,0,1,54,0
210,288,16,0,0,180,0,0,0,1,55,0
210,256,344,0,55,0,0,0,0,1,39,0
210,320,16,0,0,180,0,0,0,1,56,0
210,288,344,0,56,0,0,0,0,1,40,0
210,352,16,0,0,180,0,0,0,1,57,0
210,320,344,0,57,0,0,0,0,1,41,0
210,384,16,0,0,180,0,0,0,1,58,0
210,352,344,0,58,0,0,0,0,1,42,0
210,416,16,0,0,180,0,0,0,1,59,0
210,384,344,0,59,0,0,0,0,1,43,0
210,448,16,0,0,180,0,0,0,1,60,0
210,512,16,0,0,180,0,0,0,1,62,0
210,480,344,0,62,0,0,0,0,1,46,0
210,544,16,0,0,180,0,0,0,1,63,0
210,576,16,0,0,180,0,0,0,1,64,0
210,576,344,0,65,0,0,0,0,1,49,0
210,608,16,0,0,180,0,0,0,1,65,0
210,1232,216,0,0,90,0,0,0,1,135,0
210,632,216,0,0,270,0,0,0,1,129,0
210,632,176,0,0,270,0,0,0,1,128,0
210,1232,136,0,0,90,0,0,0,1,137,0
210,632,296,0,0,270,0,0,0,1,131,0
210,1232,256,0,0,90,0,0,0,1,134,0
210,1216,272,0,130,0,0,0,0,1,116,0
210,1216,232,0,129,0,0,0,0,1,117,0
210,648,232,0,136,0,0,0,0,1,118,0
210,1232,176,0,0,90,0,0,0,1,136,0
210,1216,192,0,128,0,0,0,0,1,119,0
210,1216,152,0,126,0,0,0,0,1,121,0
210,1232,96,0,0,90,0,0,0,1,138,0
210,1216,112,0,127,0,0,0,0,1,124,0
210,664,344,0,133,0,0,0,0,1,139,0
210,1232,296,0,0,90,0,0,0,1,133,0
210,1216,312,0,131,0,0,0,0,1,113,0
210,448,344,0,61,0,0,0,0,1,45,0
210,648,152,0,138,0,0,0,0,1,122,0
210,192,344,0,53,0,0,0,0,1,37,0
210,224,344,0,54,0,0,0,0,1,38,0
210,544,344,0,64,0,0,0,0,1,48,0
210,512,344,0,63,0,0,0,0,1,47,0
210,416,344,0,60,0,0,0,0,1,44,0
210,648,312,0,134,0,0,0,0,1,114,0
210,648,272,0,135,0,0,0,0,1,115,0
210,632,256,0,0,270,0,0,0,1,130,0
210,480,16,0,0,180,0,0,0,1,61,0
210,632,96,0,0,270,0,0,0,1,127,0
210,632,136,0,0,270,0,0,0,1,126,0
210,648,192,0,137,0,0,0,0,1,120,0
210,664,48,0,0,0,0,0,0,1,125,0
210,648,112,0,125,0,0,0,0,1,123,0
158,32,48,0,0,16777215,0,1,0,1,33,0
157,320,0,0,640,32,0,0,0,1,99,0
157,320,360,0,640,32,0,0,0,1,2,0
157,944,240,0,640,16,0,0,0,1,105,0
157,944,200,0,640,16,0,0,0,1,106,0
157,944,160,0,640,16,0,0,0,1,107,0
157,944,120,0,640,16,0,0,0,1,108,0
157,928,80,0,608,16,0,0,0,1,109,0
157,624,144,0,16,360,0,0,0,1,32,0
157,944,64,0,640,32,0,0,0,1,110,0
157,952,0,0,640,32,0,0,0,1,100,0
157,960,360,0,640,32,0,0,0,1,101,0
157,936,320,0,640,16,0,0,0,1,103,0
157,936,280,0,640,16,0,0,0,1,104,0
157,664,8,0,16,32,0,0,0,1,145,0
157,640,8,0,32,32,0,0,0,1,146,0
157,560,192,0,16,360,0,0,0,1,30,0
157,528,192,0,16,360,0,0,0,1,29,0
157,592,192,0,16,360,0,0,0,1,31,0
157,496,192,0,16,360,0,0,0,1,28,0
157,464,192,0,16,360,0,0,0,1,27,0
157,432,192,0,16,360,0,0,0,1,26,0
157,368,192,0,16,360,0,0,0,1,24,0
157,336,192,0,16,360,0,0,0,1,23,0
157,400,192,0,16,360,0,0,0,1,25,0
157,304,192,0,16,360,0,0,0,1,22,0
157,272,184,0,16,360,0,0,0,1,21,0
157,240,176,0,16,360,0,0,0,1,20,0
157,208,176,0,16,360,0,0,0,1,19,0
157,176,176,0,16,360,0,0,0,1,18,0
157,144,176,0,16,360,0,0,0,1,17,0
157,112,176,0,16,360,0,0,0,1,16,0
157,64,64,0,32,32,0,0,0,1,5,0
157,64,96,0,32,32,0,0,0,1,7,0
157,48,128,0,64,32,0,0,0,1,8,0
157,48,160,0,64,32,0,0,0,1,9,0
157,48,192,0,64,32,0,0,0,1,10,0
157,48,224,0,64,32,0,0,0,1,11,0
157,48,256,0,64,32,0,0,0,1,12,0
157,48,288,0,64,32,0,0,0,1,13,0
157,48,320,0,64,32,0,0,0,1,14,0
157,48,352,0,64,32,0,0,0,1,15,0
157,32,64,0,32,32,0,0,0,1,4,0
157,32,96,0,32,32,0,0,0,1,6,0
157,8,184,0,16,360,0,0,0,1,3,0
157,992,336,0,640,16,0,0,0,1,140,0
157,1240,176,0,16,360,0,0,0,1,102,0
157,1261,181,0,48,360,0,0,0,1,143,0
157,1256,176,0,16,360,0,0,0,1,142,0
1234567890
25,176,176,80,80,0,0,10002,0,0,0,0
25,176,176,80,80,0,80,10002,0,0,0,0
25,176,176,80,80,0,160,10002,0,0,0,0
25,176,176,80,80,0,240,10002,0,0,0,0
25,176,176,80,80,0,320,10002,0,0,0,0
25,176,176,80,80,80,320,10002,0,0,0,0
25,176,176,80,80,80,240,10002,0,0,0,0
25,176,176,80,80,80,160,10002,0,0,0,0
25,176,176,80,80,80,80,10002,0,0,0,0
25,176,176,80,80,80,0,10002,0,0,0,0
25,176,176,80,80,160,0,10002,0,0,0,0
25,176,176,80,80,240,0,10002,0,0,0,0
25,176,176,80,80,320,0,10002,0,0,0,0
25,176,176,80,80,400,0,10002,0,0,0,0
25,176,176,80,80,480,0,10002,0,0,0,0
25,176,176,80,80,560,0,10002,0,0,0,0
25,176,176,80,80,160,80,10002,0,0,0,0
25,176,176,80,80,240,80,10002,0,0,0,0
25,176,176,80,80,320,80,10002,0,0,0,0
25,176,176,80,80,400,80,10002,0,0,0,0
25,176,176,80,80,480,80,10002,0,0,0,0
25,176,176,80,80,560,80,10002,0,0,0,0
25,176,176,80,80,160,160,10002,0,0,0,0
25,176,176,80,80,240,160,10002,0,0,0,0
25,176,176,80,80,320,160,10002,0,0,0,0
25,176,176,80,80,400,160,10002,0,0,0,0
25,176,176,80,80,480,160,10002,0,0,0,0
25,176,176,80,80,560,160,10002,0,0,0,0
25,176,176,80,80,160,240,10002,0,0,0,0
25,176,176,80,80,240,240,10002,0,0,0,0
25,176,176,80,80,320,240,10002,0,0,0,0
25,176,176,80,80,400,240,10002,0,0,0,0
25,176,176,80,80,480,240,10002,0,0,0,0
25,176,176,80,80,560,240,10002,0,0,0,0
25,176,176,80,80,160,320,10002,0,0,0,0
25,176,176,80,80,240,320,10002,0,0,0,0
25,176,176,80,80,320,320,10002,0,0,0,0
25,176,176,80,80,400,320,10002,0,0,0,0
25,176,176,80,80,480,320,10002,0,0,0,0
25,176,176,80,80,560,320,10002,0,0,0,0
25,176,176,80,80,640,16,10002,0,0,0,0
25,176,176,80,80,720,16,10002,0,0,0,0
25,176,176,80,80,800,16,10002,0,0,0,0
25,176,176,80,80,880,16,10002,0,0,0,0
25,176,176,80,80,960,16,10002,0,0,0,0
25,176,176,80,80,1040,16,10002,0,0,0,0
25,176,176,80,80,1120,16,10002,0,0,0,0
25,176,176,80,80,1200,16,10002,0,0,0,0
25,176,176,80,80,640,96,10002,0,0,0,0
25,176,176,80,80,720,96,10002,0,0,0,0
25,176,176,80,80,800,96,10002,0,0,0,0
25,176,176,80,80,880,96,10002,0,0,0,0
25,176,176,80,80,960,96,10002,0,0,0,0
25,176,176,80,80,1040,96,10002,0,0,0,0
25,176,176,80,80,1120,96,10002,0,0,0,0
25,176,176,80,80,1200,96,10002,0,0,0,0
25,176,176,80,80,640,176,10002,0,0,0,0
25,176,176,80,80,720,176,10002,0,0,0,0
25,176,176,80,80,800,176,10002,0,0,0,0
25,176,176,80,80,880,176,10002,0,0,0,0
25,176,176,80,80,960,176,10002,0,0,0,0
25,176,176,80,80,1040,176,10002,0,0,0,0
25,176,176,80,80,1120,176,10002,0,0,0,0
25,176,176,80,80,1200,176,10002,0,0,0,0
25,176,176,80,80,640,256,10002,0,0,0,0
25,176,176,80,80,720,256,10002,0,0,0,0
25,176,176,80,80,800,256,10002,0,0,0,0
25,176,176,80,80,880,256,10002,0,0,0,0
25,176,176,80,80,960,256,10002,0,0,0,0
25,176,176,80,80,1040,256,10002,0,0,0,0
25,176,176,80,80,1120,256,10002,0,0,0,0
25,176,176,80,80,1200,256,10002,0,0,0,0
25,176,176,80,80,640,336,10002,0,0,0,0
25,176,176,80,80,720,336,10002,0,0,0,0
25,176,176,80,80,800,336,10002,0,0,0,0
25,176,176,80,80,880,336,10002,0,0,0,0
25,176,176,80,80,960,336,10002,0,0,0,0
25,176,176,80,80,1040,336,10002,0,0,0,0
25,176,176,80,80,1120,336,10002,0,0,0,0
25,176,176,80,80,1200,336,10002,0,0,0,0
987654321
EB89FRc1

