XlF4TlN0AGU9Z2BPK11MNFktYxR9OxNwPFFVOW0UIEV+enVgKSQ9ZmRjbV8=
259,56,136,0,112,32,0,0,0,1,58,0
259,96,168,0,32,32,0,0,0,1,59,0
259,96,192,0,32,32,0,0,0,1,61,0
259,48,264,0,32,32,0,0,0,1,62,0
259,24,232,0,96,32,0,0,0,1,63,0
259,16,264,0,32,32,0,0,0,1,64,0
259,48,248,0,96,32,0,0,0,1,65,0
259,48,200,0,96,32,0,0,0,1,66,0
259,24,168,0,112,32,0,0,0,1,68,0
160,48,336,0,0,16777215,0,0,0,1,302,0
123,224,48,0,128,0,0,0,0,1,347,0
123,240,336,0,128,0,0,0,0,1,345,0
123,432,328,0,128,0,0,0,0,1,350,0
123,320,328,0,128,0,0,0,0,1,353,0
123,504,256,0,128,0,0,0,0,1,354,0
123,320,192,0,128,0,0,0,0,1,348,0
123,384,48,0,128,0,0,0,0,1,346,0
123,504,176,0,128,0,0,0,0,1,355,0
123,496,96,0,128,0,0,0,0,1,356,0
123,720,264,0,128,0,0,0,0,1,308,0
123,920,136,0,308,0,0,0,0,1,362,0
123,776,56,0,308,0,0,0,0,1,363,0
123,792,328,0,308,0,0,0,0,1,364,0
123,144,184,0,128,0,0,0,0,1,344,0
123,144,80,0,128,0,0,0,0,1,352,0
123,64,48,0,128,0,0,0,0,1,349,0
123,144,320,0,128,0,0,0,0,1,351,0
123,840,264,0,128,0,0,0,0,1,309,0
197,96,88,0,2,0,0,0,0,1,72,0
197,920,152,0,2,0,0,0,0,1,296,0
174,776,216,0,1,279,0,0,0,0,284,1
174,64,88,0,1,98,122,371,0,0,124,1
181,674.50,304,0,250,228,0,0,0,1,252,0
205,863.50,344,0,1,0,0.50,0,0,1,332,0
220,496,68,0,64,8,0,0,0,0,371,1
186,32,88,0,32,32,0,0,0,1,43,0
219,696,232,0,112,32,0,0,0,1,266,1
219,144,71,0,64,8,0,0,0,1,377,1
188,320,160,0,180,199,0,0,0,1,162,0
188,24,344,0,0,37,0,0,0,1,46,0
188,832,344,0,0,319,0,0,0,1,326,0
188,792,344,0,0,0,321,0,0,1,325,0
188,752,344,0,0,0,0,322,0,1,324,0
188,272,192,0,270,200,0,0,0,1,163,0
188,96,208,0,0,22,0,0,0,1,142,0
188,320,224,0,0,189,0,0,0,1,165,0
188,376,192,0,90,198,0,0,0,1,164,0
242,592,48,0,32,32,0,0,0,1,338,0
242,64,72,0,32,32,0,0,0,1,206,0
154,304,216,0,1,1,8,8,1,1,169,1
154,668,280,0,2,0.50,32,32,-1,1,250,1
158,56,344,0,0,16777215,0,1,0,1,2,0
216,320,192,0,21,0,0,0,0,1,201,0
157,320,240,0,160,32,0,0,0,1,158,0
157,320,144,0,160,32,0,0,0,1,159,0
157,392,192,0,32,160,0,0,0,1,161,0
157,328,256,0,160,32,0,0,0,1,214,0
157,352,296,0,32,32,0,0,0,1,157,0
157,296,360,0,272,32,0,0,0,1,15,0
157,320,296,0,32,32,0,0,0,1,212,0
157,384,296,0,32,32,0,0,0,1,156,0
157,320,80,0,288,32,0,0,0,1,150,0
157,328,128,0,160,32,0,0,0,1,213,0
157,304,0,0,384,8,0,0,0,1,92,0
157,448,192,0,32,248,0,0,0,1,151,0
157,464,232,0,32,32,0,0,0,1,196,0
157,560,264,0,32,400,0,0,0,1,143,0
157,536,360,0,272,32,0,0,0,1,16,0
157,416,296,0,32,32,0,0,0,1,155,0
157,544,280,0,32,32,0,0,0,1,195,0
157,464,128,0,32,32,0,0,0,1,188,0
157,624,264,0,32,400,0,0,0,1,145,0
157,544,184,0,32,32,0,0,0,1,197,0
157,592,264,0,32,400,0,0,0,1,144,0
157,504,0,0,32,8,0,0,0,1,91,0
157,632,136,0,48,32,0,0,0,1,317,0
157,536,56,0,32,32,0,0,0,1,194,0
157,648,168,0,48,32,0,0,0,1,316,0
157,568,0,0,32,8,0,0,0,1,89,0
157,536,0,0,32,8,0,0,0,1,90,0
157,664,200,0,48,32,0,0,0,1,315,0
157,776,0,0,272,8,0,0,0,1,219,0
157,624,0,0,32,8,0,0,0,1,86,0
157,600,0,0,32,8,0,0,0,1,87,0
157,608,0,0,32,8,0,0,0,1,88,0
157,256,192,0,32,160,0,0,0,1,160,0
157,192,192,0,32,248,0,0,0,1,152,0
157,112,56,0,8,32,0,0,0,1,183,0
157,112,104,0,8,32,0,0,0,1,50,0
157,112,80,0,8,32,0,0,0,1,71,0
157,32,104,0,160,32,0,0,0,1,22,0
157,96,0,0,32,8,0,0,0,1,93,0
157,288,296,0,32,32,0,0,0,1,211,0
157,256,296,0,32,32,0,0,0,1,154,0
157,224,296,0,32,32,0,0,0,1,153,0
157,144,360,0,32,32,0,0,0,1,14,0
157,112,360,0,32,32,0,0,0,1,13,0
157,32,360,0,32,32,0,0,0,1,7,0
157,112,168,0,8,32,0,0,0,1,33,0
157,112,136,0,8,32,0,0,0,1,36,0
157,64,0,0,32,32,0,0,0,1,85,0
157,112,232,0,8,32,0,0,0,1,31,0
157,112,200,0,8,32,0,0,0,1,32,0
157,112,224,0,8,32,0,0,0,1,34,0
157,112,256,0,8,32,0,0,0,1,30,0
157,112,256,0,8,32,0,0,0,1,35,0
157,112,264,0,8,32,0,0,0,1,42,0
157,96,224,0,32,32,0,0,0,1,24,0
157,96,256,0,32,32,0,0,0,1,25,0
157,88,264,0,48,32,0,0,0,1,39,0
157,88,328,0,32,32,0,0,0,1,182,0
157,84,360,0,32,32,0,0,0,1,12,0
157,79,360,0,32,32,0,0,0,1,11,0
157,74,360,0,32,32,0,0,0,1,10,0
157,69,360,0,32,32,0,0,0,1,9,0
157,72,224,0,24,32,0,0,0,1,28,0
157,72,256,0,24,32,0,0,0,1,29,0
157,64,360,0,32,32,0,0,0,1,8,0
157,64,264,0,8,32,0,0,0,1,41,0
157,48,0,0,32,32,0,0,0,1,77,0
157,16,0,0,32,32,0,0,0,1,79,0
157,0,296,0,32,32,0,0,0,1,4,0
157,0,320,0,32,32,0,0,0,1,5,0
157,0,352,0,32,32,0,0,0,1,6,0
157,0,72,0,32,32,0,0,0,1,78,0
157,0,48,0,32,32,0,0,0,1,80,0
157,0,32,0,32,32,0,0,0,1,81,0
157,0,232,0,8,32,0,0,0,1,52,0
157,0,264,0,8,32,0,0,0,1,53,0
157,0,168,0,8,32,0,0,0,1,55,0
157,0,200,0,8,32,0,0,0,1,56,0
157,0,136,0,8,32,0,0,0,1,54,0
157,808,360,0,272,32,0,0,0,1,220,0
157,832,360,0,272,32,0,0,0,1,227,0
157,776,232,0,48,32,0,0,0,1,267,0
157,824,0,0,272,8,0,0,0,1,226,0
157,760,112,0,32,32,0,0,0,1,318,0
157,912,168,0,48,32,0,0,0,1,277,0
157,912,232,0,48,32,0,0,0,1,281,0
157,912,104,0,48,32,0,0,0,1,278,0
157,952,192,0,32,400,0,0,0,1,241,0
157,976,184,0,32,400,0,0,0,1,225,0
169,80,280,0,0,0,0,0,0,1,37,1
169,560,32,0,0,0,0,0,0,1,98,1
169,560,0,0,0,0,0,0,0,1,122,1
155,280,216,0,1,1,0,0,0,1,167,0
155,368,216,0,2,1,0,0,0,1,168,0
155,368,168,0,3,1,0,0,0,1,171,0
155,280,168,0,4,1,0,0,0,1,172,0
155,280,216,0,5,1,0,0,0,1,173,0
155,368,216,0,6,1,0,0,0,1,174,0
155,368,168,0,7,1,0,0,0,1,175,0
155,280,168,0,8,1,0,0,0,1,176,0
155,656,280,0,1,2,0,0,0,1,248,0
155,920,280,0,2,2,0,0,0,1,249,0
169,888,120,0,0,0,0,0,0,1,279,1
166,104,320,0,0,0,0,0,0,0,189,1
166,504,344,0,0,0,90,0,0,0,198,1
166,512,48,0,0,0,180,0,0,0,199,1
166,144,8,0,0,0,270,0,0,0,200,1
166,760,128,0,0,0,270,0,0,1,319,1
166,744,112,0,0,0,212,0,0,1,321,1
166,744,96,0,0,0,165,0,0,1,322,1
253,32,88,0,16711680,0,1,0,0,1,84,0
253,56,344,0,8388863,0,1,0,0,1,128,0
253,24,344,0,4227327,0,1,0,0,1,127,0
253,96,208,0,8454143,0,1,0,0,1,126,0
253,96,88,0,65280,0,1,0,0,1,74,0
253,64,88,0,255,0,1,0,0,1,125,0
196,104.50,319.50,0,0,0,0,0,0,0,0,0
219,864,232,0,144,32,0,0,0,1,268,1
123,920,200,0,56,0,0,0,0,1,365,0
1234567890
25,0,256,96,96,0,0,10002,0,0,0,0
25,0,256,96,96,96,0,10002,0,0,0,0
25,0,256,96,96,192,0,10002,0,0,0,0
25,0,256,96,96,288,0,10002,0,0,0,0
25,0,256,96,96,384,0,10002,0,0,0,0
25,0,256,96,96,0,96,10002,0,0,0,0
25,0,256,96,96,0,192,10002,0,0,0,0
25,0,256,96,96,0,288,10002,0,0,0,0
25,0,256,96,96,96,288,10002,0,0,0,0
25,0,256,96,96,192,288,10002,0,0,0,0
25,0,256,96,96,288,288,10002,0,0,0,0
25,0,256,96,96,384,288,10002,0,0,0,0
25,0,256,96,96,480,288,10002,0,0,0,0
25,0,256,96,96,480,192,10002,0,0,0,0
25,0,256,96,96,480,96,10002,0,0,0,0
25,0,256,96,96,480,0,10002,0,0,0,0
25,0,256,96,96,384,192,10002,0,0,0,0
25,0,256,96,96,384,96,10002,0,0,0,0
25,0,256,96,96,288,96,10002,0,0,0,0
25,0,256,96,96,192,96,10002,0,0,0,0
25,0,256,96,96,96,96,10002,0,0,0,0
25,0,256,96,96,96,192,10002,0,0,0,0
25,0,256,96,96,192,192,10002,0,0,0,0
25,0,256,96,96,288,192,10002,0,0,0,0
25,0,256,96,96,576,0,10002,0,0,0,0
25,0,256,96,96,672,0,10002,0,0,0,0
25,0,256,96,96,768,0,10002,0,0,0,0
25,0,256,96,96,864,0,10002,0,0,0,0
25,0,256,96,96,960,0,10002,0,0,0,0
25,0,256,96,96,576,96,10002,0,0,0,0
25,0,256,96,96,672,96,10002,0,0,0,0
25,0,256,96,96,768,96,10002,0,0,0,0
25,0,256,96,96,864,96,10002,0,0,0,0
25,0,256,96,96,976,96,10002,0,0,0,0
25,0,256,96,96,624,192,10002,0,0,0,0
25,0,256,96,96,720,192,10002,0,0,0,0
25,0,256,96,96,816,192,10002,0,0,0,0
25,0,256,96,96,912,192,10002,0,0,0,0
25,0,256,96,96,624,288,10002,0,0,0,0
25,0,256,96,96,720,288,10002,0,0,0,0
25,0,256,96,96,816,288,10002,0,0,0,0
25,0,256,96,96,912,288,10002,0,0,0,0
987654321
EB89FRc1

