UVx6TlN0AGU9Z0lLIEJKNBgYfkpDFz5DFSknVA59PFliZml8NTgh
160,304,96,0,0,16777215,0,0,0,1,169,0
218,32,32,0,256,0,0,323,0,1,9,0
100,256,128,0,256,0,0,209,0,1,60,0
218,512,120,0,256,0,0,271,0,1,163,0
195,144,128,0,0,128,323,0,70,1,59,0
197,512,192,0,10,26,0,0,0,1,170,0
174,120,96,0,1,28,21,0,0,0,31,1
219,176,80,0,32,32,0,0,0,1,26,1
176,48,176,0,21,32,32,0,0,1,45,0
176,48,176,0,28,32,32,0,0,1,40,0
158,48,88,0,0,16777215,0,1,0,1,15,0
210,584,192,0,173,0,0,0,0,1,171,0
210,136,96,0,0,0,0,0,0,1,173,0
157,16,16,0,32,32,0,0,0,1,14,0
157,16,48,0,32,32,0,0,0,1,2,0
157,48,16,0,32,32,0,0,0,1,3,0
157,16,80,0,32,32,0,0,0,1,4,0
157,16,112,0,32,32,0,0,0,1,5,0
157,80,112,0,32,32,0,0,0,1,8,0
157,112,112,0,32,32,0,0,0,1,10,0
157,80,16,0,32,32,0,0,0,1,11,0
157,112,16,0,32,32,0,0,0,1,12,0
157,144,112,0,32,32,0,0,0,1,16,0
157,176,112,0,32,32,0,0,0,1,18,0
157,176,48,0,32,32,0,0,0,1,23,0
157,144,16,0,32,32,0,0,0,1,24,0
157,176,16,0,32,32,0,0,0,1,25,0
157,16,144,0,32,32,0,0,0,1,34,0
157,16,176,0,32,32,0,0,0,1,36,0
157,208,112,0,32,32,0,0,0,1,38,0
157,240,112,0,32,32,0,0,0,1,39,0
157,16,208,0,32,32,0,0,0,1,41,0
157,48,208,0,32,32,0,0,0,1,42,0
157,80,208,0,32,32,0,0,0,1,49,0
157,112,208,0,32,32,0,0,0,1,50,0
157,144,208,0,32,32,0,0,0,1,51,0
157,176,208,0,32,32,0,0,0,1,54,0
157,208,208,0,32,32,0,0,0,1,55,0
157,240,208,0,32,32,0,0,0,1,56,0
157,272,208,0,32,32,0,0,0,1,57,0
157,272,112,0,32,32,0,0,0,1,58,0
157,304,208,0,32,32,0,0,0,1,82,0
157,304,112,0,32,32,0,0,0,1,83,0
157,336,208,0,32,32,0,0,0,1,89,0
157,464,208,0,32,32,0,0,0,1,90,0
157,368,208,0,32,32,0,0,0,1,91,0
157,336,112,0,32,32,0,0,0,1,96,0
157,368,112,0,32,32,0,0,0,1,97,0
157,400,112,0,32,32,0,0,0,1,98,0
157,432,112,0,32,32,0,0,0,1,101,0
157,464,112,0,32,32,0,0,0,1,102,0
157,496,112,0,32,32,0,0,0,1,105,0
157,528,112,0,32,32,0,0,0,1,106,0
157,560,112,0,32,32,0,0,0,1,107,0
157,592,112,0,32,32,0,0,0,1,108,0
157,624,112,0,32,32,0,0,0,1,109,0
157,400,208,0,32,32,0,0,0,1,114,0
157,624,208,0,32,32,0,0,0,1,115,0
157,432,208,0,32,32,0,0,0,1,119,0
157,592,208,0,32,32,0,0,0,1,120,0
157,16,240,0,32,32,0,0,0,1,123,0
157,16,272,0,32,32,0,0,0,1,124,0
157,16,304,0,32,32,0,0,0,1,125,0
157,16,336,0,32,32,0,0,0,1,126,0
157,16,360,0,32,32,0,0,0,1,127,0
157,224,296,0,896,144,0,0,0,1,128,0
157,496,208,0,32,32,0,0,0,1,135,0
157,624,88,0,32,32,0,0,0,1,157,0
157,624,56,0,32,32,0,0,0,1,158,0
157,624,24,0,32,32,0,0,0,1,159,0
157,624,8,0,32,32,0,0,0,1,160,0
157,560,208,0,32,32,0,0,0,1,165,0
157,528,208,0,32,32,0,0,0,1,166,0
157,432,16,0,696,32,0,0,0,1,167,0
157,480,24,0,296,200,0,0,0,1,168,0
169,160,64,0,0,0,0,0,0,1,21,1
172,32,96,0,0,0,0,0,0,1,28,1
166,32,168,0,0,0,0,0,0,0,70,1
255,144,48,0,38,40,1,0,0,1,93,0
1234567890
25,592,0,32,48,32,48,10002,0,0,0,0
25,592,0,32,48,64,48,10002,0,0,0,0
25,592,0,32,48,96,48,10002,0,0,0,0
25,592,0,32,48,128,48,10002,0,0,0,0
25,592,0,32,16,32,32,10002,0,0,0,0
25,592,0,32,16,64,32,10002,0,0,0,0
25,592,0,32,16,96,32,10002,0,0,0,0
25,592,0,32,16,128,32,10002,0,0,0,0
24,96,96,32,32,128,64,10000,0,0,0,0
25,48,0,48,48,32,144,10002,0,0,0,0
25,48,0,48,48,80,144,10002,0,0,0,0
25,48,0,48,48,32,96,10002,0,0,0,0
25,48,0,48,48,80,96,10002,0,0,0,0
25,48,0,48,48,176,144,10002,0,0,0,0
25,48,0,48,48,176,96,10002,0,0,0,0
25,48,0,48,48,224,144,10002,0,0,0,0
25,48,0,48,48,224,96,10002,0,0,0,0
25,256,0,16,80,128,112,10002,0,0,0,0
25,64,0,32,48,144,144,10002,0,0,0,0
25,64,0,32,48,144,96,10002,0,0,0,0
25,48,0,48,48,272,144,10002,0,0,0,0
25,48,0,48,48,272,96,10002,0,0,0,0
25,48,0,48,48,320,144,10002,0,0,0,0
25,48,0,48,48,320,96,10002,0,0,0,0
25,48,0,48,48,368,144,10002,0,0,0,0
25,48,0,48,48,368,96,10002,0,0,0,0
25,48,0,48,48,416,144,10002,0,0,0,0
25,48,0,48,48,416,96,10002,0,0,0,0
25,48,0,48,48,464,144,10002,0,0,0,0
25,48,0,48,48,464,96,10002,0,0,0,0
25,48,0,48,48,512,144,10002,0,0,0,0
25,48,0,48,48,512,96,10002,0,0,0,0
25,48,0,48,48,560,144,10002,0,0,0,0
25,48,0,48,48,560,96,10002,0,0,0,0
25,48,0,48,48,608,144,10002,0,0,0,0
25,48,0,48,48,608,96,10002,0,0,0,0
25,48,0,48,48,-16,192,10002,0,0,0,0
25,48,0,48,48,-16,240,10002,0,0,0,0
25,48,0,48,48,-16,288,10002,0,0,0,0
25,48,0,48,48,-16,336,10002,0,0,0,0
25,592,0,32,48,192,48,10002,0,0,0,0
25,592,0,32,48,192,0,10002,0,0,0,0
25,592,0,32,48,224,48,10002,0,0,0,0
25,592,0,32,48,224,0,10002,0,0,0,0
25,592,0,32,48,256,48,10002,0,0,0,0
25,592,0,32,48,256,0,10002,0,0,0,0
25,592,0,32,48,288,48,10002,0,0,0,0
25,592,0,32,48,288,0,10002,0,0,0,0
25,592,0,32,48,320,48,10002,0,0,0,0
25,592,0,32,48,320,0,10002,0,0,0,0
25,0,224,16,32,160,64,10002,0,0,0,0
25,592,0,16,48,176,48,10002,0,0,0,0
987654321
LgVqAw5iVS1sP2JcfQ==
SUZkTA==
NwQrG0AvSWlpLntLP1gD
JREvTwI7VWc=

