UVx6TlN0AGU9Z0pvAWdiFHNgVHVpUmAOSSknVA59PFliZmk=
259,32,48,0,32,32,0,0,0,1,8,0
259,16,16,0,32,32,0,0,0,1,14,0
259,120,24,0,121,187,0,0,0,1,49,0
160,336,88,0,0,16777215,0,0,0,1,195,0
218,485,181,0,256,0,108,0,0,1,115,0
218,144,120,0,256,0,0,270,0,1,68,0
224,112,48,0,128,0,0,0,0,1,37,0
123,24,20,0,128,0,0,0,0,1,11,0
218,288,200,0,256,0,108,0,0,1,117,0
218,304,152,0,256,0,108,0,0,1,113,0
178,144,232,0,32,32,0,0,0,0,56,0
178,176,232,0,32,32,0,0,0,0,61,0
218,346,233,0,256,0,108,0,0,1,116,0
218,343,88,0,256,0,108,0,0,1,114,0
174,216,192,0,0,0,56,61,0,0,63,1
174,8,32,0,1,19,17,38,93,0,12,1
174,226,210,0,0,168,0,0,0,0,171,1
174,144,208,0,0,31,80,81,82,0,93,1
181,264,184,0,108,128,0,0,0,1,104,0
181,112,296,0,0,128,0,0,0,1,154,0
194,368,176,0,0,128,0,0,0,1,161,0
194,127,302,0,0,128,0,0,0,1,153,0
194,144,325,0,0,128,0,0,0,1,160,0
194,368,216,0,0,128,0,0,0,1,159,0
205,124,344,0,1,1.99,1.99,0,0,1,136,0
205,138,344,0,1,0,1.99,0,0,1,137,0
186,120,264,0,32,32,0,0,0,1,147,0
219,176,296,0,32,32,0,0,0,1,189,1
188,64,240,0,0,82,80,81,0,1,84,0
185,389.36,99.91,0,76,32,1,0,0,1,54,0
242,400,80,0,32,32,0,0,0,1,142,0
176,104,96,0,98,32,32,0,0,1,99,0
176,144,144,0,63,32,32,0,0,1,55,0
176,120,280,0,171,32,32,0,0,1,172,0
175,108,179,0,0,60,0,0,0,1,83,0
175,232,256,0,93,1,0,0,0,0,98,0
154,389.36,99.91,0,1,0.50,32,32,-1,1,76,1
154,232,312,0,2,0.50,32,32,-1,1,88,1
154,542.45,257.55,0,3,0.50,32,32,-1,1,108,1
158,16,112,0,0,16777215,0,1,0,1,13,0
216,120,56,0,0,0,0,0,0,1,43,0
210,248,344,0,183,0,0,0,0,1,182,0
210,328,96,0,0,0,0,0,0,1,183,0
157,16,128,0,32,32,0,0,0,1,2,0
157,48,128,0,32,32,0,0,0,1,3,0
157,48,16,0,32,32,0,0,0,1,4,0
157,48,48,0,32,32,0,0,0,1,5,0
157,48,80,0,32,32,0,0,0,1,6,0
157,0,48,0,32,32,0,0,0,1,7,0
157,0,48,0,32,32,0,0,0,1,9,0
157,80,128,0,32,32,0,0,0,1,15,0
157,112,128,0,32,32,0,0,0,1,16,0
157,192,128,0,32,32,0,0,0,1,23,0
157,192,96,0,32,32,0,0,0,1,24,0
157,192,64,0,32,32,0,0,0,1,25,0
157,192,32,0,32,32,0,0,0,1,26,0
157,192,0,0,32,32,0,0,0,1,27,0
157,328,112,0,32,32,0,0,0,1,33,0
157,392,112,0,32,32,0,0,0,1,34,0
157,424,112,0,32,32,0,0,0,1,35,0
157,456,112,0,32,32,0,0,0,1,36,0
157,176,128,0,32,32,0,0,0,1,44,0
157,80,232,0,32,32,0,0,0,1,78,0
157,48,232,0,32,32,0,0,0,1,79,0
157,80,264,0,32,32,0,0,0,1,122,0
157,176,240,0,32,32,0,0,0,1,123,0
157,176,208,0,32,32,0,0,0,1,124,0
157,176,176,0,32,32,0,0,0,1,125,0
157,176,146,0,32,32,0,0,0,1,126,0
157,176,264,0,32,32,0,0,0,1,128,0
157,80,360,0,32,32,0,0,0,1,132,0
157,112,360,0,32,32,0,0,0,1,133,0
157,144,360,0,32,32,0,0,0,1,134,0
157,176,360,0,32,32,0,0,0,1,135,0
157,48,360,0,32,32,0,0,0,1,166,0
157,16,360,0,32,32,0,0,0,1,167,0
157,80,296,0,32,32,0,0,0,1,170,0
157,240,360,0,32,32,0,0,0,1,179,0
157,208,360,0,32,32,0,0,0,1,180,0
157,176,264,0,32,32,0,0,0,1,181,0
169,48,80,0,0,0,0,0,0,1,17,1
169,32,80,0,0,0,0,0,0,1,19,1
172,344,96,0,0,0,0,0,0,1,31,1
172,128,112,0,0,0,0,0,0,1,38,1
155,328,104,0,1,1,0,0,0,1,74,0
155,448,96,0,2,1,0,0,0,1,75,0
155,232,312,0,1,2,0,0,0,1,86,0
155,232,312,0,2,2,0,0,0,1,87,0
155,512,288,0,1,3,0,0,0,1,106,0
155,552,248,0,2,3,0,0,0,1,107,0
155,576,328,0,3,3,0,0,0,1,110,0
155,632,304,0,4,3,0,0,0,1,111,0
155,608,216,0,5,3,0,0,0,1,112,0
169,80,312,0,0,0,0,0,0,1,168,1
166,208,136,0,0,0,0,0,0,1,30,1
166,48,208,0,0,0,114,0,0,0,80,1
166,56,208,0,0,0,91,0,0,0,81,1
166,64,208,0,0,0,52,0,0,0,82,1
1234567890
24,304,240,16,16,16,48,10000,0,0,0,0
24,304,240,16,16,16,64,10000,0,0,0,0
24,304,240,16,16,16,32,10000,0,0,0,0
24,304,240,16,16,16,16,10000,0,0,0,0
25,176,176,80,80,0,0,10002,0,0,0,0
25,176,176,80,80,0,80,10002,0,0,0,0
25,176,176,80,80,0,160,10002,0,0,0,0
25,176,176,80,80,0,240,10002,0,0,0,0
25,176,176,80,80,0,320,10002,0,0,0,0
25,176,176,80,80,80,320,10002,0,0,0,0
25,176,176,80,80,80,240,10002,0,0,0,0
25,176,176,80,80,80,160,10002,0,0,0,0
25,176,176,80,80,80,80,10002,0,0,0,0
25,176,176,80,80,80,0,10002,0,0,0,0
25,176,176,80,80,160,0,10002,0,0,0,0
25,176,176,80,80,160,80,10002,0,0,0,0
25,176,176,80,80,160,160,10002,0,0,0,0
25,176,176,80,80,160,240,10002,0,0,0,0
25,176,176,80,80,160,320,10002,0,0,0,0
25,176,176,80,80,240,320,10002,0,0,0,0
25,176,176,80,80,240,240,10002,0,0,0,0
25,176,176,80,80,240,160,10002,0,0,0,0
25,176,176,80,80,240,80,10002,0,0,0,0
25,176,176,80,80,240,0,10002,0,0,0,0
25,176,176,80,80,320,0,10002,0,0,0,0
25,176,176,80,80,320,80,10002,0,0,0,0
25,176,176,80,80,320,160,10002,0,0,0,0
25,176,176,80,80,320,240,10002,0,0,0,0
25,176,176,80,80,320,320,10002,0,0,0,0
25,176,176,80,80,400,320,10002,0,0,0,0
25,176,176,80,80,400,240,10002,0,0,0,0
25,176,176,80,80,400,160,10002,0,0,0,0
25,176,176,80,80,400,80,10002,0,0,0,0
25,176,176,80,80,400,0,10002,0,0,0,0
25,176,176,80,80,480,0,10002,0,0,0,0
25,176,176,80,80,480,80,10002,0,0,0,0
25,176,176,80,80,480,160,10002,0,0,0,0
25,176,176,80,80,480,240,10002,0,0,0,0
25,176,176,80,80,480,320,10002,0,0,0,0
25,176,176,80,80,560,0,10002,0,0,0,0
25,176,176,80,80,560,80,10002,0,0,0,0
25,176,176,80,80,560,160,10002,0,0,0,0
25,176,176,80,80,560,240,10002,0,0,0,0
25,176,176,80,80,560,320,10002,0,0,0,0
987654321
Rw==
Ewc+BwEuRCElKWxdJ0pfPg==

