UVx6TlN0AGU9Z2FBIVIfYwR4N1RBDCkQQDUjVA59PFliZml8NTgheng=
160,203,273,0,0,16777215,0,0,0,1,41,0
123,257,91,0,128,0,0,0,0,1,38,0
195,259,38,0,0,128,269,0,53,1,37,0
197,256,142,0,2,0,0,0,0,1,39,0
174,109,152,0,1,0,38,0,0,0,32,1
154,104,92,0,1,2,32,32,1,1,35,1
158,109,276,0,0,16777215,0,1,0,1,40,0
157,74,291,0,32,32,0,0,0,1,49,0
157,105,291,0,32,32,0,0,0,1,2,0
157,74,259,0,32,32,0,0,0,1,3,0
157,74,228,0,32,32,0,0,0,1,4,0
157,105,228,0,32,32,0,0,0,1,5,0
157,137,291,0,32,32,0,0,0,1,6,0
157,169,291,0,32,32,0,0,0,1,7,0
157,201,291,0,32,32,0,0,0,1,8,0
157,137,228,0,32,32,0,0,0,1,9,0
157,168,228,0,32,32,0,0,0,1,10,0
157,168,208,0,32,32,0,0,0,1,11,0
157,232,184,0,32,32,0,0,0,1,12,0
157,241,241,0,32,32,0,0,0,1,13,0
157,215,290,0,32,32,0,0,0,1,14,0
157,240,289,0,32,32,0,0,0,1,15,0
157,241,270,0,32,32,0,0,0,1,16,0
157,272,198,0,32,32,0,0,0,1,17,0
157,273,229,0,32,32,0,0,0,1,18,0
157,274,156,0,32,32,0,0,0,1,19,0
157,243,156,0,32,32,0,0,0,1,20,0
157,273,176,0,32,32,0,0,0,1,21,0
157,168,168,0,32,32,0,0,0,1,22,0
157,136,167,0,32,32,0,0,0,1,23,0
157,105,167,0,32,32,0,0,0,1,24,0
157,74,167,0,32,32,0,0,0,1,25,0
157,72,136,0,32,32,0,0,0,1,26,0
157,72,104,0,32,32,0,0,0,1,27,0
157,72,73,0,32,32,0,0,0,1,28,0
157,137,76,0,32,32,0,0,0,1,30,0
157,136,104,0,32,32,0,0,0,1,31,0
157,256,184,0,32,32,0,0,0,1,51,0
157,72,40,0,32,32,0,0,0,1,55,0
157,104,40,0,32,32,0,0,0,1,56,0
157,128,40,0,32,32,0,0,0,1,57,0
157,160,40,0,32,32,0,0,0,1,58,0
157,192,40,0,32,32,0,0,0,1,59,0
157,224,40,0,32,32,0,0,0,1,60,0
157,256,16,0,32,32,0,0,0,1,61,0
157,304,40,0,32,32,0,0,0,1,62,0
157,304,72,0,32,32,0,0,0,1,63,0
157,304,104,0,32,32,0,0,0,1,64,0
157,304,136,0,32,32,0,0,0,1,65,0
157,288,16,0,32,32,0,0,0,1,66,0
157,304,168,0,32,32,0,0,0,1,67,0
157,304,200,0,32,32,0,0,0,1,68,0
157,304,232,0,32,32,0,0,0,1,69,0
157,72,64,0,32,32,0,0,0,1,70,0
157,72,168,0,32,32,0,0,0,1,71,0
157,272,256,0,32,32,0,0,0,1,72,0
157,272,288,0,32,32,0,0,0,1,73,0
157,304,288,0,32,32,0,0,0,1,74,0
157,304,256,0,32,32,0,0,0,1,75,0
157,72,200,0,32,32,0,0,0,1,76,0
155,104,72,0,1,1,0,0,0,1,33,0
155,104,144,0,2,1,0,0,0,0,34,0
166,200,136,0,0,0,0,0,0,0,53,1
1234567890
25,176,176,80,80,224,32,10002,0,0,0,0
25,176,176,80,80,208,112,10002,0,0,0,0
25,176,176,80,80,128,112,10002,0,0,0,0
25,176,176,80,80,144,32,10002,0,0,0,0
25,176,176,80,80,64,32,10002,0,0,0,0
25,176,176,80,80,240,192,10002,0,0,0,0
25,176,176,32,32,96,112,10002,0,0,0,0
25,176,176,32,32,96,144,10002,0,0,0,0
25,176,176,16,48,80,112,10002,0,0,0,0
25,176,176,16,48,192,192,10002,0,0,0,0
25,176,176,16,48,160,240,10002,0,0,0,0
25,176,176,16,48,176,192,10002,0,0,0,0
25,176,176,16,48,208,192,10002,0,0,0,0
25,176,176,16,48,224,192,10002,0,0,0,0
25,176,176,16,48,144,192,10002,0,0,0,0
25,176,176,16,48,128,192,10002,0,0,0,0
25,176,176,16,48,128,240,10002,0,0,0,0
25,176,176,16,48,144,240,10002,0,0,0,0
25,176,176,16,48,96,240,10002,0,0,0,0
25,176,176,16,48,80,240,10002,0,0,0,0
25,176,176,16,48,112,240,10002,0,0,0,0
25,176,176,16,48,96,176,10002,0,0,0,0
25,176,176,16,48,112,176,10002,0,0,0,0
25,176,176,16,48,64,176,10002,0,0,0,0
25,176,176,16,48,80,176,10002,0,0,0,0
25,176,176,16,48,48,176,10002,0,0,0,0
24,112,160,16,32,96,192,10000,0,0,0,0
24,112,160,16,32,128,192,10000,0,0,0,0
24,112,192,16,32,80,80,10000,0,0,0,0
24,112,192,16,32,112,80,10000,0,0,0,0
24,112,192,16,32,112,48,10000,0,0,0,0
24,112,192,16,32,80,48,10000,0,0,0,0
24,112,192,16,32,96,48,10000,0,0,0,0
24,112,192,16,32,96,80,10000,0,0,0,0
987654321
FQclDxNiAA==
Cwc4G1J7AH0=
AQw9EQY=
FA4=

