XlF4TlN0AGU9Z2ZbPUxLL0cpfxRbEiRLG2RkDF8jaBk3PDw8KSU9ZmRjbV9+STsqAHQ=
259,103,144,0,450,200,0,0,0,1,152,0
259,128,80,0,400,200,0,0,0,1,154,0
259,32,256,0,400,40,0,0,0,1,156,0
259,520,272,0,352,800,0,0,0,1,267,0
259,304,256,0,200,100,0,0,0,0,270,0
160,536,280,0,0,16777215,0,0,0,1,3,0
195,440,8,0,0,600,267,0,59,1,109,0
195,320,168,0,0,150,168,0,17,1,7,0
195,608,272,0,0,500,157,0,60,1,61,0
195,608,296,0,0,500,157,0,44,1,51,0
195,360,152,0,0,128,0,0,50,1,45,0
224,272,264,0,128,0,0,0,0,0,93,0
123,496,240,0,128,0,0,0,0,1,67,0
100,512,0,0,800,0,0,233,0,0,48,0
123,16,176,0,128,0,0,0,0,1,27,0
100,192,72,0,500,16777215,0,301,0,1,15,0
123,912,136,0,200,255,0,0,0,0,254,0
197,24,240,0,2,15,0,0,0,1,171,0
197,434,345,0,2,73,0,0,0,1,103,0
174,856,168,0,1,254,0,252,224,0,216,1
174,160,32,0,1,261,0,0,0,0,258,1
174,368,280,0,1,165,0,0,0,0,169,1
205,968,168,0,1,0,0.50,0,0,0,224,0
205,35,240,0,1,0,0.50,0,0,1,23,0
181,920,43,0,0,128,0,0,0,1,223,0
205,272,280,0,1,0,2,0,0,0,88,0
186,552,96,0,32,32,0,0,0,1,62,0
219,536,264,0,64,32,0,0,0,1,73,1
188,280,280,0,0,0,0,0,0,1,99,0
188,552,168,0,0,38,67,119,0,1,47,0
185,328,104,0,0,32,1,0,0,1,5,0
185,200,200,0,0,32,1,0,0,1,4,0
185,16,272,0,0,32,1,0,0,1,256,0
242,520,152,0,32,32,0,0,0,1,35,0
242,584,152,0,32,32,0,0,0,1,36,0
176,384,264,0,146,32,32,0,0,1,148,0
176,384,264,0,93,32,32,0,0,1,96,0
176,592,152,0,48,32,32,0,0,1,37,0
176,592,152,0,0,32,32,0,0,1,142,0
176,589,157,0,154,32,32,0,0,1,161,0
176,594,162,0,152,32,32,0,0,1,162,0
176,373,269,0,88,32,32,0,0,1,145,0
176,368,264,0,0,32,32,0,0,1,164,0
176,296,160,0,270,32,32,0,0,1,273,0
179,160,160,0,0,32,32,0,0,1,132,0
210,592,168,0,0,0,0,0,0,1,31,0
210,304,176,0,31,0,0,0,0,1,30,0
158,160,24,0,1,16777215,0,1,0,1,2,0
216,448,240,0,79,0,0,0,0,0,146,0
216,624,48,0,2,0,0,0,0,1,214,0
216,416,104,0,1,0,0,0,0,1,119,0
157,352,232,0,32,32,0,0,0,1,40,0
157,496,184,0,32,32,0,0,0,1,66,0
157,384,232,0,32,32,0,0,0,1,111,0
157,328,192,0,32,32,0,0,0,1,32,0
157,336,160,0,16,32,0,0,0,1,33,0
157,328,128,0,32,32,0,0,0,1,34,0
157,304,32,0,256,32,0,0,0,1,130,0
157,304,0,0,256,32,0,0,0,1,263,0
157,368,296,0,32,32,0,0,0,1,53,0
157,400,296,0,32,32,0,0,0,1,54,0
157,432,296,0,32,32,0,0,0,1,55,0
157,496,296,0,32,32,0,0,0,1,68,0
157,464,360,0,32,32,0,0,0,1,83,0
157,432,360,0,32,32,0,0,0,1,101,0
157,400,328,0,32,32,0,0,0,1,102,0
157,496,328,0,32,32,0,0,0,1,105,0
157,496,360,0,32,32,0,0,0,1,106,0
157,592,184,0,32,32,0,0,0,1,41,0
157,560,184,0,32,32,0,0,0,1,42,0
157,528,184,0,32,32,0,0,0,1,43,0
157,624,184,0,32,32,0,0,0,1,173,0
157,528,296,0,32,32,0,0,0,1,69,0
157,552,96,0,32,32,0,0,0,1,63,0
157,336,296,0,32,32,0,0,0,1,57,0
157,400,360,0,32,32,0,0,0,1,107,0
157,257,352,0,256,32,0,0,0,1,123,0
157,256,320,0,256,32,0,0,0,1,124,0
157,261,357,0,256,32,0,0,0,1,125,0
157,624,120,0,32,32,0,0,0,1,74,0
157,656,184,0,32,32,0,0,0,1,174,0
157,656,120,0,32,32,0,0,0,1,182,0
157,320,224,0,32,32,0,0,0,1,58,0
157,328,40,0,16,64,0,0,0,1,71,0
157,304,192,0,32,32,0,0,0,1,29,0
157,304,296,0,32,32,0,0,0,1,82,0
157,272,192,0,32,32,0,0,0,1,28,0
157,272,296,0,32,32,0,0,0,1,89,0
157,240,192,0,32,32,0,0,0,1,18,0
157,240,232,0,32,32,0,0,0,1,92,0
157,240,264,0,32,32,0,0,0,1,91,0
157,240,296,0,32,32,0,0,0,1,90,0
157,96,288,0,256,32,0,0,0,1,122,0
157,88,320,0,256,32,0,0,0,1,121,0
157,85,357,0,256,32,0,0,0,1,127,0
157,80,352,0,256,32,0,0,0,1,126,0
157,160,192,0,32,32,0,0,0,1,14,0
157,16,0,0,256,32,0,0,0,1,264,0
157,128,224,0,32,32,0,0,0,1,20,0
157,16,32,0,256,32,0,0,0,1,128,0
157,128,192,0,32,32,0,0,0,1,19,0
157,0,16,0,256,32,0,0,0,1,129,0
157,96,256,0,32,32,0,0,0,1,21,0
157,64,256,0,32,32,0,0,0,1,22,0
157,32,256,0,32,32,0,0,0,1,24,0
157,800,56,0,200,32,0,0,0,1,202,0
157,896,72,0,32,32,0,0,0,1,192,0
157,928,72,0,32,32,0,0,0,1,193,0
157,960,72,0,32,32,0,0,0,1,219,0
172,448,280,0,0,0,0,0,0,1,165,1
169,656,136,0,1,0,0,0,0,0,225,1
169,672,136,0,1,0,0,0,0,0,227,1
169,688,136,0,1,0,0,0,0,0,229,1
169,704,136,0,1,0,0,0,0,0,231,1
169,720,136,0,1,0,0,0,0,0,233,1
169,736,136,0,1,0,0,0,0,0,235,1
169,752,136,0,1,0,0,0,0,0,242,1
172,144,32,0,0,0,0,0,0,1,261,1
166,8,160,0,0,0,0,0,0,0,17,1
166,344,216,0,0,0,0,0,0,0,44,1
166,344,152,0,0,0,0,0,0,0,50,1
166,360,264,0,0,0,0,0,0,0,59,1
166,408,240,0,0,0,0,0,0,0,60,1
166,584,264,0,0,0,181,0,0,0,64,1
255,472,168,0,128,128,1,0,0,0,38,0
157,685,120,0,32,32,0,0,0,1,238,0
157,688,88,0,32,32,0,0,0,1,183,0
157,688,184,0,32,32,0,0,0,1,175,0
157,688,56,0,32,32,0,0,0,1,197,0
157,688,24,0,32,32,0,0,0,1,198,0
157,688,0,0,32,32,0,0,0,1,199,0
157,776,208,0,200,32,0,0,0,1,205,0
157,776,240,0,200,32,0,0,0,1,206,0
157,776,272,0,200,32,0,0,0,1,207,0
157,776,304,0,200,32,0,0,0,1,208,0
157,776,336,0,200,32,0,0,0,1,209,0
157,776,360,0,200,32,0,0,0,1,210,0
157,704,184,0,32,32,0,0,0,1,176,0
157,704,88,0,32,32,0,0,0,1,184,0
157,792,24,0,200,32,0,0,0,1,203,0
157,792,0,0,200,32,0,0,0,1,204,0
157,712,120,0,32,32,0,0,0,1,239,0
157,736,184,0,32,32,0,0,0,1,177,0
157,736,88,0,32,32,0,0,0,1,185,0
157,744,120,0,32,32,0,0,0,1,240,0
157,768,88,0,32,32,0,0,0,1,186,0
157,768,184,0,32,32,0,0,0,1,178,0
157,776,120,0,32,32,0,0,0,1,241,0
157,800,184,0,32,32,0,0,0,1,179,0
157,800,88,0,32,32,0,0,0,1,187,0
157,832,184,0,32,32,0,0,0,1,180,0
157,832,88,0,32,32,0,0,0,1,188,0
157,864,184,0,32,32,0,0,0,1,181,0
157,864,72,0,32,32,0,0,0,1,189,0
157,896,184,0,32,32,0,0,0,1,195,0
157,928,184,0,32,32,0,0,0,1,194,0
157,960,184,0,32,32,0,0,0,1,220,0
157,992,184,0,32,32,0,0,0,1,221,0
157,992,72,0,32,32,0,0,0,1,222,0
176,712,152,0,225,32,32,0,0,1,244,0
176,728,152,0,227,32,32,0,0,1,245,0
176,744,152,0,229,32,32,0,0,1,246,0
176,760,152,0,231,32,32,0,0,1,247,0
176,776,152,0,233,32,32,0,0,1,248,0
176,792,152,0,235,32,32,0,0,1,249,0
176,824,152,0,242,32,32,0,0,1,250,0
216,736,48,0,2,0,0,0,0,1,212,0
216,927,128,0,80,0,0,0,0,0,252,0
1234567890
24,192,16,64,64,112,240,10000,0,0,0,0
24,192,48,64,32,-16,240,10000,0,0,0,0
24,192,48,64,32,48,240,10000,0,0,0,0
24,192,48,64,32,112,176,10000,0,0,0,0
24,192,48,64,32,224,176,10000,0,0,0,0
24,192,48,64,32,320,176,10000,0,0,0,0
24,0,320,64,32,48,208,10000,0,0,0,0
24,432,48,32,16,624,144,10000,0,0,0,0
24,320,32,32,16,448,256,10000,0,0,0,0
24,112,160,16,32,176,240,10000,0,0,0,0
24,112,256,48,32,176,160,10000,0,0,0,0
25,272,0,224,352,336,0,10002,0,0,0,0
25,272,0,224,352,560,0,10002,0,0,0,0
25,272,0,224,352,784,0,10002,0,0,0,0
25,0,0,144,96,192,0,10002,0,0,0,0
25,0,0,144,96,192,96,10002,0,0,0,0
25,0,0,144,96,0,48,10002,0,0,0,0
25,0,0,144,96,0,144,10002,0,0,0,0
25,0,0,144,96,0,240,10002,0,0,0,0
25,0,0,144,96,0,336,10002,0,0,0,0
25,0,0,144,96,192,192,10002,0,0,0,0
25,0,0,144,96,192,288,10002,0,0,0,0
25,208,160,48,96,144,0,10002,0,0,0,0
25,208,160,48,96,144,96,10002,0,0,0,0
25,208,160,48,96,144,192,10002,0,0,0,0
25,208,160,48,96,144,288,10002,0,0,0,0
25,32,176,144,48,0,0,10002,0,0,0,0
25,272,176,224,16,336,352,10002,0,0,0,0
25,272,176,224,16,560,352,10002,0,0,0,0
25,272,176,224,16,784,352,10002,0,0,0,0
987654321
NQkkBg8vXix2OC1HIAtMekIlaUxbG28dRjooRwFuM0ptdWZvOisuaXdsflBtRig=

