XlF4TlV0AGU9Z31PPUReaAUraRRHEj9UHGl2C1sjf1liZml8NTghenh/cUNi
160,704,320,0,0,16777215,0,0,0,1,32,0
195,600,96,0,0,268,255,0,9,1,13,0
195,344,88,0,0,268,255,0,0,1,12,0
195,501,101,0,0,268,255,0,0,1,14,0
195,208,64,0,0,268,255,0,0,1,11,0
195,288,368,0,0,132,334,0,0,1,36,0
195,344,368,0,0,132,334,0,0,1,35,0
195,242,378,0,0,132,334,0,0,1,37,0
195,285.50,480,0,48,132,334,0,0,1,33,0
195,192,368,0,0,132,334,0,0,1,34,0
218,9,359,0,692,0,0,339,0,1,39,0
197,592,472,0,10,0,0,0,0,1,38,0
197,168,472,0,3,0,0,0,0,1,82,0
174,608,328,0,1,21,0,0,0,0,88,1
174,912,528,0,1,94,0,0,0,0,104,1
189,279,160,0,19,176,222,0,0,1,15,0
205,607.50,328,0,1,0,0.50,0,0,1,9,0
189,290.50,480,0,48,128,35,0,0,1,50,0
186,808,232,0,32,32,0,0,0,1,96,0
188,648,328,0,0,28,0,0,0,1,54,0
175,769,263,0,94,248,0,0,0,0,120,0
154,212,160,0,1,1,32,32,-1,1,19,1
154,246,544,0,2,0.50,32,32,1,1,43,1
154,286,480,0,3,0.50,32,32,-1,1,48,1
154,141.10,393.89,0,5,0.50,32,32,1,1,170,1
210,800,160,0,110,180,0,0,0,1,113,0
210,816,160,0,111,180,0,0,0,1,114,0
210,816,504,0,114,0,0,0,0,1,111,0
210,800,504,0,113,0,0,0,0,1,110,0
158,16,328,0,0,16777215,0,1,0,1,10,0
290,728,344,0,32,32,1,0,0,1,27,0
157,400,208,0,32,32,0,0,0,1,5,0
157,544,200,0,32,32,0,0,0,1,6,0
157,632,88,0,32,216,0,0,0,1,7,0
157,320,344,0,656,32,0,0,0,1,8,0
157,632,280,0,32,32,0,0,0,1,23,0
157,632,248,0,32,32,0,0,0,1,24,0
157,632,216,0,32,32,0,0,0,1,25,0
157,608,344,0,32,32,0,0,0,1,26,0
157,664,344,0,32,32,0,0,0,1,63,0
157,720,232,0,144,32,0,0,0,1,72,0
157,840,208,0,32,88,0,0,0,1,102,0
157,752,144,0,208,32,0,0,0,1,112,0
157,800,344,0,112,32,0,0,0,1,123,0
157,264,208,0,32,32,0,0,0,1,4,0
157,104,208,0,32,32,0,0,0,1,3,0
157,176,488,0,32,32,0,0,0,1,79,0
157,688,488,0,208,32,1,0,0,1,90,0
157,616,544,0,96,32,0,0,0,1,30,0
157,704,544,0,80,32,0,0,0,1,31,0
157,904,544,0,32,32,0,0,0,1,103,0
155,40,160,0,1,1,0,0,0,1,17,0
155,624,160,0,2,1,0,0,0,1,18,0
169,624,296,0,0,0,0,0,0,1,21,1
172,680,328,0,0,0,0,0,0,1,28,1
155,160,544,0,1,2,0,0,0,1,41,0
155,552,544,0,2,2,0,0,0,1,42,0
155,200,480,0,1,3,0,0,0,1,46,0
155,552,480,0,2,3,0,0,0,1,47,0
172,792,232,0,0,0,0,0,0,1,94,1
155,64,432,0,1,5,0,0,0,1,168,0
155,151,389,0,2,5,0,0,0,1,169,0
166,24,360,0,0,0,273,0,0,1,129,1
166,72,368,0,0,0,243,0,0,1,130,1
166,0,392,0,0,0,307,0,0,1,131,1
166,0,400,0,0,0,352,0,0,0,132,1
166,0,408,0,0,0,352,0,0,0,133,1
166,0,416,0,0,0,352,0,0,0,134,1
166,0,424,0,0,0,352,0,0,0,135,1
166,0,432,0,0,0,352,0,0,0,136,1
166,0,440,0,0,0,352,0,0,0,137,1
166,0,448,0,0,0,312,0,0,0,138,1
166,0,456,0,0,0,352,0,0,0,139,1
166,0,472,0,0,0,352,0,0,0,142,1
166,0,464,0,0,0,352,0,0,0,143,1
166,0,480,0,0,0,90,0,0,0,144,1
166,0,491,0,0,0,352,0,0,0,146,1
166,0,496,0,0,0,352,0,0,0,147,1
166,0,512,0,0,0,352,0,0,0,151,1
166,0,520,0,0,0,352,0,0,0,152,1
166,16,360,0,0,0,330,0,0,1,153,1
166,48,360,0,0,0,271,0,0,1,154,1
166,0,504,0,0,0,352,0,0,0,155,1
166,0,555,0,0,0,39,0,0,1,157,1
237,320,0,0,16744703,241,0,0,0,1,2,0
1234567890
25,0,0,624,352,-16,-16,10002,0,0,0,0
25,0,256,624,96,-16,352,10002,0,0,0,0
25,0,336,496,16,0,544,10002,0,0,0,0
25,0,336,496,16,0,528,10002,0,0,0,0
25,0,336,496,16,0,512,10002,0,0,0,0
25,0,336,496,16,0,496,10002,0,0,0,0
25,0,336,496,16,0,480,10002,0,0,0,0
25,0,336,496,16,0,464,10002,0,0,0,0
25,0,336,496,16,0,448,10002,0,0,0,0
25,0,336,496,16,496,448,10002,0,0,0,0
25,0,336,496,16,496,464,10002,0,0,0,0
25,0,336,496,16,496,480,10002,0,0,0,0
25,0,336,496,16,496,496,10002,0,0,0,0
25,0,336,496,16,496,512,10002,0,0,0,0
25,0,336,496,16,496,528,10002,0,0,0,0
25,0,336,496,16,496,544,10002,0,0,0,0
25,0,336,496,16,608,432,10002,0,0,0,0
25,0,336,496,16,608,416,10002,0,0,0,0
25,0,336,496,16,608,400,10002,0,0,0,0
25,0,336,496,16,608,384,10002,0,0,0,0
25,0,336,496,16,608,368,10002,0,0,0,0
25,0,336,496,16,608,352,10002,0,0,0,0
25,0,336,496,16,608,304,10002,0,0,0,0
25,0,336,496,16,608,320,10002,0,0,0,0
25,0,336,496,16,624,336,10002,0,0,0,0
25,0,0,624,64,608,240,10002,0,0,0,0
25,0,0,624,64,608,176,10002,0,0,0,0
25,0,0,624,64,608,16,10002,0,0,0,0
25,0,0,624,64,608,80,10002,0,0,0,0
25,256,96,320,32,608,144,10002,0,0,0,0
25,0,0,624,16,608,0,10002,0,0,0,0
987654321
LyFq
Ij4PMDkNfgw=
LkgLL0AMdR4=
MydqNigLY2lDDkx8c2ZoexVtOhkP

