Vl16Vkx7CXspcyFvN19PP0Y8N1ZHCDVOSyknVA59PFliZml8NTgh
160,40,936,0,1,16777215,0,0,0,1,695,0
178,431,311,0,16,16,0,0,0,0,758,0
100,340,120,0,256,0,220,0,220,1,229,0
100,329,220,0,256,0,168,0,168,1,173,0
123,432,360,0,80,255,0,0,0,0,505,0
100,558,752,0,396,0,972,0,972,0,976,0
100,739,752,0,376,0,1012,0,1012,0,1013,0
100,384,752,0,372,0,954,0,954,0,902,0
178,584,736,0,16,16,0,0,0,0,887,0
178,776,736,0,16,16,0,0,0,0,891,0
178,393,735,0,16,16,0,0,0,0,883,0
174,8,320,0,0,230,0,0,0,0,178,1
174,8,351,0,0,169,216,0,0,0,230,1
174,8,288,0,0,113,112,110,111,0,127,0
174,24,288,0,0,114,115,116,117,0,128,0
174,40,288,0,0,82,71,130,131,0,129,0
174,56,288,0,0,80,50,62,61,0,130,0
174,72,288,0,0,101,91,92,81,0,131,0
174,88,288,0,0,140,149,174,0,0,158,0
174,136,496,0,0,525,526,524,527,0,543,1
174,168,496,0,0,509,531,173,229,0,545,1
174,135,520,0,0,498,501,502,503,0,593,1
174,56,624,0,0,804,805,806,803,0,816,1
174,56,576,0,0,804,805,806,803,0,814,1
174,152,496,0,0,523,528,530,522,0,544,1
174,56,600,0,0,804,805,806,803,0,815,1
174,56,552,0,0,804,805,806,803,0,813,1
174,64,512,0,0,809,810,811,812,0,808,1
174,48,512,0,0,825,808,611,0,0,807,1
174,200,496,0,0,169,170,0,0,0,584,1
174,1160,472,0,1,856,697,698,0,0,847,0
174,176,464,0,0,543,544,545,584,0,542,0
174,184,496,0,0,532,565,555,807,0,556,1
174,673,647,0,0,770,771,794,785,0,837,1
174,689,648,0,0,721,720,719,722,0,846,1
174,656,647,0,0,283,769,768,767,0,836,1
174,168,840,0,0,857,870,0,0,0,871,1
174,152,840,0,0,871,858,859,860,0,856,0
174,638,647,0,0,836,837,846,1022,0,835,1
174,272,880,0,0,985,899,900,952,0,897,1
174,288,881,0,0,883,0,880,0,0,898,1
174,304,880,0,0,887,0,885,0,0,899,1
174,275,915,0,0,898,967,976,1011,0,985,0
174,290,915,0,0,1005,1013,0,0,0,1011,0
174,244,865,0,0,897,0,0,0,0,896,1
174,320,880,0,0,891,0,889,0,0,900,1
174,336,880,0,0,902,0,903,0,0,952,1
174,136,576,0,0,723,616,617,614,0,612,1
174,152,576,0,0,613,0,0,615,0,723,1
174,168,576,0,0,483,480,834,0,0,740,1
193,82,176,0,1,127,128,129,158,1,126,0
181,386,120,0,218,128,0,0,0,1,220,0
181,552,752,0,969,220,0,0,0,1,972,0
181,688,752,0,1007,220,0,0,0,1,1012,0
181,416,752,0,905,220,0,0,0,1,954,0
181,329,220,0,171,176,0,0,0,1,168,0
220,552,720,0,576,16,0,0,0,0,283,0
220,248,736,0,32,16,0,0,0,0,857,0
220,216,752,0,32,16,0,0,0,0,858,0
220,184,768,0,32,16,0,0,0,0,859,0
220,152,784,0,32,16,0,0,0,0,860,0
220,1000,400,0,48,16,0,0,0,0,770,0
220,1160,400,0,48,16,0,0,0,0,771,0
220,1144,440,0,16,64,0,0,0,0,794,0
220,1152,480,0,32,16,0,0,0,0,785,0
220,888,640,0,48,16,0,0,0,0,769,0
220,1000,560,0,48,16,0,0,0,0,768,0
220,888,480,0,48,16,0,0,0,0,767,0
176,536,384,0,392,32,176,0,0,1,477,0
176,536,384,0,261,32,176,0,0,1,478,0
176,536,384,0,394,32,176,0,0,1,476,0
176,536,384,0,312,32,176,0,0,1,350,0
176,492,376,0,497,32,160,0,0,1,506,0
176,488,376,0,505,32,160,0,0,1,507,0
176,484,376,0,542,32,160,0,0,1,508,0
176,472,208,0,392,32,144,0,0,1,398,0
176,472,208,0,394,32,144,0,0,1,399,0
175,96,200,0,46,30,0,0,0,0,50,0
175,112,200,0,45,29,0,0,0,0,61,0
175,112,216,0,46,59,0,0,0,0,62,0
175,96,232,0,47,60,0,0,0,0,71,0
175,112,232,0,47,89,0,0,0,0,80,0
175,135,200,0,48,90,0,0,0,0,81,0
175,152,200,0,48,119,0,0,0,0,82,0
175,136,216,0,49,120,0,0,0,0,91,0
175,152,216,0,49,149,0,0,0,0,92,0
175,136,232,0,52,150,0,0,0,0,101,0
175,32,224,0,25,150,0,0,0,0,110,0
175,40,216,0,13,150,0,0,0,0,111,0
175,32,240,0,29,150,0,0,0,0,112,0
175,40,248,0,33,150,0,0,0,0,113,0
175,56,248,0,41,150,0,0,0,0,114,0
175,64,240,0,37,150,0,0,0,0,115,0
175,64,224,0,21,150,0,0,0,0,116,0
175,58,216,0,17,150,0,0,0,0,117,0
175,96,215,0,45,1,0,0,0,0,140,0
175,152,232,0,52,179,0,0,0,0,149,0
175,48,120,0,178,150,0,0,0,0,174,0
175,256,448,0,495,240,0,0,0,0,509,0
175,272,464,0,521,240,0,0,0,0,522,0
175,288,448,0,520,120,0,0,0,0,523,0
175,304,448,0,519,60,0,0,0,0,524,0
175,320,448,0,518,1,0,0,0,0,525,0
175,320,464,0,518,60,0,0,0,0,526,0
175,304,464,0,519,120,0,0,0,0,527,0
175,288,464,0,520,180,0,0,0,0,528,0
175,272,448,0,521,180,0,0,0,0,530,0
175,256,464,0,556,240,0,0,0,0,531,0
175,280,488,0,495,500,0,0,0,0,532,0
175,248,488,0,593,560,0,0,0,0,555,0
175,264,488,0,505,530,0,0,0,0,565,0
175,112,552,0,612,600,0,0,0,0,611,0
175,183,537,0,719,60,0,0,0,0,613,0
175,242,536,0,720,60,0,0,0,0,614,0
175,264,536,0,740,90,0,0,0,0,615,0
175,203,536,0,722,60,0,0,0,0,616,0
175,224,536,0,721,60,0,0,0,0,617,0
175,32,544,0,813,560,0,0,0,0,809,0
175,32,568,0,814,590,0,0,0,0,810,0
175,32,592,0,815,600,0,0,0,0,811,0
175,31,615,0,816,630,0,0,0,0,812,0
175,32,520,0,749,555,0,0,0,0,825,0
175,275,818,0,896,30,0,0,0,0,1022,0
154,64,56,0,1,0.50,48,16,1,1,15,1
154,160,56,0,2,0.50,48,16,1,1,19,1
154,176,80,0,3,0.50,16,32,1,1,23,1
154,48,80,0,4,0.50,16,32,1,1,27,1
154,48,160,0,5,0.50,16,32,1,1,31,1
154,64,184,0,6,0.50,48,16,1,1,35,1
154,176,160,0,7,0.50,16,32,1,1,39,1
154,160,184,0,8,0.50,48,16,1,1,43,1
154,329,220,0,9,0.50,16,16,-1,1,171,1
154,340,120,0,10,0.50,16,16,-1,1,218,1
154,416,272,0,12,0.50,16,16,-1,1,261,0
154,579,272,0,11,0.50,16,16,-1,1,396,1
154,400,400,1,13,1,16,16,-1,1,499,1
154,384,752,1,14,0.75,16,16,-1,1,905,0
154,558,752,1,16,0.75,16,16,-1,1,969,0
154,739,752,1,17,0.75,16,16,-1,1,1007,0
210,248,752,0,0,270,0,0,0,1,922,0
210,832,752,0,922,90,0,0,0,1,923,0
158,72,176,0,1,16777215,0,1,0,1,12,0
216,568,374,0,6,0,0,0,0,0,803,0
216,432,360,0,21,0,0,0,0,0,749,0
216,408,376,0,53,0,0,0,0,0,518,0
216,408,376,0,50,0,0,0,0,0,521,0
216,408,376,0,52,0,0,0,0,0,519,0
216,408,376,0,51,0,0,0,0,0,520,0
216,296,374,0,7,0,0,0,0,0,804,0
216,120,112,0,51,0,0,0,0,0,49,0
216,120,112,0,50,0,0,0,0,0,52,0
216,120,112,0,53,0,0,0,0,0,47,0
216,120,112,0,54,0,0,0,0,0,46,0
216,120,111,0,55,0,0,0,0,0,45,0
216,120,112,0,52,0,0,0,0,0,48,0
157,40,944,0,64,16,0,0,0,1,694,0
155,64,56,0,1,1,0,0,0,0,13,0
155,272,56,0,2,1,2,0,0,1,14,0
155,160,56,0,1,2,0,0,0,0,17,0
155,368,56,0,2,2,2,0,0,1,18,0
155,176,80,0,1,3,0,0,0,0,21,0
155,384,80,0,2,3,1,0,0,1,22,0
155,48,80,0,1,4,0,0,0,0,25,0
155,256,80,0,2,4,1,0,0,1,26,0
155,48,160,0,1,5,0,0,0,0,29,0
155,256,160,0,2,5,2,0,0,1,30,0
155,64,184,0,1,6,0,0,0,0,33,0
155,272,184,0,2,6,1,0,0,1,34,0
155,176,160,0,1,7,0,0,0,0,37,0
155,384,160,0,2,7,2,0,0,1,38,0
155,160,184,0,1,8,0,0,0,0,41,0
155,368,184,0,2,8,1,0,0,1,42,0
155,329,220,0,1,9,0,0,0,0,169,0
155,329,107,0,2,9,60,0,0,1,170,0
155,272,144,0,3,1,0,0,0,1,187,0
155,256,168,0,3,4,1,0,0,1,188,0
155,368,144,0,3,2,0,0,0,1,189,0
155,384,168,0,3,3,1,0,0,1,190,0
155,384,248,0,3,7,0,0,0,1,191,0
155,368,272,0,3,8,1,0,0,1,193,0
155,256,248,0,3,5,0,0,0,1,194,0
155,272,272,0,3,6,1,0,0,1,195,0
155,340,120,0,1,10,0,0,0,0,216,0
155,305,120,0,2,10,0,0,0,1,217,0
155,416,272,0,1,12,0,0,0,0,259,0
155,416,144,0,2,12,0,0,0,1,260,0
155,560,272,0,4,8,0,0,0,1,279,0
155,400,272,0,4,6,0,0,0,1,280,0
155,384,248,0,4,5,0,0,0,1,281,0
155,576,248,0,4,7,0,0,0,1,282,0
155,576,168,0,4,3,0,0,0,1,284,0
155,384,168,0,4,4,0,0,0,1,285,0
155,400,144,0,4,1,0,0,0,1,286,0
155,560,144,0,4,2,0,0,0,1,287,0
155,448,248,0,5,5,0,0,0,1,321,0
155,672,272,0,5,8,0,0,0,1,370,0
155,464,272,0,5,6,0,0,0,1,371,0
155,464,144,0,5,1,0,0,0,1,374,0
155,448,168,0,5,4,0,0,0,1,383,0
155,579,272,0,1,11,0,0,0,0,394,0
155,579,144,0,2,11,0,0,0,1,395,0
155,672,144,0,5,2,1,0,0,1,408,0
155,688,168,0,5,3,0,0,0,1,409,0
155,576,144,0,6,1,1,0,0,1,410,0
155,560,168,0,6,4,0,0,0,1,411,0
155,560,248,0,6,5,1,0,0,1,413,0
155,688,248,0,5,7,1,0,0,1,424,0
155,576,272,0,6,6,0,0,0,1,433,0
155,576,421,0,7,6,1,0,0,1,442,0
155,672,421,0,6,8,1,0,0,1,443,0
155,688,397,0,6,7,0,0,0,1,444,0
155,689,317,0,6,3,0,0,0,1,445,0
155,672,293,0,6,2,1,0,0,1,446,0
155,576,293,0,7,1,0,0,0,1,447,0
155,560,317,0,7,4,0,0,0,1,448,0
155,560,397,0,7,5,0,0,0,1,449,0
155,232,120,0,3,10,0,0,0,1,467,0
155,496,397,0,7,7,5,0,0,0,479,0
155,480,421,0,7,8,5,0,0,0,480,0
155,496,317,0,7,3,0,0,0,0,481,0
155,480,293,0,7,2,5,0,0,0,482,0
155,384,421,0,8,6,5,0,0,0,483,0
155,368,397,0,8,5,5,0,0,0,484,0
155,384,293,0,8,1,5,0,0,0,485,0
155,368,317,0,8,4,5,0,0,0,486,0
155,400,400,0,1,13,0,0,0,0,497,0
155,464,400,0,2,13,0,0,0,1,498,0
155,488,360,0,3,13,0,0,0,1,501,0
155,464,320,0,4,13,0,0,0,1,502,0
155,400,320,0,5,13,0,0,0,1,503,0
155,384,360,0,6,13,0,0,0,1,504,0
155,352,421,0,9,6,5,0,0,0,715,0
155,512,421,0,8,8,5,0,0,0,716,0
155,384,752,0,1,14,0,0,0,0,903,0
155,825,752,0,2,14,0,0,0,1,904,0
155,272,752,0,3,14,0,0,0,1,934,0
155,558,752,0,1,16,0,0,0,0,967,0
155,824,752,0,2,16,0,0,0,1,968,0
155,272,752,0,3,16,0,0,0,1,971,0
155,739,752,0,1,17,0,0,0,0,1005,0
155,824,752,0,2,17,0,0,0,1,1006,0
155,272,752,0,3,17,0,0,0,1,1009,0
166,0,992,0,0,0,0,0,0,1,204,1
166,1504,992,0,0,0,90,0,0,1,205,1
166,1504,0,0,0,0,180,0,0,1,206,1
166,552,208,0,0,261,185,0,0,0,312,0
166,472,208,0,0,396,185,0,0,0,392,0
166,431,358,0,0,499,0,0,0,0,495,0
166,0,992,0,0,0,90,0,0,1,602,1
166,65,867,0,0,0,270,0,0,1,697,0
166,80,880,0,0,0,180,0,0,1,698,0
166,520,397,0,0,0,135,0,0,0,719,0
166,343,398,0,0,0,45,0,0,0,720,0
166,336,376,0,0,0,0,0,0,0,721,0
166,528,376,0,0,0,180,0,0,0,722,0
176,328,200,0,217,208,32,0,0,1,458,0
176,328,200,0,312,208,32,0,0,1,331,0
176,328,201,0,259,208,32,0,0,1,322,0
176,328,194,0,169,208,32,0,0,1,351,0
178,680,736,0,16,16,0,0,0,0,889,0
178,488,736,0,16,16,0,0,0,0,885,0
178,296,736,0,16,16,0,0,0,0,880,0
242,424,664,0,320,32,0,0,0,1,861,0
176,424,704,0,835,320,32,0,0,0,834,0
216,1120,376,0,6,0,0,0,0,0,870,0
216,520,437,0,8,0,0,0,0,0,806,0
216,344,437,0,8,0,0,0,0,0,805,0
1234567890
24,224,176,16,16,1488,976,10000,0,0,0,0
24,224,176,16,16,1488,960,10000,0,0,0,0
24,224,176,16,16,1488,944,10000,0,0,0,0
24,224,176,16,16,1488,928,10000,0,0,0,0
24,224,176,16,16,1488,912,10000,0,0,0,0
24,224,176,16,16,1488,896,10000,0,0,0,0
24,224,176,16,16,1488,880,10000,0,0,0,0
24,224,176,16,16,1488,864,10000,0,0,0,0
24,224,176,16,16,1488,848,10000,0,0,0,0
24,224,176,16,16,1488,832,10000,0,0,0,0
24,224,176,16,16,1488,816,10000,0,0,0,0
24,224,176,16,16,1488,800,10000,0,0,0,0
24,224,176,16,16,1488,784,10000,0,0,0,0
24,224,176,16,16,1488,768,10000,0,0,0,0
24,224,176,16,16,1488,736,10000,0,0,0,0
24,224,176,16,16,1488,752,10000,0,0,0,0
24,224,176,16,16,1488,720,10000,0,0,0,0
24,224,176,16,16,1488,704,10000,0,0,0,0
24,224,176,16,16,1488,688,10000,0,0,0,0
24,224,176,16,16,1488,672,10000,0,0,0,0
24,224,176,16,16,1488,656,10000,0,0,0,0
24,224,176,16,16,1488,640,10000,0,0,0,0
24,224,176,16,16,1488,624,10000,0,0,0,0
24,224,176,16,16,1488,608,10000,0,0,0,0
24,224,176,16,16,1488,576,10000,0,0,0,0
24,224,176,16,16,1488,560,10000,0,0,0,0
24,224,176,16,16,1488,544,10000,0,0,0,0
24,224,176,16,16,1488,528,10000,0,0,0,0
24,224,176,16,16,1488,512,10000,0,0,0,0
24,224,176,16,16,1488,496,10000,0,0,0,0
24,224,176,16,16,1488,480,10000,0,0,0,0
24,224,176,16,16,1488,448,10000,0,0,0,0
24,224,176,16,16,1488,464,10000,0,0,0,0
24,224,176,16,16,1488,336,10000,0,0,0,0
24,224,176,16,16,1488,384,10000,0,0,0,0
24,224,176,16,16,1488,432,10000,0,0,0,0
24,224,176,16,16,1488,416,10000,0,0,0,0
24,224,176,16,16,1488,400,10000,0,0,0,0
24,224,176,16,16,1488,368,10000,0,0,0,0
24,224,176,16,16,1488,352,10000,0,0,0,0
24,224,176,16,16,1488,320,10000,0,0,0,0
24,224,176,16,16,1488,288,10000,0,0,0,0
24,224,176,16,16,1488,272,10000,0,0,0,0
24,224,176,16,16,1488,208,10000,0,0,0,0
24,224,176,16,16,1488,160,10000,0,0,0,0
24,224,176,16,16,1488,128,10000,0,0,0,0
24,224,176,16,16,1488,240,10000,0,0,0,0
24,224,176,16,16,1488,256,10000,0,0,0,0
24,224,176,16,16,1488,224,10000,0,0,0,0
24,224,176,16,16,1488,192,10000,0,0,0,0
24,224,176,16,16,1488,176,10000,0,0,0,0
24,224,176,16,16,1488,144,10000,0,0,0,0
24,224,176,16,16,1488,112,10000,0,0,0,0
24,224,176,16,16,1488,96,10000,0,0,0,0
24,224,176,16,16,1488,80,10000,0,0,0,0
24,224,176,16,16,1488,64,10000,0,0,0,0
24,224,176,16,16,1488,48,10000,0,0,0,0
24,224,176,16,16,1488,32,10000,0,0,0,0
24,224,176,16,16,1488,16,10000,0,0,0,0
24,224,176,16,16,1488,0,10000,0,0,0,0
24,224,176,16,16,1488,-16,10000,0,0,0,0
987654321
Rw==

