X1h6TlN0AGU9Z0Z8Hwd+H3cYK3oCTnwSVTU7SBJhIEV+eg==
259,408,344,0,48,16,0,0,0,1,29,0
259,536,344,0,16,16,0,0,0,1,30,0
259,152,344,0,48,16,0,0,0,1,31,0
259,96,160,0,64,64,0,0,0,1,38,0
259,544,256,0,64,64,0,0,0,1,39,0
259,552,8,0,16,16,0,0,0,1,59,0
259,744,224,0,208,416,0,0,0,1,133,0
259,328,352,0,624,32,0,0,0,1,136,0
259,48,336,0,32,32,0,0,0,1,172,0
160,728,336,0,1,128,0,0,0,1,92,0
224,40,304,0,128,0,24,0,0,1,140,0
218,729,321,1,224,128,84,0,0,1,126,0
224,687,232,0,36,128,0,0,0,1,121,0
224,760,192,0,36,128,0,0,0,1,122,0
197,760,200,0,1,117,0,0,0,1,90,0
197,688,248,0,1,118,0,0,0,1,91,0
197,728,160,0,2,116,0,0,0,1,87,0
174,312,264,0,0,163,160,169,0,0,165,1
193,256,336,0,1,160,156,163,0,1,159,1
174,224,256,0,1,164,160,169,0,0,166,1
194,768,329,0,0,128,0,0,0,0,117,0
194,687,328,0,0,128,0,0,0,0,116,0
194,704,56,0,0,128,0,0,0,0,118,0
220,256,320,0,32,32,0,0,0,0,169,1
219,544,255,0,64,64,0,0,0,1,45,1
219,576,272,0,16,16,0,0,0,1,37,1
219,96,160,0,64,64,0,0,0,1,36,1
219,8,152,0,16,16,0,0,0,1,54,1
219,8,216,0,16,16,0,0,0,1,62,1
219,8,104,0,16,16,0,0,0,1,52,1
185,400,360,0,0,16,1,0,0,1,150,0
185,152,360,0,0,16,1,0,0,1,151,0
242,400,352,0,32,32,0,0,0,1,50,0
242,150,353,0,32,32,0,0,0,1,49,0
176,356,298,0,166,32,96,0,0,0,163,0
176,112,288,0,165,32,96,0,0,0,164,0
176,560,0,0,146,32,32,0,0,1,147,0
175,96,160,0,3,8,1,0,0,1,20,0
175,544,256,0,33,8,1,0,0,1,32,0
175,614,270,0,126,85,0,0,0,1,129,0
175,616,272,0,126,84,1,0,0,1,130,0
175,376,208,0,140,60,1,0,0,1,141,0
175,376,208,0,140,66,1,0,0,1,142,0
154,40,304,0,1,1,48,48,1,1,24,1
154,726,95,0,2,0.14,96,32,1,1,84,1
210,8,96,0,60,0,0,0,0,1,56,0
210,8,209,0,73,0,0,0,0,1,64,0
210,8,160,0,0,180,0,0,0,1,63,0
210,550,0,0,0,180,0,0,0,1,60,0
210,8,145,0,63,0,0,0,0,1,55,0
210,728,48,0,0,180,0,0,0,1,73,0
158,256,320,0,1,16777215,0,1,0,1,43,0
216,288,152,0,69,1,0,0,0,0,160,0
216,328,200,0,50,0,0,0,0,1,155,0
216,352,216,0,40,0,0,0,0,0,156,0
216,528,104,0,78,0,0,0,0,0,146,0
216,80,96,0,60,0,0,0,0,1,145,0
157,280,344,0,208,16,0,0,0,1,26,0
157,472,344,0,112,16,0,0,0,1,27,0
157,592,344,0,96,16,0,0,0,1,28,0
157,64,344,0,144,16,0,0,0,1,17,0
157,24,352,0,48,16,0,0,0,1,98,0
157,16,328,0,32,16,0,0,0,1,99,0
157,8,320,0,16,16,0,0,0,1,103,0
157,648,192,0,16,368,0,0,0,1,70,0
157,680,8,0,240,16,0,0,0,1,58,0
157,272,8,0,544,16,0,0,0,1,57,0
157,792,184,0,16,368,0,0,0,1,74,0
155,40,304,0,1,1,100,0,0,1,22,0
155,474,248,0,2,1,25,0,0,1,23,0
155,496,216,0,3,1,19,0,0,1,41,0
155,568,72,0,4,1,0,0,0,1,47,0
155,726,95,0,1,2,0,0,0,0,82,0
155,720,360,0,2,2,0,0,0,1,83,0
155,320,104,0,5,1,0,0,0,1,106,0
155,312,72,0,6,1,0,0,0,1,107,0
155,56,56,0,7,1,0,0,0,1,108,0
155,40,120,0,8,1,0,0,0,1,111,0
166,544,256,0,0,24,180,0,0,1,3,1
166,96,160,0,0,24,0,0,0,1,33,1
166,656,24,0,0,0,0,0,0,1,76,1
166,784,24,0,0,0,270,0,0,1,77,1
166,784,352,0,0,0,180,0,0,1,78,1
166,664,352,0,0,0,90,0,0,1,79,1
196,544,256.50,0,0,0,0,0,0,0,0,0
196,96,161,0,0,0,0,0,0,0,0,0
196,544,256.50,0,0,0,0,0,0,0,0,0
196,96,161,0,0,0,0,0,0,0,0,0
196,544,256.50,0,0,0,0,0,0,0,0,0
196,96,161,0,0,0,0,0,0,0,0,0
196,544,256.50,0,0,0,0,0,0,0,0,0
196,96,161,0,0,0,0,0,0,0,0,0
196,544,256.50,0,0,0,0,0,0,0,0,0
196,96,161,0,0,0,0,0,0,0,0,0
196,544,256.50,0,0,0,0,0,0,0,0,0
196,96,161,0,0,0,0,0,0,0,0,0
196,544,256.50,0,0,0,0,0,0,0,0,0
196,96,161,0,0,0,0,0,0,0,0,0
196,544,256.50,0,0,0,0,0,0,0,0,0
196,96,161,0,0,0,0,0,0,0,0,0
196,544,256.50,0,0,0,0,0,0,0,0,0
196,96,161,0,0,0,0,0,0,0,0,0
216,288,200,0,49,0,0,0,0,1,154,0
157,729,43,0,16,16,0,0,0,1,80,0
176,730,63,0,82,32,32,0,0,1,95,0
123,728,152,0,36,128,0,0,0,1,123,0
1234567890
24,352,304,48,16,576,16,10000,0,0,0,0
25,272,0,64,48,656,16,10002,0,0,0,0
25,272,0,64,48,720,144,10002,0,0,0,0
25,272,0,64,48,656,192,10002,0,0,0,0
25,272,0,64,48,720,240,10002,0,0,0,0
25,272,0,64,48,656,288,10002,0,0,0,0
25,272,0,64,48,720,336,10002,0,0,0,0
25,400,48,64,48,656,144,10002,0,0,0,0
25,400,48,64,48,720,96,10002,0,0,0,0
25,400,48,64,48,720,16,10002,0,0,0,0
25,400,48,64,48,656,64,10002,0,0,0,0
25,400,48,64,48,720,192,10002,0,0,0,0
25,400,48,64,48,656,240,10002,0,0,0,0
25,400,48,64,48,720,288,10002,0,0,0,0
25,400,48,64,48,656,336,10002,0,0,0,0
24,432,320,64,32,480,16,10000,0,0,0,0
24,288,144,32,32,240,288,10000,0,0,0,0
24,96,96,32,32,128,208,10000,0,0,0,0
24,352,128,16,16,368,128,10000,0,0,0,0
24,464,80,32,32,480,80,10000,0,0,0,0
24,464,80,32,32,96,304,10000,0,0,0,0
24,368,224,32,16,32,320,10000,0,0,0,0
24,0,288,32,32,512,288,10000,0,0,0,0
24,432,192,16,16,464,272,10000,0,0,0,0
24,320,16,16,16,480,272,10000,0,0,0,0
24,432,208,16,16,48,192,10000,0,0,0,0
24,352,16,16,16,32,192,10000,0,0,0,0
24,112,160,16,32,0,176,10000,0,0,0,0
24,32,176,16,16,0,128,10000,0,0,0,0
25,256,160,16,80,0,16,10002,0,0,0,0
25,240,256,16,32,0,112,10002,0,0,0,0
25,256,0,16,48,0,160,10002,0,0,0,0
25,240,48,16,48,0,224,10002,0,0,0,0
25,256,160,16,48,0,272,10002,0,0,0,0
987654321
NC0JNlAAECB2Py1aO05fPxQlO1BBDjUCLCV7EVU0LBxyMzwjJWE/diE9YRs6HDd0STxgNw==
EA0rCUArEC1qJXkOJltBNVUoO1lAByRKEGt8WFwkdVU7ajQxbnExOC0kYQM3D3J2
FEhqQjQqWTolLmlHJ0Rfel0/O0xGG3BAHHZjWFs1ZQE9OHkxY2B0JGg0IB0gAGR3QyA0
DkgmCwsnECBxa3tLIVINN0EvcxhdEX4MVyV1AVtxZBQkL3k2cHoxbWE=

