UVx6TlN0AGU9Z0BcGURFO1oienVPEHxyC2xkF1AUfxYzOjx8NTghenh/cUNiVSc2HA==
160,96,320,0,0,-1,0,0,0,1,133,0
100,240,80,0,256,0,0,288,0,1,18,0
218,304,80,0,256,0,0,247,0,1,31,0
123,432,104,0,128,0,0,0,0,1,47,0
100,312,232,0,256,0,0,233,0,1,87,0
100,336,232,0,256,0,0,316,0,1,86,0
174,512,192,0,1,60,77,0,0,0,67,1
174,160,256,0,1,112,0,0,0,0,108,1
205,360.50,192,0,1,0,0.50,0,0,1,37,0
189,328,240,0,0,128,266,0,0,1,88,0
181,104,272,0,0,128,331,0,0,1,156,0
158,240,192,0,0,16777215,0,1,0,1,17,0
157,240,208,0,32,32,0,0,0,1,2,0
157,272,208,0,32,32,0,0,0,1,3,0
157,304,208,0,32,32,0,0,0,1,4,0
157,208,144,0,32,32,0,0,0,1,5,0
157,208,208,0,32,32,0,0,0,1,6,0
157,208,120,0,32,32,0,0,0,1,7,0
157,208,176,0,32,32,0,0,0,1,8,0
157,208,88,0,32,32,0,0,0,1,9,0
157,208,56,0,32,32,0,0,0,1,10,0
157,240,56,0,32,32,0,0,0,1,11,0
157,272,56,0,32,32,0,0,0,1,12,0
157,296,56,0,32,32,0,0,0,1,13,0
157,328,56,0,32,32,0,0,0,1,14,0
157,328,208,0,32,32,0,0,0,1,15,0
157,352,208,0,32,32,0,0,0,1,16,0
157,376,208,0,32,32,0,0,0,1,19,0
157,352,56,0,32,32,0,0,0,1,20,0
157,376,56,0,32,32,0,0,0,1,21,0
157,328,144,0,32,32,0,0,0,1,26,0
157,328,72,0,32,32,0,0,0,1,27,0
157,328,136,0,32,32,0,0,0,1,28,0
157,408,208,0,32,32,0,0,0,1,38,0
157,424,208,0,32,32,0,0,0,1,39,0
157,408,56,0,32,32,0,0,0,1,40,0
157,432,56,0,32,32,0,0,0,1,41,0
157,456,56,0,32,32,0,0,0,1,42,0
157,456,208,0,32,32,0,0,0,1,43,0
157,480,56,0,32,32,0,0,0,1,52,0
157,512,56,0,32,32,0,0,0,1,53,0
157,536,56,0,32,32,0,0,0,1,54,0
157,536,88,0,32,32,0,0,0,1,55,0
157,536,120,0,32,32,0,0,0,1,56,0
157,536,152,0,32,32,0,0,0,1,57,0
157,536,184,0,32,32,0,0,0,1,58,0
157,536,208,0,32,32,0,0,0,1,59,0
157,520,208,0,32,32,0,0,0,1,62,0
157,456,240,0,32,32,0,0,0,1,63,0
157,520,240,0,32,32,0,0,0,1,64,0
157,456,272,0,32,32,0,0,0,1,65,0
157,520,272,0,32,32,0,0,0,1,66,0
157,520,304,0,32,32,0,0,0,1,70,0
157,520,336,0,32,32,0,0,0,1,71,0
157,496,336,0,32,32,0,0,0,1,72,0
157,464,336,0,32,32,0,0,0,1,73,0
157,432,336,0,32,32,0,0,0,1,74,0
157,400,336,0,32,32,0,0,0,1,75,0
157,368,336,0,32,32,0,0,0,1,76,0
157,328,280,0,32,8,0,0,0,1,89,0
157,344,336,0,32,32,0,0,0,1,90,0
157,312,336,0,32,32,0,0,0,1,91,0
157,280,336,0,32,32,0,0,0,1,92,0
157,256,336,0,32,32,0,0,0,1,96,0
157,224,336,0,32,32,0,0,0,1,97,0
157,200,264,0,32,16,0,0,0,1,98,0
157,176,264,0,32,16,0,0,0,1,99,0
157,152,264,0,32,16,0,0,0,1,100,0
157,144,240,0,16,32,0,0,0,1,102,0
157,144,216,0,16,16,0,0,0,1,103,0
157,160,216,0,16,16,0,0,0,1,104,0
157,176,216,0,16,16,0,0,0,1,105,0
157,192,216,0,16,16,0,0,0,1,106,0
157,224,272,0,8,32,0,0,0,1,114,0
157,216,272,0,8,32,0,0,0,1,115,0
157,232,272,0,8,32,0,0,0,1,116,0
157,192,336,0,32,32,0,0,0,1,128,0
157,168,336,0,32,32,0,0,0,1,129,0
157,136,336,0,32,32,0,0,0,1,130,0
157,104,336,0,32,32,0,0,0,1,131,0
157,72,336,0,32,32,0,0,0,1,132,0
157,128,216,0,16,16,0,0,0,1,140,0
157,112,216,0,16,16,0,0,0,1,141,0
157,96,216,0,16,16,0,0,0,1,142,0
157,88,216,0,16,16,0,0,0,1,143,0
157,72,216,0,16,16,0,0,0,1,144,0
157,64,312,0,16,16,0,0,0,1,145,0
157,64,296,0,16,16,0,0,0,1,146,0
157,64,280,0,16,16,0,0,0,1,147,0
157,64,264,0,16,16,0,0,0,1,148,0
157,64,248,0,16,16,0,0,0,1,149,0
157,64,232,0,16,16,0,0,0,1,150,0
157,64,216,0,16,16,0,0,0,1,151,0
169,312,160,0,0,0,0,0,0,1,32,1
172,472,192,0,0,0,0,0,0,1,60,1
169,440,288,0,0,0,0,0,0,1,77,1
169,216,288,0,0,0,0,0,0,1,112,1
1234567890
24,320,192,16,16,224,128,10000,0,0,0,0
24,336,192,16,16,240,128,10000,0,0,0,0
24,320,208,16,16,224,144,10000,0,0,0,0
24,336,208,16,16,240,144,10000,0,0,0,0
25,432,224,16,16,208,64,10002,0,0,0,0
25,432,224,16,16,208,80,10002,0,0,0,0
25,96,48,48,48,272,96,10002,0,0,0,0
25,96,48,48,48,272,144,10002,0,0,0,0
25,96,48,48,48,224,144,10002,0,0,0,0
25,96,48,48,48,320,96,10002,0,0,0,0
25,96,48,48,48,320,144,10002,0,0,0,0
25,96,48,48,48,368,96,10002,0,0,0,0
25,96,48,48,48,368,144,10002,0,0,0,0
25,96,48,48,48,224,96,10002,0,0,0,0
25,96,48,48,48,224,48,10002,0,0,0,0
25,96,48,48,48,272,48,10002,0,0,0,0
25,96,48,48,48,320,48,10002,0,0,0,0
25,96,48,48,48,368,48,10002,0,0,0,0
25,96,48,48,48,416,96,10002,0,0,0,0
25,96,48,48,48,416,48,10002,0,0,0,0
25,96,48,48,48,464,96,10002,0,0,0,0
25,96,48,48,48,464,144,10002,0,0,0,0
25,96,48,48,48,464,48,10002,0,0,0,0
25,96,48,32,48,512,48,10002,0,0,0,0
25,96,48,32,48,512,96,10002,0,0,0,0
25,96,48,32,48,512,144,10002,0,0,0,0
25,272,176,16,16,416,176,10002,0,0,0,0
25,112,48,32,48,432,144,10002,0,0,0,0
25,96,48,16,32,416,144,10002,0,0,0,0
24,432,64,32,32,352,144,10000,0,0,0,0
24,464,176,32,16,256,176,10000,0,0,0,0
24,432,320,64,32,224,64,10000,0,0,0,0
24,336,16,16,16,480,208,10000,0,0,0,0
24,336,16,16,16,480,224,10000,0,0,0,0
24,336,16,16,16,480,240,10000,0,0,0,0
24,336,16,16,16,480,272,10000,0,0,0,0
24,336,16,16,16,480,256,10000,0,0,0,0
25,0,224,16,32,464,208,10002,0,0,0,0
25,0,224,16,32,480,208,10002,0,0,0,0
25,0,224,16,32,496,208,10002,0,0,0,0
25,0,224,16,32,496,240,10002,0,0,0,0
25,0,224,16,32,480,240,10002,0,0,0,0
25,0,224,16,32,464,240,10002,0,0,0,0
25,0,224,16,32,464,272,10002,0,0,0,0
25,0,224,16,32,480,272,10002,0,0,0,0
25,0,224,16,32,496,272,10002,0,0,0,0
25,0,224,16,32,496,304,10002,0,0,0,0
25,0,224,16,32,480,304,10002,0,0,0,0
25,0,224,16,32,464,304,10002,0,0,0,0
25,0,224,16,32,448,288,10002,0,0,0,0
25,272,176,224,80,224,240,10002,0,0,0,0
25,272,176,176,16,272,224,10002,0,0,0,0
25,272,176,176,16,96,224,10002,0,0,0,0
25,416,176,32,80,64,224,10002,0,0,0,0
25,416,176,32,80,176,272,10002,0,0,0,0
25,416,176,32,80,144,272,10002,0,0,0,0
987654321

