UVx6TlN0AGU9Z0pvAWdiFHNgSEhPHTUOSSknVA59PFliZml8NQ==
259,24,24,0,200,222,0,0,0,1,13,0
259,48,176,0,100,99,0,0,0,1,27,0
160,256,104,0,0,16777215,0,0,0,1,94,0
195,272,152,0,0,128,271,0,68,1,69,0
123,296,192,0,564,255,0,0,0,0,9,0
197,144,264,0,2,35,0,0,0,1,34,0
197,160,200,0,2,42,0,0,0,1,41,0
174,80,192,0,1,23,6,0,0,0,26,1
174,424,144,0,0,31,44,46,89,0,42,1
174,417,78,0,0,79,78,77,0,0,89,1
174,456,160,0,0,31,9,0,0,0,35,1
205,77.50,128,0,1,0,0.50,0,0,0,6,0
186,160,128,0,32,32,0,0,0,1,53,0
219,176,248,0,32,32,0,0,0,1,31,1
188,48,128,0,0,7,9,0,0,1,8,0
158,40,264,0,1,16777215,0,1,0,1,10,0
157,16,144,0,32,32,0,0,0,1,2,0
157,48,144,0,32,32,0,0,0,1,3,0
157,80,144,0,32,32,0,0,0,1,4,0
157,112,144,0,32,32,0,0,0,1,5,0
157,16,280,0,32,32,0,0,0,1,11,0
157,48,280,0,32,32,0,0,0,1,12,0
157,112,176,0,32,32,0,0,0,1,18,0
157,112,208,0,32,32,0,0,0,1,19,0
157,80,208,0,32,32,0,0,0,1,20,0
157,80,280,0,32,32,0,0,0,1,21,0
157,112,280,0,32,32,0,0,0,1,22,0
157,112,216,0,32,32,0,0,0,1,25,0
157,144,280,0,32,32,0,0,0,1,29,0
157,176,280,0,32,32,0,0,0,1,30,0
157,176,216,0,32,32,0,0,0,1,32,0
157,144,216,0,32,32,0,0,0,1,33,0
157,208,280,0,32,32,0,0,0,1,37,0
157,208,216,0,32,32,0,0,0,1,38,0
157,240,280,0,32,32,0,0,0,1,40,0
157,208,128,0,32,32,0,0,0,1,48,0
157,208,96,0,32,32,0,0,0,1,49,0
157,208,64,0,32,32,0,0,0,1,50,0
157,208,32,0,32,32,0,0,0,1,51,0
157,208,0,0,32,32,0,0,0,1,52,0
157,112,112,0,32,32,0,0,0,1,57,0
157,112,80,0,32,32,0,0,0,1,58,0
157,112,48,0,32,32,0,0,0,1,59,0
157,112,16,0,32,32,0,0,0,1,60,0
157,272,280,0,32,32,0,0,0,1,64,0
157,304,280,0,32,32,0,0,0,1,65,0
157,272,128,0,32,32,0,0,0,1,70,0
157,240,128,0,32,32,0,0,0,1,71,0
157,304,128,0,32,32,0,0,0,1,72,0
157,304,0,0,32,32,0,0,0,1,80,0
157,240,0,0,32,32,0,0,0,1,81,0
157,272,0,0,32,32,0,0,0,1,82,0
157,336,280,0,32,32,0,0,0,1,93,0
157,392,232,0,32,32,0,0,0,1,95,0
157,336,168,0,32,32,0,0,0,1,96,0
157,304,96,0,32,32,0,0,0,1,77,0
157,304,72,0,32,32,0,0,0,1,78,0
157,304,40,0,32,32,0,0,0,1,79,0
169,112,232,0,0,0,0,0,0,1,23,1
172,128,128,0,0,0,0,0,0,1,44,1
172,160,128,0,1,0,0,0,0,1,46,1
166,8,304,0,0,0,0,0,0,0,7,1
166,8,256,0,0,0,0,0,0,0,68,1
196,8.50,303.50,0,0,0,0,0,0,0,0,0
1234567890
25,176,176,80,80,0,0,10002,0,0,0,0
25,176,176,80,80,0,80,10002,0,0,0,0
25,176,176,80,80,0,160,10002,0,0,0,0
25,176,176,80,80,0,240,10002,0,0,0,0
25,176,176,80,80,0,320,10002,0,0,0,0
25,176,176,80,80,80,320,10002,0,0,0,0
25,176,176,80,80,80,240,10002,0,0,0,0
25,176,176,80,80,80,0,10002,0,0,0,0
25,176,176,80,80,80,80,10002,0,0,0,0
25,176,176,80,80,80,160,10002,0,0,0,0
25,176,176,80,80,160,160,10002,0,0,0,0
25,176,176,80,80,240,160,10002,0,0,0,0
25,176,176,80,80,320,160,10002,0,0,0,0
25,176,176,80,80,320,240,10002,0,0,0,0
25,176,176,80,80,320,80,10002,0,0,0,0
25,176,176,80,80,320,0,10002,0,0,0,0
25,176,176,80,80,240,0,10002,0,0,0,0
25,176,176,80,80,160,0,10002,0,0,0,0
25,176,176,80,80,160,80,10002,0,0,0,0
25,176,176,80,80,240,80,10002,0,0,0,0
25,176,176,80,80,240,240,10002,0,0,0,0
25,176,176,80,80,320,320,10002,0,0,0,0
25,176,176,80,80,240,320,10002,0,0,0,0
25,176,176,80,80,160,320,10002,0,0,0,0
25,176,176,80,80,160,240,10002,0,0,0,0
25,176,176,80,80,400,320,10002,0,0,0,0
25,176,176,80,80,480,320,10002,0,0,0,0
25,176,176,80,80,560,320,10002,0,0,0,0
25,176,176,80,80,560,240,10002,0,0,0,0
25,176,176,80,80,480,240,10002,0,0,0,0
25,176,176,80,80,400,240,10002,0,0,0,0
25,176,176,80,80,400,0,10002,0,0,0,0
25,176,176,80,80,480,0,10002,0,0,0,0
25,176,176,80,80,560,0,10002,0,0,0,0
25,176,176,80,80,576,80,10002,0,0,0,0
25,176,176,80,80,576,160,10002,0,0,0,0
25,176,176,80,80,496,80,10002,0,0,0,0
25,176,176,80,80,400,80,10002,0,0,0,0
25,176,176,80,80,400,160,10002,0,0,0,0
25,240,176,16,80,560,160,10002,0,0,0,0
25,176,176,16,80,480,96,10002,0,0,0,0
25,176,192,80,64,480,176,10002,0,0,0,0
25,192,240,64,16,496,160,10002,0,0,0,0
25,224,208,16,16,480,80,10002,0,0,0,0
987654321
Rw==
Ewc+BwEuRCElKWxdJ0pfPg==

