UVx6TlN0AGU9Z0pvAWdiFHNgYllXBylbAHxuAUd9PFliZml8NTghenh/cQ==
259,24,360,0,411,222,0,0,0,1,87,0
259,208,264,0,32,32,0,0,0,1,91,0
160,64,328,0,1,16777215,0,0,0,1,48,0
100,55,176,0,256,0,0,271,103,1,95,0
123,88,80,0,128,0,0,0,0,1,107,0
123,85,17,0,128,0,0,0,0,1,108,0
123,105,43,0,128,0,0,0,0,1,109,0
123,72,39,0,128,0,0,0,0,1,110,0
197,120,336,0,2,32,0,0,0,1,47,0
174,168,128,0,1,6,8,0,0,0,5,1
205,496,344,0,1,0,0.50,0,0,1,149,0
205,536,304,0,1,0,1.23,0,0,1,123,0
205,496,320,0,-1,0,0.50,0,0,1,156,0
205,496,325,0,-1,0,0.50,0,0,1,158,0
205,472,319,0,1,0,1.23,0,0,1,154,0
205,469,325,0,-1,0,0.50,0,0,1,161,0
205,459,313,0,1,0,1.23,0,0,1,153,0
205,450,310,0,1,0,1.23,0,0,1,151,0
205,440,312,0,-1,0,0.50,0,0,1,150,0
205,449,310,0,-1,0,0.50,0,0,1,160,0
205,436,330,0,1,0,1.23,0,0,1,152,0
205,439,312,0,-1,0,0.50,0,0,1,159,0
205,480,320,0,1,0,0.50,0,0,1,155,0
186,88,144,0,32,32,0,0,0,1,46,0
188,592,120,0,0,32,103,101,0,1,64,0
154,55,176,0,1,0.50,32,32,-1,1,103,1
158,40,232,0,1,16777215,0,1,0,1,25,0
210,273,344,0,65,0,0,0,0,1,58,0
210,584,0,0,58,180,0,0,0,1,65,0
157,16,248,0,32,32,0,0,0,1,76,0
157,48,248,0,32,32,0,0,0,1,2,0
157,80,248,0,32,32,0,0,0,1,3,0
157,112,248,0,32,32,0,0,0,1,4,0
157,40,144,0,32,32,0,0,0,1,10,0
157,8,144,0,32,32,0,0,0,1,11,0
157,8,112,0,32,32,0,0,0,1,12,0
157,40,112,0,32,32,0,0,0,1,13,0
157,16,16,0,32,32,0,0,0,1,14,0
157,40,16,0,32,32,0,0,0,1,15,0
157,40,48,0,32,32,0,0,0,1,16,0
157,40,80,0,32,32,0,0,0,1,17,0
157,8,80,0,32,32,0,0,0,1,18,0
157,16,48,0,32,32,0,0,0,1,19,0
157,136,144,0,32,32,0,0,0,1,20,0
157,136,112,0,32,32,0,0,0,1,21,0
157,136,80,0,32,32,0,0,0,1,22,0
157,136,48,0,32,32,0,0,0,1,23,0
157,136,16,0,32,32,0,0,0,1,24,0
157,144,248,0,32,32,0,0,0,1,26,0
157,176,248,0,32,32,0,0,0,1,27,0
157,240,248,0,32,32,0,0,0,1,29,0
157,240,280,0,32,32,0,0,0,1,34,0
157,240,312,0,32,32,0,0,0,1,35,0
157,240,344,0,32,32,0,0,0,1,36,0
157,208,352,0,32,32,0,0,0,1,37,0
157,176,352,0,32,32,0,0,0,1,38,0
157,144,352,0,32,32,0,0,0,1,39,0
157,112,352,0,32,32,0,0,0,1,40,0
157,16,280,0,32,32,0,0,0,1,41,0
157,16,312,0,32,32,0,0,0,1,42,0
157,16,344,0,32,32,0,0,0,1,43,0
157,48,352,0,32,32,0,0,0,1,44,0
157,80,352,0,32,32,0,0,0,1,45,0
157,168,144,0,32,32,0,0,0,1,50,0
157,200,144,0,32,32,0,0,0,1,51,0
157,304,248,0,32,32,0,0,0,1,52,0
157,304,280,0,32,32,0,0,0,1,53,0
157,304,312,0,32,32,0,0,0,1,54,0
157,304,344,0,32,32,0,0,0,1,55,0
157,232,144,0,32,32,0,0,0,1,56,0
157,272,360,0,32,32,0,0,0,1,57,0
157,624,136,0,32,32,0,0,0,1,59,0
157,592,136,0,32,32,0,0,0,1,60,0
157,560,136,0,32,32,0,0,0,1,61,0
157,528,136,0,32,32,0,0,0,1,62,0
157,496,136,0,32,32,0,0,0,1,63,0
157,304,216,0,32,32,0,0,0,1,66,0
157,304,152,0,32,32,0,0,0,1,80,0
157,304,144,0,32,32,0,0,0,1,81,0
157,336,216,0,32,32,0,0,0,1,85,0
157,368,216,0,32,32,0,0,0,1,86,0
157,176,280,0,32,32,0,0,0,1,133,0
172,56,144,0,0,0,0,0,0,1,6,1
172,88,144,0,1,0,0,0,0,1,8,1
172,192,232,0,0,0,0,0,0,1,32,1
155,8,176,0,1,1,0,0,0,1,101,0
155,248,176,0,2,1,0,0,0,1,102,0
166,632,112,0,0,0,180,0,0,0,118,1
1234567890
25,208,112,32,16,96,144,10002,0,0,0,0
25,208,112,32,16,64,144,10002,0,0,0,0
24,0,160,32,32,96,208,10000,0,0,0,0
24,64,256,32,32,128,192,10000,0,0,0,0
24,128,256,32,32,256,272,10000,0,0,0,0
24,320,16,16,16,96,192,10000,0,0,0,0
24,368,16,16,16,256,208,10000,0,0,0,0
24,352,16,16,16,256,96,10000,0,0,0,0
24,336,16,16,16,256,256,10000,0,0,0,0
24,336,16,16,16,272,256,10000,0,0,0,0
24,336,16,16,16,256,304,10000,0,0,0,0
24,336,16,16,16,272,304,10000,0,0,0,0
24,256,144,32,32,320,240,10000,0,0,0,0
24,368,192,32,16,352,256,10000,0,0,0,0
24,368,192,32,16,384,256,10000,0,0,0,0
24,368,192,32,16,416,256,10000,0,0,0,0
24,368,192,32,16,448,256,10000,0,0,0,0
24,368,192,32,16,352,240,10000,0,0,0,0
24,368,192,32,16,384,240,10000,0,0,0,0
24,368,192,32,16,416,240,10000,0,0,0,0
24,368,192,32,16,448,240,10000,0,0,0,0
24,368,192,32,16,480,240,10000,0,0,0,0
24,368,192,32,16,512,240,10000,0,0,0,0
24,368,192,32,16,544,240,10000,0,0,0,0
24,368,192,32,16,576,240,10000,0,0,0,0
24,368,192,32,16,608,240,10000,0,0,0,0
24,368,192,32,16,608,256,10000,0,0,0,0
24,368,192,32,16,576,256,10000,0,0,0,0
24,368,192,32,16,544,256,10000,0,0,0,0
24,368,192,32,16,512,256,10000,0,0,0,0
24,368,192,32,16,480,256,10000,0,0,0,0
24,0,320,64,32,64,48,10000,0,0,0,0
987654321
Rw==
Ewc+BwEuRCElKWxdJ0pfPg==

