XlF4TlN0AGU9Z0Z8Hwd+H38YKwsCTnwSVTU7SBJhIEV+eg==
259,24,88,0,16,16,0,0,0,1,75,0
259,656,328,0,32,32,0,0,0,1,221,0
259,856,304,0,448,112,0,0,0,1,232,0
259,672,112,0,96,288,0,0,0,1,245,0
259,376,192,0,336,240,0,0,0,1,256,0
259,416,32,0,144,80,0,0,0,1,334,0
259,776,16,0,112,256,0,0,0,1,414,0
259,968,136,0,304,320,0,0,0,1,415,0
259,240,40,0,32,64,0,0,0,1,475,0
160,916,346,0,1,16777215,0,0,0,1,246,0
123,320,344,0,152,8454143,0,0,0,1,47,0
100,480,48,0,256,128,0,137,0,0,290,0
100,352,48,0,256,128,0,34,0,0,289,0
224,88,248,0,156,65535,0,1,0,1,429,0
224,88,248,0,252,8388863,0,1,180,1,385,0
224,328,16,0,116,8454143,0,1,180,1,39,0
123,208,24,0,44,8388863,0,0,0,1,46,0
224,88,120,0,156,65535,0,1,0,1,432,0
123,104,72,0,76,8454143,0,0,0,1,48,0
224,88,120,0,148,8388863,0,1,180,1,431,0
123,604,326,0,112,8388863,0,0,0,1,384,0
224,504,24,1,116,8454143,0,1,0,1,267,0
100,482.40,88,0,280,8388863,346,0,346,1,382,0
224,760,192,0,128,8388863,0,1,180,1,417,0
197,552,56,0,1,268,0,0,0,1,279,0
197,312,56,0,3,273,0,0,0,1,285,0
197,392,56,0,7,288,0,0,0,1,284,0
197,544,56,0,1,293,0,0,0,1,278,0
197,536,56,0,1,0,0,0,0,1,280,0
193,856,64,0,0,94,95,96,168,1,156,1
193,856,96,0,0,97,98,159,169,1,168,1
174,656,48,0,0,135,147,0,0,0,148,1
193,856,200,0,0,92,91,0,0,1,177,1
193,857,145,0,0,123,121,122,167,1,170,1
193,856,120,0,0,157,158,124,170,1,169,1
174,424,56,0,0,289,290,275,292,0,288,1
174,656,128,0,0,57,58,0,0,0,63,1
193,856,176,0,0,120,119,93,177,1,167,1
193,904,203,0,0,229,0,0,0,1,231,1
193,657,88,0,0,125,0,0,0,1,184,1
193,856,232,0,0,77,0,0,0,1,82,1
174,56,80,0,1,7,0,0,0,0,9,1
174,128,168,0,0,287,286,0,0,0,294,1
174,129,209,0,0,321,307,0,0,0,322,1
205,712,88,0,1,0,0.19,0,0,0,147,0
181,512,170,0,352,128,0,0,0,1,346,0
220,88,72,0,16,16,0,0,0,0,77,1
220,408,112,0,208,16,0,0,0,0,94,1
220,376,208,0,112,16,0,0,0,0,96,1
220,424,184,0,16,32,0,0,0,0,97,1
220,400,160,0,96,16,0,0,0,0,98,1
220,472,160,0,16,16,0,0,0,0,159,1
220,472,192,0,16,16,0,0,0,0,157,1
220,471,224,0,16,16,0,0,0,0,158,1
220,536,96,0,16,16,0,0,0,0,124,1
220,536,128,0,16,16,0,0,0,0,123,1
220,536,160,0,16,16,0,0,0,0,121,1
220,536,192,0,16,16,0,0,0,0,122,1
220,376,256,0,208,16,0,0,0,0,93,1
220,536,224,0,16,16,0,0,0,0,120,1
220,536,256,0,16,16,0,0,0,0,119,1
220,487,192,0,16,144,0,0,0,0,92,1
220,312,168,0,16,96,0,0,0,0,95,1
220,264,184,0,16,160,0,0,0,0,91,1
186,944,96,0,32,32,0,0,0,1,224,0
188,752,88,0,0,147,184,0,0,1,155,0
188,736,88,0,0,0,0,0,156,1,166,0
188,944,240,0,0,215,0,0,0,1,225,0
188,944,184,0,0,231,0,0,0,1,228,0
185,242,33,0,453,16,1,0,0,1,466,0
185,984,312,0,0,64,1,0,0,1,234,0
242,288,40,0,32,32,0,0,0,1,398,0
242,240,136,0,32,32,0,0,0,1,397,0
176,288,40,0,411,32,32,0,0,1,413,0
176,240,168,0,451,32,32,0,0,1,474,0
176,240,160,0,449,32,32,0,0,1,465,0
176,104,288,0,78,32,32,0,0,1,81,0
176,104,64,0,0,32,32,0,0,1,107,0
176,240,136,0,0,32,32,0,0,1,348,0
176,240,136,0,411,32,32,0,0,1,412,0
176,88,72,0,82,32,32,0,0,1,78,0
176,240,88,0,148,32,32,0,0,1,135,0
176,240,88,0,125,32,32,0,0,1,493,0
176,256,88,0,495,32,32,0,0,1,494,0
175,688,192,0,62,25,0,0,0,1,52,0
273,664,160,0,54,1,0,0,0,1,57,0
273,688,160,0,51,1,0,0,0,1,58,0
273,712,160,0,63,1,0,0,0,1,62,0
175,192,208,0,294,70,1,0,0,1,295,0
175,160,208,0,322,70,1,0,0,1,445,0
154,656,328,0,1,10,32,32,1,1,217,1
154,481.60,88,1,2,0.40,16,16,-1,1,352,1
154,242,33,0,3,0.19,16,16,1,1,453,1
210,688,272,0,0,180,0,0,0,1,212,0
210,592,296,0,212,0,0,0,0,1,193,0
210,400,200,0,211,0,0,0,0,1,192,0
210,288,56,0,0,0,0,0,0,1,211,0
158,32,80,0,1,8388863,0,1,0,1,10,0
216,176,160,0,20,1,0,0,0,1,287,0
216,176,160,0,21,1,0,0,0,0,286,0
216,48,200,0,29,0,0,0,0,1,485,0
216,49,130,0,49,0,0,0,0,1,483,0
216,416,32,0,23,0,0,0,0,0,292,0
216,168,264,0,20,1,0,0,0,0,321,0
216,168,264,0,21,1,0,0,0,1,307,0
216,464,184,0,72,1,0,0,0,0,411,0
157,320,8,0,608,16,0,0,0,1,3,0
157,400,64,0,288,16,0,0,0,1,89,0
157,336,56,0,16,16,0,0,0,1,271,0
157,368,32,0,16,16,0,0,0,1,283,0
157,216,200,0,16,192,0,0,0,1,84,0
157,32,88,0,32,16,0,0,0,1,7,0
157,8,183,0,16,368,0,0,0,1,17,0
157,264,64,0,16,112,0,0,0,1,113,0
157,216,40,0,16,64,0,0,0,1,448,0
157,184,112,0,48,16,0,0,0,1,88,0
157,160,112,0,16,16,0,0,0,1,76,0
157,144,112,0,16,16,0,0,0,1,444,0
157,120,64,0,16,16,0,0,0,1,87,0
157,120,88,0,16,16,0,0,0,1,74,0
157,120,112,0,16,16,0,0,0,1,446,0
157,120,56,0,16,16,0,0,0,1,447,0
157,88,152,0,16,16,0,0,0,1,30,0
157,88,184,0,16,16,0,0,0,1,31,0
157,88,216,0,16,16,0,0,0,1,67,0
157,88,248,0,16,16,0,0,0,1,69,0
157,64,88,0,64,16,0,0,0,1,8,0
157,88,120,0,16,16,0,0,0,1,29,0
157,88,56,0,16,16,0,0,0,1,72,0
157,88,24,0,16,16,0,0,0,1,73,0
157,240,56,0,48,16,0,0,0,1,449,0
157,320,352,0,608,16,0,0,0,1,5,0
157,376,304,0,336,16,0,0,0,1,86,0
157,632,176,0,16,368,0,0,0,1,4,0
157,592,304,0,64,16,0,0,0,1,269,0
157,552,184,0,16,256,0,0,0,1,85,0
157,496,56,0,16,16,0,0,0,1,272,0
157,464,32,0,16,16,0,0,0,1,282,0
157,656,256,0,32,32,0,0,0,1,198,0
157,824,352,0,384,16,0,0,0,1,214,0
157,656,296,0,32,32,0,0,0,1,219,0
157,656,272,0,32,32,0,0,0,1,220,0
157,112,312,0,48,16,0,0,0,1,32,0
172,224,104,0,0,0,0,0,0,1,125,1
155,656,328,0,1,1,0,0,0,0,215,0
155,912,328,0,2,1,0,0,0,0,216,0
172,928,96,0,0,0,0,0,0,1,222,1
172,928,184,0,0,0,0,0,0,1,229,1
169,328,16,0,0,0,0,0,0,1,273,1
169,488,16,0,0,0,0,0,0,1,275,1
155,320,240,0,1,2,0,0,0,1,350,0
155,512,280,0,2,2,0,0,0,1,351,0
155,512,88,0,3,2,0,0,0,1,354,0
155,480,88,0,4,2,0,0,0,1,355,0
155,512,88,0,5,2,0,0,0,1,356,0
155,512,136,0,6,2,0,0,0,1,357,0
155,336,136,0,7,2,0,0,0,1,358,0
155,336,232,0,8,2,0,0,0,1,359,0
155,288,232,0,9,2,0,0,0,1,360,0
155,288,184,0,10,2,0,0,0,1,361,0
155,336,184,0,11,2,0,0,0,1,362,0
155,336,88,0,12,2,0,0,0,1,363,0
155,296,88,0,13,2,0,0,0,1,364,0
155,296,136,0,14,2,0,0,0,1,365,0
155,448,136,0,15,2,0,0,0,1,366,0
155,448,232,0,16,2,0,0,0,1,367,0
155,400,232,0,17,2,0,0,0,1,368,0
155,336,232,0,18,2,0,0,0,1,369,0
155,336,280,0,19,2,0,0,0,1,370,0
155,512,280,0,20,2,0,0,0,1,371,0
155,512,88,0,21,2,0,0,0,1,372,0
155,368,89,0,22,2,0,0,0,1,373,0
155,368,137,0,23,2,0,0,0,1,374,0
155,368,232,0,24,2,0,0,0,1,375,0
155,336,232,0,25,2,0,0,0,1,376,0
155,336,136,0,26,2,0,0,0,1,377,0
155,296,136,0,27,2,0,0,0,1,378,0
155,392,144,0,28,2,0,0,0,1,379,0
155,288,256,0,29,2,0,0,0,1,380,0
155,248,280,0,30,2,0,0,0,1,381,0
155,242,33,0,1,3,0,0,0,0,451,0
155,240,280,0,2,3,0,0,0,1,452,0
155,520,280,0,3,3,0,0,0,1,455,0
155,520,88,0,4,3,0,0,0,1,456,0
155,288,88,0,5,3,0,0,0,1,457,0
155,288,136,0,6,3,0,0,0,1,458,0
155,288,232,0,7,3,0,0,0,1,459,0
155,464,232,0,8,3,0,0,0,1,460,0
155,464,136,0,9,3,0,0,0,1,461,0
155,336,136,0,10,3,0,0,0,1,462,0
155,336,184,0,11,3,0,0,0,1,463,0
155,408,184,0,12,3,0,0,0,0,464,0
169,208,72,0,0,0,0,0,0,0,495,1
166,616,336,0,0,0,180,0,0,0,51,1
166,24,336,0,0,0,0,0,0,1,54,1
166,568,65,0,0,0,270,0,0,0,268,1
166,616,24,0,0,0,270,0,0,1,270,1
166,568,24,0,0,0,270,0,0,1,293,1
216,48,273,0,32,0,0,0,0,1,484,0
185,728,304,0,0,16,-1,0,0,1,242,0
185,752,304,0,0,16,-1,0,0,1,241,0
185,776,304,0,0,16,-1,0,0,1,236,0
185,800,304,0,0,16,-1,0,0,1,238,0
185,824,304,0,0,16,-1,0,0,1,239,0
185,848,304,0,0,16,-1,0,0,1,237,0
185,872,304,0,0,16,-1,0,0,1,240,0
185,896,304,0,0,16,-1,0,0,1,243,0
157,728,32,0,112,16,0,0,0,1,144,0
157,680,80,0,16,80,0,0,0,1,146,0
157,688,256,0,32,32,0,0,0,1,194,0
157,728,128,0,112,16,0,0,0,1,143,0
157,728,96,0,64,16,0,0,0,1,136,0
157,720,256,0,32,32,0,0,0,1,195,0
157,752,256,0,32,32,0,0,0,1,196,0
157,904,280,0,336,16,0,0,0,1,244,0
157,784,256,0,32,32,0,0,0,1,197,0
157,776,80,0,16,80,0,0,0,1,145,0
157,816,256,0,32,32,0,0,0,1,199,0
157,848,256,0,32,32,0,0,0,1,200,0
157,880,256,0,32,32,0,0,0,1,207,0
157,912,256,0,32,32,0,0,0,1,208,0
157,944,256,0,32,32,0,0,0,1,209,0
157,976,256,0,32,32,0,0,0,1,210,0
176,688,288,0,222,48,32,0,0,1,226,0
216,768,192,0,79,0,0,0,0,0,410,0
224,760,192,0,128,65535,0,1,0,1,416,0
1234567890
24,32,176,16,16,80,128,10000,0,0,0,0
24,48,176,16,16,80,160,10000,0,0,0,0
24,240,320,16,16,240,320,10000,0,0,0,0
24,416,240,32,16,96,288,10000,0,0,0,0
24,352,304,48,16,384,304,10000,0,0,0,0
24,352,304,48,16,464,304,10000,0,0,0,0
24,368,320,32,32,480,128,10000,0,0,0,0
24,0,256,64,32,112,208,10000,0,0,0,0
24,80,320,16,32,176,208,10000,0,0,0,0
24,112,320,32,32,112,160,10000,0,0,0,0
24,192,320,16,32,144,160,10000,0,0,0,0
24,112,144,48,16,160,80,10000,0,0,0,0
24,464,256,32,32,320,16,10000,0,0,0,0
24,464,256,32,32,480,16,10000,0,0,0,0
24,464,288,32,32,224,96,10000,0,0,0,0
24,80,304,16,16,80,256,10000,0,0,0,0
24,0,288,32,32,144,112,10000,0,0,0,0
25,272,256,64,48,208,304,10002,0,0,0,0
25,272,256,64,48,272,304,10002,0,0,0,0
25,272,256,64,48,336,304,10002,0,0,0,0
25,272,256,64,48,400,304,10002,0,0,0,0
25,272,256,64,48,464,304,10002,0,0,0,0
25,272,256,64,48,528,304,10002,0,0,0,0
25,272,256,64,48,592,304,10002,0,0,0,0
25,272,256,64,48,144,304,10002,0,0,0,0
25,272,256,64,48,144,256,10002,0,0,0,0
25,272,256,64,48,144,208,10002,0,0,0,0
25,272,256,64,48,144,160,10002,0,0,0,0
25,272,256,64,48,144,112,10002,0,0,0,0
25,272,256,64,48,80,112,10002,0,0,0,0
25,272,256,64,48,80,160,10002,0,0,0,0
25,272,256,64,48,16,112,10002,0,0,0,0
25,272,256,64,48,16,160,10002,0,0,0,0
25,272,256,64,48,16,208,10002,0,0,0,0
25,272,256,64,48,16,256,10002,0,0,0,0
25,272,256,64,48,16,304,10002,0,0,0,0
25,272,256,64,48,80,208,10002,0,0,0,0
25,272,256,64,48,80,256,10002,0,0,0,0
25,272,256,64,48,80,304,10002,0,0,0,0
25,272,256,64,48,16,64,10002,0,0,0,0
25,272,256,64,48,16,16,10002,0,0,0,0
25,272,256,64,48,80,64,10002,0,0,0,0
25,272,256,64,48,80,16,10002,0,0,0,0
25,272,256,64,48,144,16,10002,0,0,0,0
25,272,256,64,48,144,64,10002,0,0,0,0
25,272,48,64,48,272,16,10002,0,0,0,0
25,272,48,64,48,336,16,10002,0,0,0,0
25,272,48,64,48,400,16,10002,0,0,0,0
25,272,48,64,48,464,16,10002,0,0,0,0
25,272,48,32,48,592,16,10002,0,0,0,0
25,272,48,32,48,592,64,10002,0,0,0,0
25,272,48,32,48,592,112,10002,0,0,0,0
25,272,48,32,48,592,160,10002,0,0,0,0
25,272,48,32,48,592,208,10002,0,0,0,0
25,272,48,32,48,592,256,10002,0,0,0,0
25,272,48,64,48,528,16,10002,0,0,0,0
25,304,48,32,48,560,64,10002,0,0,0,0
25,304,48,32,48,560,112,10002,0,0,0,0
25,304,48,32,48,560,160,10002,0,0,0,0
25,304,48,32,48,560,208,10002,0,0,0,0
25,304,48,32,48,560,256,10002,0,0,0,0
25,400,0,64,48,272,64,10002,0,0,0,0
25,400,0,64,48,336,64,10002,0,0,0,0
25,400,0,64,48,464,112,10002,0,0,0,0
25,400,0,64,48,336,112,10002,0,0,0,0
25,400,0,64,48,272,112,10002,0,0,0,0
25,400,0,64,48,272,160,10002,0,0,0,0
25,400,0,64,48,272,208,10002,0,0,0,0
25,400,0,64,48,272,256,10002,0,0,0,0
25,400,0,64,48,336,160,10002,0,0,0,0
25,400,0,64,48,336,208,10002,0,0,0,0
25,400,0,64,48,336,256,10002,0,0,0,0
25,400,0,64,48,400,160,10002,0,0,0,0
25,400,0,64,48,400,208,10002,0,0,0,0
25,400,0,64,48,400,256,10002,0,0,0,0
25,400,0,64,48,464,160,10002,0,0,0,0
25,400,0,64,48,464,208,10002,0,0,0,0
25,400,0,64,48,464,256,10002,0,0,0,0
25,400,48,16,48,528,64,10002,0,0,0,0
25,400,48,16,48,528,112,10002,0,0,0,0
25,400,48,16,48,528,160,10002,0,0,0,0
25,400,48,16,48,528,208,10002,0,0,0,0
25,400,48,16,48,528,256,10002,0,0,0,0
25,400,48,64,48,400,64,10002,0,0,0,0
25,400,48,64,48,400,112,10002,0,0,0,0
25,400,48,48,48,224,112,10002,0,0,0,0
25,400,48,48,48,224,160,10002,0,0,0,0
25,400,48,48,48,224,208,10002,0,0,0,0
25,400,48,48,48,224,256,10002,0,0,0,0
25,400,48,48,48,224,64,10002,0,0,0,0
25,448,48,16,48,208,48,10002,0,0,0,0
25,400,80,16,16,208,96,10002,0,0,0,0
987654321
NC0JNlAAECB2Py1aO05fPxQlO1BBDjUCLCV7EVU0LBxyMzwjJWE/diE9YRs6HDd0STxgNw==
EA0rCUArEC1qJXkOJltBNVUoO1lAByRKEGt8WFwkdVU7ajQxbnExOC0kYQM3D3J2
FEhqQjQqWTolLmlHJ0Rfel0/O0xGG3BAHHZjWFs1ZQE9OHkxY2B0JGg0IB0gAGR3QyA0
DkgmCwsnECBxa3tLIVINN0EvcxhdEX4MVyV1AVtxZBQkL3k2cHoxbWE

