UVx6TlJyAHkpcyFlAWcBFAQCL3UdUmAOSSknVA59PFliZmk=
259,144,256,0,368,208,0,0,0,1,161,0
259,544,48,0,208,64,0,0,0,1,309,0
259,600,112,0,144,80,0,0,0,1,310,0
259,600,448,0,80,240,0,0,0,1,522,0
259,472,1248,0,32,96,0,0,0,1,676,0
259,504,1256,0,32,112,0,0,0,1,683,0
259,64,1224,0,48,32,0,0,0,1,699,0
259,520,712,0,128,16,0,0,0,1,768,0
259,394,1474,0,880,288,0,0,0,1,870,0
160,61,1054,0,0,16777215,0,0,0,1,696,0
195,352,808,0,0,128,0,0,575,1,574,0
123,352,872,0,128,65280,0,0,0,1,581,0
123,352,872,0,128,255,0,0,0,0,580,0
100,352,808,0,256,65280,574,0,574,1,583,0
100,352,808,0,256,255,574,0,574,0,584,0
197,456,960,0,4,568,0,0,0,1,636,0
197,520,748,0,3,764,0,0,0,1,767,0
197,56,1192,0,2,0,0,0,0,1,701,0
174,408,32,0,0,0,312,316,315,0,314,1
174,384,32,0,0,392,407,408,409,0,405,1
174,408,112,0,0,319,393,321,405,0,391,1
193,272,432,0,0,0,480,0,0,1,487,1
193,296,328,0,0,472,0,0,0,1,470,1
174,304,880,0,0,561,583,0,584,0,582,1
193,584,992,0,0,637,639,0,0,1,641,1
174,352,888,0,1,581,580,559,582,1,575,1
193,137,807,0,0,597,595,751,0,1,599,1
174,136,752,0,1,750,547,545,543,0,601,1
174,608,752,0,0,756,765,766,758,0,763,1
174,522,697,0,0,760,763,0,0,0,764,1
174,409,72,0,0,391,317,320,318,0,315,1
205,632,64,0,-1,0,0.25,0,0,0,318,0
205,632,136,0,-1,0,0.26,0,0,0,407,0
205,592,136,0,-1,0,0.36,0,0,0,317,0
205,464,48,0,-1,0,0.25,0,0,0,409,0
205,488,64,0,-1,0,0.25,0,0,0,316,0
205,480,192,0,-1,0,0.25,0,0,0,319,0
205,456,136,0,1,0,0.10,0,0,0,312,0
205,552,137,0,1,0,0.10,0,0,0,321,0
205,528,64,0,-1,0,0.10,0,0,0,392,0
205,520,136,0,1,0,0.10,0,0,0,393,0
205,547,65,0,1,0,0.75,0,0,0,320,0
205,568,64,0,1,0,0.10,0,0,0,408,0
220,328,320,0,16,80,0,0,0,0,497,1
220,312,320,0,16,80,0,0,0,0,496,1
220,304,424,0,16,80,0,0,0,0,494,1
220,288,424,0,16,80,0,0,0,0,488,1
220,296,320,0,16,80,0,0,0,0,495,1
220,272,424,0,16,80,0,0,0,0,489,1
186,575,376,0,32,32,0,0,0,1,476,0
186,616,376,0,32,32,0,0,0,1,477,0
186,504,832,0,32,32,0,0,0,1,585,0
219,80,88,0,128,16,0,0,0,1,2,1
219,80,24,0,128,16,0,0,0,1,7,1
219,384,144,0,64,16,0,0,0,1,334,1
219,440,96,0,16,32,0,0,0,1,290,1
219,232,1248,0,320,16,0,0,0,1,693,1
219,232,1296,0,320,16,0,0,0,1,692,1
188,272,464,0,0,487,0,0,0,1,469,0
188,576,432,0,0,494,482,0,0,1,486,0
188,616,432,0,0,497,478,0,0,1,502,0
188,616,488,0,0,474,496,0,0,1,501,0
188,616,544,0,0,0,0,495,0,1,500,0
188,576,544,0,0,0,0,489,0,1,499,0
188,576,488,0,0,488,484,0,0,1,498,0
188,296,360,0,0,470,0,0,0,1,471,0
188,501,912,0,0,630,566,0,0,1,632,0
188,504,976,0,0,641,0,0,0,1,642,0
188,456,1000,0,0,570,0,0,0,1,634,0
188,504,1256,0,0,685,0,0,0,1,684,0
188,504,1280,0,0,572,673,0,0,1,675,0
188,600,64,0,0,307,0,0,0,1,308,0
188,480,136,0,0,270,0,0,0,1,272,0
188,480,296,0,0,359,363,0,0,1,379,0
188,504,1232,0,0,687,0,0,0,1,689,0
185,400,264,0,365,16,-1,0,0,1,352,0
185,232,296,0,0,16,1,0,0,1,184,0
185,16,296,0,0,16,1,0,0,1,181,0
185,544,264,0,361,16,-1,0,0,1,250,0
185,88,400,0,0,16,1,0,0,1,448,0
185,304,400,0,0,16,1,0,0,1,454,0
185,416,520,0,0,64,1,0,0,1,180,0
185,128,504,0,0,32,1,0,0,1,183,0
185,264,504,0,0,16,1,0,0,1,449,0
185,24,520,0,0,16,1,0,0,1,246,0
185,337,547,0,0,32,1,0,0,1,455,0
185,128,568,0,0,32,1,0,0,1,224,0
185,296,560,0,0,16,1,0,0,1,456,0
185,232,584,0,0,16,1,0,0,1,185,0
185,136,640,0,0,48,1,0,0,1,226,0
185,472,1232,0,0,16,1,0,0,1,677,0
185,472,1248,0,0,16,1,0,0,1,678,0
185,472,1264,0,0,16,1,0,0,1,679,0
242,136,736,0,32,32,0,0,0,0,751,0
242,397,1169,0,128,32,0,0,0,1,836,0
176,304,144,0,32,48,112,0,0,1,103,0
176,64,64,0,314,32,32,0,0,1,313,0
176,208,144,0,26,48,112,0,0,1,59,0
176,272,144,0,30,48,112,0,0,1,101,0
176,240,144,0,28,48,112,0,0,1,61,0
176,48,144,0,16,48,96,0,0,1,56,0
176,144,144,0,22,48,96,0,0,1,54,0
176,80,144,0,18,48,96,0,0,1,123,0
176,112,144,0,20,48,96,0,0,1,81,0
176,175,145,0,24,48,112,0,0,1,57,0
176,136,736,0,599,32,32,0,0,0,750,0
176,224,1192,0,698,224,96,0,0,1,697,0
154,544,264,0,1,2.50,16,16,1,1,361,1
154,400,264,0,2,2.50,16,16,1,1,365,1
210,40,776,0,587,0,0,0,0,1,589,0
210,248,776,0,587,0,0,0,0,1,592,0
210,216,776,0,587,0,0,0,0,1,590,0
210,56,776,0,587,0,0,0,0,1,588,0
210,232,776,0,587,0,0,0,0,1,591,0
210,200,776,0,587,0,0,0,0,1,586,0
210,456,832,0,0,0,0,0,0,1,587,0
158,64,80,0,1,16777215,0,1,0,1,13,0
216,96,56,0,7,0,0,0,0,1,6,0
157,24,88,0,16,16,0,0,0,1,8,0
157,136,88,0,16,16,0,0,0,1,9,0
157,16,144,0,32,16,0,0,0,1,53,0
157,136,24,0,16,16,0,0,0,1,5,0
157,24,24,0,16,16,0,0,0,1,4,0
157,336,144,0,32,16,0,0,0,1,335,0
157,440,32,0,16,64,0,0,0,1,304,0
157,520,88,0,16,16,0,0,0,1,421,0
157,520,96,0,16,16,0,0,0,1,422,0
157,592,144,0,160,16,0,0,0,1,52,0
157,432,144,0,32,16,0,0,0,1,269,0
157,504,72,0,144,16,0,0,0,1,287,0
157,440,128,0,16,32,0,0,0,1,288,0
157,552,8,0,208,16,0,0,0,1,305,0
157,632,72,0,16,16,0,0,0,1,306,0
157,480,304,0,48,16,0,0,0,1,348,0
157,512,304,0,16,32,0,0,0,1,349,0
157,456,304,0,16,32,0,0,0,1,350,0
157,488,312,0,48,16,0,0,0,1,351,0
157,296,368,0,16,16,0,0,0,1,452,0
157,272,472,0,16,16,0,0,0,1,450,0
157,232,584,0,16,16,0,0,0,1,434,0
157,568,712,0,32,16,0,0,0,1,904,0
157,472,712,0,32,16,0,0,0,1,905,0
157,448,760,0,384,16,0,0,0,1,551,0
157,520,756,0,16,16,0,0,0,1,802,0
157,128,760,0,128,16,0,0,0,1,549,0
157,16,760,0,32,16,0,0,0,1,550,0
157,48,784,0,32,16,0,0,0,1,552,0
157,224,784,0,64,16,0,0,0,1,553,0
157,344,848,0,48,16,0,0,0,1,578,0
157,376,872,0,16,64,0,0,0,1,579,0
157,328,872,0,16,32,0,0,0,1,576,0
157,344,896,0,48,16,0,0,0,1,577,0
157,32,1072,0,16,16,0,0,0,1,710,0
157,63,1073,0,16,16,0,0,0,1,713,0
157,96,1072,0,16,16,0,0,0,1,714,0
157,32,1104,0,16,16,0,0,0,1,712,0
157,32,1136,0,16,16,0,0,0,1,711,0
157,32,1167,0,16,16,0,0,0,1,709,0
157,56,1200,0,32,16,0,0,0,1,700,0
157,32,1200,0,16,16,0,0,0,1,708,0
157,80,1200,0,16,16,0,0,0,1,715,0
157,432,1208,0,64,16,0,0,0,1,680,0
157,32,1232,0,16,16,0,0,0,1,707,0
157,480,144,0,64,16,0,0,0,1,270,0
157,408,1248,0,32,16,0,0,0,1,681,0
157,56,1248,0,32,16,0,0,0,1,691,0
157,32,1264,0,16,16,0,0,0,1,702,0
157,600,72,0,48,16,0,0,0,1,307,0
157,520,712,0,128,16,0,0,0,1,760,0
157,440,1296,0,96,16,0,0,0,1,682,0
157,40,1296,0,64,16,0,0,0,1,695,0
172,32,136,0,0,0,0,0,0,1,16,1
172,64,136,0,1,0,0,0,0,1,18,1
172,96,136,0,0,0,0,0,0,1,20,1
172,128,136,0,1,0,0,0,0,1,22,1
172,160,136,0,0,0,0,0,0,1,24,1
172,192,136,0,1,0,0,0,0,1,26,1
172,224,136,0,0,0,0,0,0,1,28,1
172,256,136,0,1,0,0,0,0,1,30,1
172,288,136,0,0,0,0,0,0,1,32,1
155,544,264,0,1,1,0,0,0,0,359,0
155,472,264,0,2,1,0,0,0,1,360,0
155,400,264,0,1,2,0,0,0,0,363,0
155,472,264,0,2,2,0,0,0,1,364,0
172,600,376,0,0,0,0,0,0,1,472,1
172,600,488,0,0,0,0,0,0,1,474,1
172,600,432,0,0,0,0,0,0,1,478,1
172,560,376,0,0,0,0,0,0,1,480,1
172,560,432,0,0,0,0,0,0,1,482,1
172,560,488,0,0,0,0,0,0,1,484,1
172,600,544,0,0,0,0,0,0,1,490,1
172,560,545,0,0,0,0,0,0,1,492,1
172,32,752,0,0,0,0,0,0,1,543,1
172,224,752,0,0,0,0,0,0,1,545,1
172,192,752,0,0,0,0,0,0,1,547,1
172,440,832,0,0,0,0,0,0,1,559,1
172,488,832,0,0,0,0,0,0,1,561,1
172,440,912,0,0,0,0,0,0,1,566,1
172,488,912,0,0,0,0,0,0,1,568,1
172,488,1000,0,0,0,0,0,0,1,570,1
172,440,1000,0,0,0,0,0,0,1,572,0
169,160,720,0,1,0,0,0,0,0,595,1
169,96,720,0,1,0,0,0,0,0,597,1
172,440,960,0,0,0,0,0,0,1,637,1
172,488,976,0,0,0,0,0,0,1,639,1
172,488,1280,0,0,0,0,0,0,1,673,0
172,488,1256,0,0,0,0,0,0,1,685,0
172,488,1232,0,0,0,0,0,0,1,687,0
169,471,720,0,0,0,0,0,0,0,756,1
169,552,720,0,0,0,0,0,0,0,758,1
169,456,720,0,0,0,0,0,0,0,765,1
169,568,720,0,0,0,0,0,0,0,766,1
166,40,24,0,0,0,0,0,0,1,3,1
166,120,88,0,0,0,180,0,0,1,10,1
166,568,584,0,0,0,180,0,0,1,435,1
166,632,264,0,0,0,218,0,0,1,436,1
166,432,1008,0,0,0,90,0,0,1,563,1
166,480,1208,0,0,0,90,0,0,1,564,1
166,528,1304,0,0,0,90,0,0,1,565,1
166,624,857,0,0,0,193,0,0,0,630,1
166,80,1248,0,0,0,0,0,0,1,690,1
166,384,1296,0,0,0,180,0,0,1,694,1
166,56,1224,0,0,0,0,0,0,0,698,1
166,64,1104,0,0,0,180,0,0,1,716,1
237,320,0,0,9960437,304,0,0,0,1,274,0
1234567890
25,48,256,48,48,448,96,10002,0,0,0,0
25,48,256,48,48,496,96,10002,0,0,0,0
25,48,256,48,48,544,96,10002,0,0,0,0
25,48,256,48,48,592,96,10002,0,0,0,0
25,48,256,48,48,592,48,10002,0,0,0,0
25,48,256,48,48,544,48,10002,0,0,0,0
25,48,256,48,48,496,48,10002,0,0,0,0
25,48,256,48,48,448,48,10002,0,0,0,0
25,48,256,48,48,448,0,10002,0,0,0,0
25,48,256,48,48,496,0,10002,0,0,0,0
25,48,256,48,48,544,0,10002,0,0,0,0
25,48,256,48,48,592,0,10002,0,0,0,0
25,80,288,16,16,432,80,10002,0,0,0,0
25,80,256,16,16,432,96,10002,0,0,0,0
24,464,112,16,16,448,272,10000,0,0,0,0
24,112,160,16,32,416,112,10000,0,0,0,0
24,464,288,32,32,32,128,10000,0,0,0,0
24,464,288,32,32,64,128,10000,0,0,0,0
24,464,288,32,32,96,128,10000,0,0,0,0
24,464,288,32,32,128,128,10000,0,0,0,0
24,464,288,32,32,160,128,10000,0,0,0,0
24,464,288,32,32,192,128,10000,0,0,0,0
24,464,288,32,32,224,128,10000,0,0,0,0
24,464,288,32,32,256,128,10000,0,0,0,0
24,464,288,32,32,288,128,10000,0,0,0,0
24,304,320,64,32,256,192,10000,0,0,0,0
24,208,320,32,32,208,176,10000,0,0,0,0
24,160,288,64,32,448,320,10000,0,0,0,0
24,528,64,32,32,208,272,10000,0,0,0,0
24,0,320,32,32,80,224,10000,0,0,0,0
24,0,320,32,32,112,240,10000,0,0,0,0
25,256,80,16,48,128,32,10002,0,0,0,0
25,256,80,16,48,16,32,10002,0,0,0,0
24,192,304,32,16,320,240,10000,0,0,0,0
24,192,304,32,16,352,352,10000,0,0,0,0
24,192,304,32,16,368,304,10000,0,0,0,0
24,192,304,32,16,368,336,10000,0,0,0,0
24,192,304,32,16,368,320,10000,0,0,0,0
24,464,288,32,32,192,752,10000,0,0,0,0
25,208,112,32,16,224,752,10002,0,0,0,0
25,208,112,32,16,192,752,10002,0,0,0,0
25,208,112,32,16,32,752,10002,0,0,0,0
24,464,128,32,16,400,736,10000,0,0,0,0
24,80,64,16,32,336,816,10000,0,0,0,0
24,64,32,16,16,336,800,10000,0,0,0,0
24,80,240,16,16,416,1216,10000,0,0,0,0
24,80,240,16,16,448,1216,10000,0,0,0,0
24,80,240,16,16,432,1216,10000,0,0,0,0
24,80,240,16,16,416,1184,10000,0,0,0,0
24,80,240,16,16,432,1184,10000,0,0,0,0
24,80,240,16,16,448,1184,10000,0,0,0,0
24,64,240,16,16,384,1216,10000,0,0,0,0
24,64,208,16,16,384,1184,10000,0,0,0,0
24,96,240,16,16,464,1216,10000,0,0,0,0
24,96,208,16,16,464,1184,10000,0,0,0,0
24,96,224,16,16,464,1200,10000,0,0,0,0
24,96,224,16,16,384,1200,10000,0,0,0,0
24,80,240,16,16,400,1184,10000,0,0,0,0
24,80,240,16,16,400,1216,10000,0,0,0,0
987654321
NC0JNlAAECB2Py1aO05fPxQlO1BBDjUCLCV7EVU0LBxyMzwjJWE/diE9YRs6HDd0STxgNw==
EA0rCUArEC1qJXkOJltBNVUoO1lAByRKEGt8WFwkdVU7ajQxbnExOC0kYQM3D3J2
FEhqQjQqWTolLmlHJ0Rfel0/O0xGG3BAHHZjWFs1ZQE9OHkxY2B0JGg0IB0gAGR3QyA0
DkgmCwsnECBxa3tLIVINN0EvcxhdEX4MVyV1AVtxZBQkL3k2cHoxbWE

