VVh6UkxxBnkpcyF9MkZEOVUgfhR+ESVQCnB+DFt9PFliZml8NTghenh/cQ==
160,32,48,0,0,16777215,0,0,0,1,256,0
178,664,256,0,144,32,0,0,0,0,223,0
178,711,256,0,448,32,0,0,0,0,77,1
178,608,312,0,256,32,0,0,0,0,226,0
178,456,312,0,48,32,0,0,0,0,229,0
178,752,312,0,32,32,0,0,0,0,217,0
178,824,304,0,32,32,0,0,0,0,215,0
178,840,312,0,32,32,0,0,0,0,214,0
178,856,328,0,32,32,0,0,0,0,209,0
178,872,344,0,32,32,0,0,0,0,208,0
178,1191,360,0,608,32,0,0,0,0,204,0
178,952,304,0,16,32,0,0,0,0,259,0
178,1400,288,0,96,32,0,0,0,0,180,0
178,1744,352,0,464,16,0,0,0,0,239,0
178,1576,128,0,16,32,0,0,0,0,251,0
178,1608,192,0,16,48,0,0,0,0,233,0
178,1688,232,0,144,32,0,0,0,0,232,0
178,1472,256,0,48,96,0,0,0,0,192,0
178,1568,232,0,96,32,0,0,0,0,187,0
178,1506,352,0,16,16,0,0,0,0,202,0
197,1840,80,0,1,0,0,0,0,1,289,0
197,160,48,0,1,0,0,0,0,1,285,0
197,448,296,0,1,0,0,0,0,1,290,0
188,1344,240,0,0,0,0,0,0,1,153,0
188,1360,240,0,0,0,0,0,0,1,154,0
188,1232,240,0,0,156,0,0,0,1,146,0
188,1264,240,0,0,158,0,0,0,1,148,0
188,1279,240,0,0,159,0,0,0,1,149,0
188,1248,240,0,0,157,0,0,0,1,147,0
188,1312,240,0,0,161,0,0,0,1,151,0
188,1328,240,0,0,162,0,0,0,1,152,0
188,1152,240,0,0,141,0,0,0,1,133,0
188,1216,240,0,0,155,0,0,0,1,137,0
188,1200,240,0,0,144,0,0,0,1,136,0
188,1136,240,0,0,140,0,0,0,1,132,0
188,1120,240,0,0,139,0,0,0,1,131,0
188,1168,240,0,0,142,0,0,0,1,134,0
188,1184,240,0,0,143,0,0,0,1,135,0
188,1056,240,0,0,122,0,0,0,1,118,0
188,1072,240,0,0,126,0,0,0,1,125,0
188,1088,240,0,0,127,0,0,0,1,128,0
188,1104,240,0,0,129,0,0,0,1,124,0
188,1296,240,0,0,0,160,0,0,1,150,0
242,476,295,0,32,32,0,0,0,1,264,0
242,960,280,0,32,32,0,0,0,1,263,0
242,1384,256,0,32,32,0,0,0,1,183,0
176,344,224,0,41,32,32,0,0,1,53,0
176,416,224,0,52,112,32,0,0,1,54,0
176,296,224,0,51,64,32,0,0,1,50,0
176,560,200,0,60,32,80,0,0,1,66,0
176,528,200,0,56,32,80,0,0,1,64,0
176,496,160,0,55,32,80,0,0,1,63,0
176,488,224,0,57,32,32,0,0,1,62,0
176,448,296,0,236,32,32,0,0,1,277,0
176,448,296,0,232,32,32,0,0,1,278,0
176,448,296,0,187,32,32,0,0,1,279,0
176,448,296,0,233,32,32,0,0,1,280,0
176,496,296,0,229,32,32,0,0,1,230,0
176,616,224,0,61,32,32,0,0,1,67,0
176,608,224,0,59,64,32,0,0,1,70,0
176,664,224,0,0,32,32,0,0,1,78,0
176,712,224,0,58,32,32,0,0,1,69,0
176,720,296,0,226,32,32,0,0,1,227,0
176,744,288,0,77,32,32,0,0,1,224,0
176,784,224,0,92,32,32,0,0,1,100,0
176,824,272,0,217,32,32,0,0,1,216,0
176,864,288,0,215,32,32,0,0,1,221,0
176,856,224,0,93,32,32,0,0,1,101,0
176,883,300,0,214,32,32,0,0,1,219,0
176,896,328,0,209,32,32,0,0,1,207,0
176,888,320,0,208,32,32,0,0,1,220,0
176,1368,256,0,180,32,32,0,0,1,181,0
176,1432,256,0,192,32,32,0,0,1,193,0
176,1472,328,0,204,32,32,0,0,1,205,0
176,1480,192,0,187,32,32,0,0,1,200,0
176,1512,264,0,202,32,32,0,0,1,203,0
176,1576,96,0,0,32,32,0,0,1,253,0
154,762.05,160,0,1,1.65,32,160,1,1,110,1
158,88,240,0,0,16744448,1,0,0,1,2,0
216,1512,200,0,5,1,0,0,0,1,270,0
216,1488,328,0,6,1,0,0,0,1,271,0
157,384,64,0,2032,32,0,0,0,1,112,0
157,128,256,0,272,32,0,0,0,1,13,0
157,296,256,0,64,32,0,0,0,1,51,1
157,336,256,0,16,32,0,0,0,1,41,1
157,408,256,0,128,32,0,0,0,1,52,1
157,480,256,0,16,32,0,0,0,1,57,0
157,496,256,0,16,32,0,0,0,1,55,0
157,544,256,0,80,32,0,0,0,1,56,0
157,640,248,0,112,16,0,0,0,1,60,0
157,592,264,0,16,16,0,0,0,1,59,0
157,648,263,0,160,16,0,0,0,1,61,0
157,704,248,0,48,16,0,0,0,1,58,0
157,832,248,0,208,16,0,0,0,1,92,1
157,832,264,0,208,16,0,0,0,1,93,1
157,976,248,0,16,16,0,0,0,1,95,1
157,1216,256,0,304,32,0,0,0,1,119,0
157,1008,248,0,16,16,0,0,0,1,97,1
157,1008,248,0,16,16,0,0,0,1,98,1
157,1056,256,0,16,32,0,0,0,1,120,0
157,1416,144,0,32,192,0,0,0,1,164,0
157,1496,64,0,128,32,0,0,0,1,185,0
155,8,160,0,1,1,0,0,0,1,108,0
155,1408,160,0,2,1,0,0,0,1,109,0
166,1080,88,0,0,0,270,0,0,0,122,0
166,1096,88,0,0,0,270,0,0,0,126,0
166,1112,88,0,0,0,270,0,0,0,127,0
166,1128,88,0,0,0,270,0,0,0,129,0
166,1144,88,0,0,0,270,0,0,0,139,0
166,1160,88,0,0,0,270,0,0,0,140,0
166,1176,88,0,0,0,270,0,0,0,141,0
166,1192,88,0,0,0,270,0,0,0,142,0
166,1208,88,0,0,0,270,0,0,0,143,0
166,1224,88,0,0,0,270,0,0,0,144,0
166,1240,88,0,0,0,270,0,0,0,155,0
166,1256,88,0,0,0,270,0,0,0,156,0
166,1272,88,0,0,0,270,0,0,0,157,0
166,1288,88,0,0,0,270,0,0,0,158,0
166,1304,88,0,0,0,270,0,0,0,159,0
166,1320,88,0,0,0,270,0,0,0,160,0
166,1336,88,0,0,0,270,0,0,0,161,0
166,1352,88,0,0,0,270,0,0,0,162,0
237,320,0,0,16777215,300,0,0,0,1,292,0
178,1768,217,0,16,208,0,0,0,0,236,0
178,1744,160,0,32,32,0,0,0,0,242,0
178,1872,88,0,176,16,0,0,0,0,248,0
178,1896,120,0,112,16,0,0,0,0,247,0
178,1896,304,0,32,32,0,0,0,0,244,0
242,1744,128,0,32,32,0,0,0,1,262,0
176,1744,200,0,239,32,32,0,0,1,238,0
176,1760,96,0,244,32,32,0,0,1,243,0
176,1831,328,0,259,32,32,0,0,1,258,0
176,1896,272,0,247,32,32,0,0,1,245,0
176,1921,108,0,248,32,32,0,0,1,249,0
176,1960,328,0,242,32,32,0,0,1,241,0
176,1976,128,0,251,32,32,0,0,1,250,0
176,1976,128,0,187,32,32,0,0,1,282,0
216,1960,288,0,5,1,0,0,0,1,267,0
216,1976,80,0,5,1,0,0,0,1,283,0
123,384,144,0,128,0,0,0,0,1,294,0
100,144,144,0,256,0,0,0,0,1,293,0
1234567890
25,112,144,368,144,368,96,10002,0,0,0,0
25,112,144,368,144,0,96,10002,0,0,0,0
25,112,144,368,144,752,96,10002,0,0,0,0
25,112,144,368,144,1120,96,10002,0,0,0,0
25,112,144,368,144,0,272,10002,0,0,0,0
25,112,144,368,144,368,272,10002,0,0,0,0
25,592,336,32,16,1104,304,10002,0,0,0,0
25,592,336,32,16,1216,288,10002,0,0,0,0
25,592,336,32,16,1088,320,10002,0,0,0,0
25,592,336,32,16,1136,304,10002,0,0,0,0
25,592,336,32,16,1120,320,10002,0,0,0,0
25,592,336,32,16,1152,320,10002,0,0,0,0
25,592,336,32,16,1200,352,10002,0,0,0,0
25,592,336,32,16,1152,352,10002,0,0,0,0
25,592,336,32,16,1472,352,10002,0,0,0,0
25,592,336,32,16,1504,304,10002,0,0,0,0
25,592,336,32,16,1152,336,10002,0,0,0,0
25,592,336,32,16,1216,336,10002,0,0,0,0
25,592,336,32,16,1392,336,10002,0,0,0,0
25,592,336,32,16,1264,336,10002,0,0,0,0
25,592,336,32,16,1296,336,10002,0,0,0,0
25,592,336,32,16,1296,352,10002,0,0,0,0
25,592,336,32,16,1264,352,10002,0,0,0,0
25,592,336,32,16,1488,320,10002,0,0,0,0
25,592,336,32,16,1440,336,10002,0,0,0,0
25,592,336,32,16,1392,352,10002,0,0,0,0
25,592,336,32,16,1344,352,10002,0,0,0,0
25,592,336,32,16,1344,336,10002,0,0,0,0
25,592,336,32,16,1504,256,10002,0,0,0,0
25,592,336,32,16,1440,288,10002,0,0,0,0
25,592,336,32,16,1280,256,10002,0,0,0,0
25,592,336,32,16,1312,256,10002,0,0,0,0
25,592,336,32,16,1424,272,10002,0,0,0,0
25,592,336,32,16,1296,272,10002,0,0,0,0
25,592,336,32,16,1424,256,10002,0,0,0,0
25,592,336,32,16,1488,272,10002,0,0,0,0
25,592,336,32,16,1520,272,10002,0,0,0,0
25,592,336,32,16,1520,288,10002,0,0,0,0
25,592,336,32,16,1488,288,10002,0,0,0,0
25,592,336,32,16,1376,272,10002,0,0,0,0
25,592,336,32,16,1248,304,10002,0,0,0,0
25,592,336,32,16,1376,288,10002,0,0,0,0
25,592,336,32,16,1296,304,10002,0,0,0,0
25,592,336,32,16,1248,288,10002,0,0,0,0
25,592,336,32,16,1072,288,10002,0,0,0,0
25,592,336,32,16,1056,272,10002,0,0,0,0
25,592,336,32,16,1104,272,10002,0,0,0,0
25,592,336,32,16,1104,288,10002,0,0,0,0
25,592,336,32,16,1136,288,10002,0,0,0,0
25,592,336,32,16,1184,272,10002,0,0,0,0
25,592,336,32,16,1184,288,10002,0,0,0,0
25,592,336,32,16,1200,304,10002,0,0,0,0
25,592,336,32,16,1216,320,10002,0,0,0,0
25,592,336,32,16,1264,320,10002,0,0,0,0
25,592,336,32,16,1328,320,10002,0,0,0,0
25,592,336,32,16,1360,320,10002,0,0,0,0
25,592,336,32,16,1392,320,10002,0,0,0,0
25,592,336,32,16,1424,320,10002,0,0,0,0
25,592,336,32,16,1408,304,10002,0,0,0,0
25,592,336,32,16,1328,272,10002,0,0,0,0
987654321
FCkHKyMDfAw=
JCcFLg==
JSEFQg==
Ki0J

