UVx6TlN0AGU9Z2ZBIFhAO1oiKgEbR3wSSTQ7SBJhIEV+enVgKSQ9Zg==
259,200,304,0,32,32,0,0,0,1,93,0
259,232,304,0,32,32,0,0,0,1,109,0
259,248,304,0,32,32,0,0,0,1,243,0
160,86,256,0,0,16777215,0,0,0,1,180,0
123,464,128,0,100,0,0,0,0,1,191,0
123,285,64,0,128,0,0,0,0,1,207,0
123,424,224,0,128,0,0,0,0,1,230,0
123,212,208,0,80,0,0,0,0,1,244,0
197,528,320,0,4,175,0,0,0,1,220,0
197,392,320,0,4,0,0,0,0,1,225,0
174,539,88,0,1,157,0,0,0,0,245,1
174,344,320,0,1,240,0,0,0,0,242,1
174,119,258,0,1,94,0,0,0,1,64,1
174,104,107,0,1,212,0,0,0,0,148,1
205,378.60,120,0,1,0,0.30,0,0,1,134,0
194,304,256,0,0,128,0,0,0,1,202,0
194,496,208,0,0,128,0,0,0,1,217,0
186,416,46,0,32,32,0,0,0,1,152,0
188,305,138,0,0,113,0,0,0,1,116,0
185,544,128,0,0,32,1,0,0,1,139,0
185,496,160,0,0,16,1,0,0,1,140,0
185,256,160,0,0,32,1,0,0,1,185,0
185,160,128,0,0,32,1,0,0,1,186,0
242,520,72,0,32,32,0,0,0,1,235,0
154,246.50,88,0,2,0.50,32,16,1,1,144,1
154,337,128,0,1,0.50,160,16,1,1,173,1
158,72,256,0,0,16777215,0,1,0,1,63,0
210,361,32,0,89,180,0,0,0,1,90,0
210,184,301,0,66,270,0,0,0,1,67,0
210,225,287,0,90,180,0,0,0,1,89,0
210,152,301,0,67,90,0,0,0,1,66,0
157,40,48,0,32,32,0,0,0,1,72,0
157,40,80,0,32,32,0,0,0,1,2,0
157,40,112,0,32,32,0,0,0,1,3,0
157,40,144,0,32,32,0,0,0,1,4,0
157,40,176,0,32,32,0,0,0,1,5,0
157,40,208,0,32,32,0,0,0,1,6,0
157,40,240,0,32,32,0,0,0,1,7,0
157,40,272,0,32,32,0,0,0,1,8,0
157,40,304,0,32,32,0,0,0,1,9,0
157,40,336,0,32,32,0,0,0,1,10,0
157,72,336,0,32,32,0,0,0,1,11,0
157,104,336,0,32,32,0,0,0,1,12,0
157,136,336,0,32,32,0,0,0,1,13,0
157,168,336,0,32,32,0,0,0,1,14,0
157,200,336,0,32,32,0,0,0,1,15,0
157,232,336,0,32,32,0,0,0,1,16,0
157,264,336,0,32,32,0,0,0,1,17,0
157,296,336,0,32,32,0,0,0,1,18,0
157,328,336,0,32,32,0,0,0,1,19,0
157,360,336,0,32,32,0,0,0,1,20,0
157,392,336,0,32,32,0,0,0,1,21,0
157,424,336,0,32,32,0,0,0,1,22,0
157,456,336,0,32,32,0,0,0,1,23,0
157,488,336,0,32,32,0,0,0,1,24,0
157,520,336,0,32,32,0,0,0,1,25,0
157,552,336,0,32,32,0,0,0,1,26,0
157,584,336,0,32,32,0,0,0,1,27,0
157,584,304,0,32,32,0,0,0,1,28,0
157,584,240,0,32,32,0,0,0,1,29,0
157,584,272,0,32,32,0,0,0,1,30,0
157,584,208,0,32,32,0,0,0,1,31,0
157,584,176,0,32,32,0,0,0,1,32,0
157,584,144,0,32,32,0,0,0,1,33,0
157,584,112,0,32,32,0,0,0,1,34,0
157,328,16,0,32,32,0,0,0,1,35,0
157,584,80,0,32,32,0,0,0,1,36,0
157,584,16,0,32,32,0,0,0,1,37,0
157,552,16,0,32,32,0,0,0,1,38,0
157,584,48,0,32,32,0,0,0,1,39,0
157,520,16,0,32,32,0,0,0,1,40,0
157,456,16,0,32,32,0,0,0,1,41,0
157,392,16,0,32,32,0,0,0,1,43,0
157,360,16,0,32,32,0,0,0,1,44,0
157,488,16,0,32,32,0,0,0,1,45,0
157,72,16,0,32,32,0,0,0,1,46,0
157,104,16,0,32,32,0,0,0,1,47,0
157,168,16,0,32,32,0,0,0,1,48,0
157,136,16,0,32,32,0,0,0,1,49,0
157,264,16,0,32,32,0,0,0,1,50,0
157,232,16,0,32,32,0,0,0,1,51,0
157,200,16,0,32,32,0,0,0,1,52,0
157,296,16,0,32,32,0,0,0,1,53,0
157,40,16,0,32,32,0,0,0,1,54,0
157,161,216,0,32,32,0,0,0,1,56,0
157,168,304,0,32,32,0,0,0,1,57,0
157,161,248,0,32,32,0,0,0,1,58,0
157,168,272,0,32,32,0,0,0,1,61,0
157,72,274,0,32,32,0,0,0,1,75,0
157,96,274,0,32,32,0,0,0,1,76,0
157,160,274,0,32,32,0,0,0,1,77,0
157,200,272,0,32,32,0,0,0,1,80,0
157,232,272,0,32,32,0,0,0,1,84,0
157,264,272,0,32,32,0,0,0,1,85,0
157,104,115,0,32,16,0,0,0,1,141,0
157,394,40,0,16,16,0,0,0,1,153,0
157,394,56,0,16,16,0,0,0,1,154,0
157,448,40,0,16,16,0,0,0,1,155,0
157,448,56,0,16,16,0,0,0,1,156,0
157,438,32,0,8,64,0,0,0,1,159,0
157,512,96,0,64,16,0,0,0,1,164,0
157,56,192,0,32,8,0,0,0,1,196,0
157,128,192,0,32,8,0,0,0,1,201,0
157,368,263,0,64,16,0,0,0,1,218,0
157,488,264,0,64,16,0,0,0,1,219,0
172,113,259,0,0,0,0,0,0,1,94,1
155,168,88,0,1,2,0,0,0,1,142,0
155,248,88,0,2,2,0,0,0,1,143,0
172,402,48,0,0,0,0,0,0,1,157,1
155,304,128,0,1,1,0,0,0,1,171,0
155,440,128,0,2,1,0,0,0,1,172,0
169,264,288,0,0,0,0,0,0,1,240,1
166,240,107,0,0,0,0,0,0,1,113,1
166,56,208,0,0,0,0,0,0,1,175,0
166,256,200,0,0,0,270,0,0,1,212,1
237,320,0,0,16777215,300,0,0,0,1,99,0
1234567890
24,144,48,16,64,112,176,10000,0,0,0,0
25,272,256,64,48,48,32,10002,0,0,0,0
25,272,256,64,48,112,32,10002,0,0,0,0
25,272,256,64,48,176,32,10002,0,0,0,0
25,272,256,64,48,240,32,10002,0,0,0,0
25,272,256,64,48,304,32,10002,0,0,0,0
25,272,256,64,48,368,32,10002,0,0,0,0
25,272,256,64,48,432,32,10002,0,0,0,0
25,272,256,64,48,48,176,10002,0,0,0,0
25,272,256,64,48,48,80,10002,0,0,0,0
25,272,256,64,48,48,128,10002,0,0,0,0
25,272,256,64,48,112,176,10002,0,0,0,0
25,272,256,64,48,176,176,10002,0,0,0,0
25,272,256,64,48,240,176,10002,0,0,0,0
25,272,256,64,48,304,176,10002,0,0,0,0
25,272,256,64,48,368,176,10002,0,0,0,0
25,272,256,64,48,432,176,10002,0,0,0,0
25,272,256,64,48,496,176,10002,0,0,0,0
25,272,256,16,48,560,176,10002,0,0,0,0
25,272,256,64,48,496,32,10002,0,0,0,0
25,272,256,16,48,560,32,10002,0,0,0,0
25,272,96,64,48,112,80,10002,0,0,0,0
25,272,96,64,48,176,128,10002,0,0,0,0
25,272,96,64,48,304,128,10002,0,0,0,0
25,272,96,64,48,432,128,10002,0,0,0,0
25,272,96,64,48,496,80,10002,0,0,0,0
25,272,96,16,48,560,128,10002,0,0,0,0
25,400,48,64,48,176,80,10002,0,0,0,0
25,400,48,64,48,112,128,10002,0,0,0,0
25,400,48,64,48,240,128,10002,0,0,0,0
25,400,48,64,48,368,128,10002,0,0,0,0
25,400,48,64,48,496,128,10002,0,0,0,0
25,400,48,64,48,432,80,10002,0,0,0,0
25,16,240,16,16,16,240,10002,0,0,0,0
25,272,96,64,48,240,80,10002,0,0,0,0
25,272,96,64,48,368,80,10002,0,0,0,0
25,400,96,64,48,304,80,10002,0,0,0,0
24,528,64,32,32,496,96,10000,0,0,0,0
24,512,224,32,64,496,128,10000,0,0,0,0
24,112,160,16,32,496,288,10000,0,0,0,0
24,64,16,64,16,48,80,10000,0,0,0,0
24,496,304,64,32,176,96,10000,0,0,0,0
24,496,304,64,32,80,128,10000,0,0,0,0
24,496,304,64,32,272,128,10000,0,0,0,0
24,496,0,64,32,224,224,10000,0,0,0,0
24,496,0,64,32,416,288,10000,0,0,0,0
987654321
EQ04ERUhWA==

VA==

