UVx6TlN0AGU9Z2ZBIFhAO1oiKgEbR3wSSTY7SBJhIEV+enVgKSQ9Zg==
259,152,132,0,144,48,0,0,0,1,107,0
259,168,184,0,112,48,0,0,0,1,121,0
160,568,272,0,0,16777215,0,0,0,1,80,0
100,235,5,0,164,8388863,0,318,0,1,28,0
100,635,10,0,568,0,0,245,0,0,62,0
100,90,114,0,312,65535,0,327,0,1,108,0
195,288,4,0,0,68,241,0,31,1,26,0
100,424,6,0,548,0,0,348,0,1,61,0
100,224,228,0,256,16744703,0,270,0,1,239,0
100,270,76,0,516,16744576,0,324,0,1,92,0
100,272,228,0,256,1838251,0,270,0,1,241,0
123,399,206,0,180,16744576,0,0,0,1,447,0
123,176,184,0,128,0,0,0,0,1,122,0
197,273,260,0,2,0,0,0,0,1,229,0
197,225,260,0,2,0,0,0,0,1,222,0
197,624,144,0,2,0,0,0,0,1,79,0
197,387,116,0,2,0,0,0,0,1,84,0
197,112,156,0,2,0,0,0,0,1,112,0
174,178,64,0,1,23,0,0,0,0,22,1
174,528,31,0,1,41,61,62,0,0,51,1
174,626,103,0,1,55,0,0,0,0,66,1
174,158,155,0,1,114,0,0,0,0,113,1
174,40,64,0,1,9,0,0,0,0,8,1
174,128,204,0,1,129,136,0,0,0,135,1
174,171,261,0,1,129,136,71,0,0,315,1
181,490,102,0,71,128,0,0,0,1,74,0
205,95.50,64,0,1,0,0.50,0,0,1,6,0
194,608,176,0,0,128,0,0,0,1,55,0
194,240,304,0,0,128,0,0,0,1,467,0
194,528,320,0,0,128,0,0,0,1,468,0
188,200,280,0,0,141,0,0,0,1,150,0
188,296,280,0,0,143,0,0,0,1,153,0
188,248,281,0,0,139,0,0,0,1,152,0
185,264,144,0,0,16,1,0,0,1,106,0
242,312,48,0,32,32,0,0,0,1,56,0
242,622,132,0,32,32,0,0,0,1,85,0
242,352,96,0,32,32,0,0,0,1,373,0
242,192,136,0,32,32,0,0,0,1,374,0
176,552,88,0,55,32,32,0,0,1,67,0
176,392,96,0,35,32,32,0,0,1,284,0
176,352,48,0,41,32,32,0,0,1,38,0
176,192,88,0,146,32,32,0,0,1,353,0
176,160,88,0,33,32,32,0,0,1,341,0
176,192,136,0,6,32,32,0,0,1,294,0
176,197,141,0,6,32,32,0,0,1,405,0
176,128,136,0,71,32,32,0,0,1,304,0
176,133,141,0,71,32,32,0,0,1,406,0
176,80,48,0,69,32,32,0,0,1,362,0
176,520,256,0,453,32,32,0,0,1,452,0
176,456,254,0,451,32,32,0,0,1,450,0
176,461,261,0,457,32,32,0,0,1,456,0
176,141,253,0,147,32,32,0,0,1,426,0
176,136,248,0,146,32,32,0,0,1,416,0
176,397,261,0,454,32,32,0,0,1,455,0
176,392,256,0,449,32,32,0,0,1,448,0
154,266,54,0,1,7,16,16,-1,1,35,1
154,392,71,0,2,1,48,8,1,0,41,1
154,428,102,0,3,0.75,16,16,-1,1,71,1
154,168,273,0,4,0.50,16,8,1,1,148,1
158,16,64,0,0,16777215,0,1,0,1,2,0
210,216,147,0,0,90,0,0,0,1,102,0
210,216,130,0,0,90,0,0,0,1,101,0
210,303,117,0,102,0,0,0,0,1,97,0
210,287,116,0,101,0,0,0,0,1,363,0
157,39,68,0,80,8,0,0,0,1,5,0
157,56,47,0,8,32,0,0,0,1,3,0
157,151,68,0,80,8,0,0,0,1,11,0
157,152,104,0,144,8,0,0,0,1,14,0
157,372,113,0,8,16,0,0,0,1,16,0
157,220,8,0,8,32,0,0,0,1,17,0
157,220,76,0,8,48,0,0,0,1,18,0
157,296,71,0,144,8,0,0,0,1,19,0
157,178,264,0,256,8,0,0,0,1,21,0
157,584,148,0,112,8,0,0,0,1,45,0
157,600,107,0,80,8,0,0,0,1,46,0
157,520,35,0,96,8,0,0,0,1,47,0
157,431,0,0,416,8,0,0,0,1,27,0
157,416,120,0,96,8,0,0,0,1,78,0
157,192,209,0,64,8,0,0,0,1,89,0
157,112,160,0,64,8,0,0,0,1,90,0
157,320,120,0,96,8,0,0,0,1,91,0
157,116,184,0,8,48,0,0,0,1,98,0
157,220,132,0,8,48,0,0,0,1,99,0
157,84,132,0,8,48,0,0,0,1,100,0
157,200,160,0,48,8,0,0,0,1,116,0
157,219,204,0,8,16,0,0,0,1,128,0
157,116,209,0,8,8,0,0,0,1,138,0
157,249,216,0,112,24,0,0,0,1,182,0
157,156,209,0,8,8,0,0,0,1,375,0
157,200,0,0,32,16,0,0,0,1,395,0
157,40,208,0,32,16,0,0,0,1,436,0
157,488,280,0,288,16,0,0,0,1,446,0
172,79,64,0,0,0,0,0,0,1,9,1
169,216,24,0,0,0,0,0,0,1,23,1
155,266,54,0,1,1,0,0,0,0,33,0
155,352,54,0,2,1,0,0,0,1,34,0
155,392,71,0,1,2,0,0,0,1,39,0
155,601,71,0,2,2,0,0,0,1,40,0
155,428,102,0,1,3,0,0,0,0,69,0
155,520,102,0,2,3,0,0,0,1,70,0
155,520,166,0,3,3,0,0,0,1,73,0
172,144,155,0,0,0,0,0,0,1,114,1
169,209,164,0,0,0,0,0,0,0,129,1
172,120,205,0,1,0,0,0,0,1,136,1
169,241,228,0,0,0,0,0,0,1,139,1
169,193,228,0,0,0,0,0,0,1,141,1
169,289,228,0,0,0,0,0,0,1,143,1
155,168,273,0,1,4,0,0,0,0,146,0
155,328,273,0,2,4,0,0,0,0,147,0
166,344,10,0,0,35,224,0,0,0,31,1
166,352,176,0,0,0,270,0,0,0,449,1
166,416,176,0,0,0,270,0,0,0,451,1
166,480,176,0,0,0,270,0,0,0,453,1
166,308,216,0,0,0,0,0,0,0,454,1
166,608,176,0,0,0,270,0,0,0,457,1
237,320,0,0,16777215,300,0,0,0,1,7,0
1234567890
25,272,80,64,64,0,0,10002,0,0,0,0
25,272,80,64,64,64,0,10002,0,0,0,0
25,272,80,64,64,128,0,10002,0,0,0,0
25,272,80,64,64,192,0,10002,0,0,0,0
25,272,80,64,64,256,0,10002,0,0,0,0
25,272,80,64,64,320,0,10002,0,0,0,0
25,272,80,64,64,384,0,10002,0,0,0,0
25,272,80,64,64,448,0,10002,0,0,0,0
25,272,80,64,64,512,0,10002,0,0,0,0
25,272,80,64,64,576,0,10002,0,0,0,0
24,464,64,32,16,576,80,10000,0,0,0,0
25,560,304,32,32,320,64,10002,0,0,0,0
25,560,304,32,32,352,64,10002,0,0,0,0
25,560,304,32,32,384,64,10002,0,0,0,0
25,560,304,32,32,416,64,10002,0,0,0,0
25,560,304,32,32,448,64,10002,0,0,0,0
25,560,304,32,32,480,64,10002,0,0,0,0
25,560,304,32,32,512,64,10002,0,0,0,0
25,560,304,32,32,544,64,10002,0,0,0,0
25,560,304,32,32,576,64,10002,0,0,0,0
25,560,304,32,32,608,64,10002,0,0,0,0
25,560,304,32,32,608,96,10002,0,0,0,0
25,560,304,32,32,576,96,10002,0,0,0,0
25,560,304,32,32,544,96,10002,0,0,0,0
25,560,304,32,32,512,96,10002,0,0,0,0
25,560,304,32,32,480,96,10002,0,0,0,0
25,560,304,32,32,448,96,10002,0,0,0,0
25,560,304,32,32,416,96,10002,0,0,0,0
25,560,304,32,32,384,96,10002,0,0,0,0
25,560,304,32,32,352,96,10002,0,0,0,0
25,560,304,32,32,320,96,10002,0,0,0,0
25,560,304,32,32,288,96,10002,0,0,0,0
25,560,304,32,32,256,96,10002,0,0,0,0
25,560,304,32,32,224,96,10002,0,0,0,0
25,560,304,32,32,224,64,10002,0,0,0,0
25,560,304,32,32,256,64,10002,0,0,0,0
25,560,304,32,32,288,64,10002,0,0,0,0
25,464,0,32,48,80,112,10002,0,0,0,0
25,464,0,32,48,112,112,10002,0,0,0,0
25,464,0,32,48,144,112,10002,0,0,0,0
25,464,0,32,48,176,112,10002,0,0,0,0
25,464,0,32,48,80,64,10002,0,0,0,0
25,464,0,32,48,112,64,10002,0,0,0,0
25,464,0,32,48,144,64,10002,0,0,0,0
25,464,0,32,48,176,64,10002,0,0,0,0
25,480,0,16,48,208,64,10002,0,0,0,0
25,480,0,16,48,208,112,10002,0,0,0,0
25,464,48,32,48,48,112,10002,0,0,0,0
25,464,48,32,48,48,64,10002,0,0,0,0
25,464,48,32,48,16,64,10002,0,0,0,0
25,464,48,32,48,16,112,10002,0,0,0,0
25,464,48,16,48,0,64,10002,0,0,0,0
25,464,48,16,48,0,112,10002,0,0,0,0
25,560,304,32,16,528,128,10002,0,0,0,0
25,560,304,32,16,560,128,10002,0,0,0,0
25,560,304,32,16,592,128,10002,0,0,0,0
25,560,304,32,16,624,128,10002,0,0,0,0
24,336,16,16,16,160,128,10000,0,0,0,0
24,336,16,16,16,160,144,10000,0,0,0,0
24,336,16,16,16,160,160,10000,0,0,0,0
24,336,16,16,16,160,176,10000,0,0,0,0
24,336,16,16,16,160,192,10000,0,0,0,0
987654321
EQ04ERUhWA==

VA==

