UVx6TlN0AGU9Z2ZBIFhAO1oiNwgeSnwTVTU7SBJhIEV+enVg
160,40,353,0,0,16777215,0,0,0,1,45,0
100,120,8,0,280,0,0,323,0,1,98,0
100,632,128,0,276,65280,0,237,0,1,74,0
100,472,8,0,348,0,0,226,0,1,220,0
100,488,61,0,372,4259584,0,180,25,1,30,0
100,488,61,0,376,65535,0,270,25,1,31,0
100,488,61,0,388,16744703,0,0,25,1,29,0
100,488,61,0,380,16711680,0,90,25,1,32,0
123,361,42,0,116,0,0,0,0,1,38,0
123,594,272,0,124,16744703,126,0,0,1,128,0
197,416,88,0,2,0,0,0,0,1,35,0
197,318,353,0,2,0,0,0,0,1,144,0
197,256,304,0,2,0,0,0,0,1,130,0
174,56,88,0,1,5,3,0,0,0,9,1
174,240,304,0,1,132,0,0,0,0,131,1
174,360,168,0,1,108,0,0,0,0,110,1
174,192,248,0,1,142,200,0,0,0,141,1
181,200,144,0,0,128,0,0,0,1,94,0
194,472,288,0,0,128,0,0,0,1,69,0
181,624,19,0,0,360,262,0,0,1,211,0
205,340,87,0,-1,0,0.50,0,0,1,15,0
181,464,240,0,0,128,181,0,0,1,192,0
186,549,168,0,32,32,0,0,0,1,114,0
188,576,200,0,0,111,0,0,0,1,115,0
242,320,336,0,32,32,0,0,0,1,106,0
176,240,344,0,49,32,32,0,0,1,58,0
176,240,344,0,50,32,32,0,0,1,59,0
176,240,344,0,55,32,32,0,0,1,57,0
176,128,48,0,78,32,80,0,0,1,80,0
176,408,152,0,113,32,32,0,0,1,116,0
176,408,152,0,93,32,32,0,0,1,117,0
176,424,72,0,42,32,32,0,0,1,84,0
176,208,336,0,47,32,32,0,0,1,89,0
176,248,336,0,51,48,32,0,0,1,60,0
154,488,63.50,0,1,2.50,32,32,-1,1,25,1
154,8,280,0,2,0.50,48,16,1,0,55,1
154,596.50,272,0,3,2.50,16,16,-1,1,126,1
158,16,88,0,0,16777215,0,1,0,1,2,0
216,144,64,0,7,0,0,0,0,1,41,0
216,360,120,0,52,0,0,0,0,1,163,0
216,240,272,0,56,0,0,0,0,1,165,0
216,256,272,0,55,0,0,0,0,1,176,0
216,416,56,0,53,0,0,0,0,1,164,0
216,480,156,0,7,0,0,0,0,0,113,0
216,480,128,0,19,1,0,0,0,0,93,0
216,480,48,0,2,0,1,0,0,0,42,0
216,336,330,0,58,0,0,0,0,1,168,0
216,128,320,0,77,1,0,0,0,0,47,0
216,192,200,0,57,0,0,0,0,1,166,0
216,224,64,0,1,1,0,0,0,0,78,0
216,32,32,0,20,0,0,0,0,1,161,0
216,72,72,0,51,0,0,0,0,1,162,0
216,576,176,0,54,0,0,0,0,1,184,0
216,328,248,0,4,1,0,0,0,0,79,0
157,80,176,0,176,176,0,0,0,1,11,0
157,368,96,0,144,16,0,0,0,1,14,0
157,416,176,0,256,16,0,0,0,1,16,0
157,392,80,0,16,16,0,0,0,1,33,0
157,312,357,0,656,8,0,0,0,1,64,0
157,312,312,0,272,16,0,0,0,1,65,0
157,544,208,0,192,16,0,0,0,1,73,0
157,199,256,0,48,16,0,0,0,1,102,0
157,400,120,0,16,32,0,0,0,1,107,0
157,208,264,0,16,16,0,0,0,1,134,0
157,96,8,0,16,32,0,0,0,1,145,0
169,88,56,0,1,0,0,0,0,1,3,1
169,88,24,0,0,0,0,0,0,1,5,1
155,240,56,0,1,1,0,0,0,1,23,0
155,240,136,0,2,1,0,0,0,1,24,0
155,488,136,0,3,1,0,0,0,1,27,0
155,488,56,0,4,1,0,0,0,1,28,0
155,8,280,0,1,2,0,0,0,1,53,0
155,192,280,0,2,2,0,0,0,1,54,0
169,392,136,0,0,0,0,0,0,1,108,1
169,544,168,0,0,0,0,0,0,1,111,1
155,464,272,0,1,3,0,0,0,1,124,0
155,608,272,0,2,3,0,0,0,1,125,0
169,200,272,0,0,0,0,0,0,1,132,1
169,272,320,0,0,0,0,0,0,1,142,1
169,408,320,0,0,0,0,0,0,1,200,1
166,104,264,0,0,0,270,0,0,0,49,1
166,128,264,0,0,0,270,0,0,0,50,1
166,152,264,0,0,0,270,0,0,0,51,1
176,320,248,0,79,256,112,0,0,1,85,0
1234567890
25,0,0,96,96,0,0,10002,0,0,0,0
25,0,0,96,96,96,0,10002,0,0,0,0
25,0,0,96,96,192,0,10002,0,0,0,0
25,0,0,96,96,288,0,10002,0,0,0,0
25,0,0,96,96,384,0,10002,0,0,0,0
25,0,0,96,96,480,0,10002,0,0,0,0
25,0,0,96,96,576,0,10002,0,0,0,0
25,0,0,96,96,144,96,10002,0,0,0,0
25,0,0,96,96,240,96,10002,0,0,0,0
25,0,0,96,96,336,96,10002,0,0,0,0
25,0,0,96,96,432,96,10002,0,0,0,0
25,0,0,96,96,528,96,10002,0,0,0,0
25,0,0,96,96,624,96,10002,0,0,0,0
25,0,0,96,96,96,192,10002,0,0,0,0
25,0,0,96,96,192,192,10002,0,0,0,0
25,0,0,96,96,0,192,10002,0,0,0,0
25,0,0,96,96,480,192,10002,0,0,0,0
25,0,0,96,96,576,192,10002,0,0,0,0
25,0,0,96,96,528,288,10002,0,0,0,0
25,0,0,96,96,624,288,10002,0,0,0,0
25,0,0,96,96,432,288,10002,0,0,0,0
25,0,0,96,96,144,288,10002,0,0,0,0
25,0,0,96,96,48,288,10002,0,0,0,0
25,48,0,48,96,0,288,10002,0,0,0,0
25,0,0,96,96,0,96,10002,0,0,0,0
25,48,0,48,96,96,96,10002,0,0,0,0
25,0,0,48,96,288,192,10002,0,0,0,0
25,48,0,48,96,336,192,10002,0,0,0,0
25,0,0,96,96,384,192,10002,0,0,0,0
25,0,0,96,96,240,288,10002,0,0,0,0
25,0,0,96,96,336,288,10002,0,0,0,0
987654321
LkgrD0AjEC53Lmxac01MNBQjfRhdCjVDFXF/WFwwfwEzOD0=
FwQvAwMnECpqJmBLPV8NN01sd11YGzwCEGM3AVEkLAIzJC1wZGA=
DAc5EQ0jXictL2JaekxIPEYpfktuGCJHHGtyDBY1YwF7Ljw=
EwArDAsx

