UVx6TlN0AGU9Z2ZBIFhAO1oiN3pcHzlMKnB0E1sjIEV+enVgKSQ9ZmRjbV8=
259,600,360,0,80,16,0,0,0,1,36,0
259,360,360,0,80,16,0,0,0,1,37,0
160,188,350,0,0,16777215,0,0,0,1,1038,0
100,493,176,0,512,16744703,0,270,0,1,194,0
100,640,103,0,384,255,0,180,0,0,1145,0
100,8,16,0,256,16744703,0,296,0,1,1915,0
100,463,72,0,284,16744576,0,270,0,0,1255,0
100,640,24,0,448,0,0,180,0,1,2626,0
100,595,24,0,480,8454143,0,180,2096,0,2072,0
123,98,221,0,164,65535,0,0,0,0,259,0
100,228,144,0,652,16711680,0,270,249,0,202,0
100,368,176,0,460,4259584,0,235,0,1,199,0
197,520,280,0,6,0,0,0,0,1,56,0
197,24,112,0,2,388,0,0,0,1,1952,0
197,576,99,0,2,1983,0,0,0,1,703,0
197,464,280,0,2,43,0,0,0,1,42,0
197,496,50,0,2,2120,0,0,0,1,2045,0
174,265,232,0,1,30,31,62,63,0,52,1
205,608.50,152,0,1,0,0.40,0,0,1,710,0
205,490,280,0,1,0,0.50,0,0,1,24,0
181,136,24,0,0,128,224,0,0,1,1953,0
194,631.50,24,0,0,152,0,0,0,1,2145,0
205,138,352,0,1,0,1,0,0,1,82,0
186,248,352,0,32,32,0,0,0,1,23,0
186,304,352,0,32,32,0,0,0,1,46,0
186,512,152,0,32,32,0,0,0,1,308,0
186,440,152,0,32,32,0,0,0,1,309,0
188,638,270,0,90,6,0,0,0,1,18,0
188,382,197,0,0,827,817,0,0,1,845,0
188,48,352,0,0,1075,1077,1061,1051,1,78,0
188,448,352,0,0,7,30,0,0,1,26,0
188,520,152,0,0,859,1668,0,0,1,854,0
188,33,352,0,0,240,83,0,0,1,1111,0
242,224,264,0,32,32,0,0,0,1,1265,0
242,240,216,0,32,32,0,0,0,1,2662,0
242,389,184,0,32,32,0,0,0,1,2699,0
242,98,153,0,32,32,0,0,0,1,2760,0
242,291,89,0,32,32,0,0,0,1,2785,0
242,448,32,0,32,32,0,0,0,1,2798,0
176,232,88,0,194,48,48,0,0,1,287,0
176,232,88,0,1255,48,48,0,0,1,1651,0
176,232,88,0,199,48,48,0,0,1,277,0
176,232,88,0,2072,48,48,0,0,1,2650,0
176,232,88,0,859,48,48,0,0,1,1690,0
176,232,88,0,1145,48,48,0,0,1,1679,0
176,496,32,0,2094,32,32,0,0,1,2157,0
176,104,320,0,259,48,64,0,0,1,274,0
176,104,320,0,202,48,64,0,0,1,273,0
176,176,152,0,0,32,32,0,0,1,1852,0
154,600,288,0,1,0.75,80,16,1,1,8,1
154,360,288,0,2,0.75,80,16,1,1,32,1
154,96,295.50,0,3,0.50,64,16,1,1,64,1
154,230,144,0,4,2,32,16,-1,1,249,1
154,72,120,0,5,0.50,64,16,1,1,1985,1
154,595,24,0,6,1.50,64,16,-1,1,2096,1
158,276,352,0,0,16777215,0,1,0,1,2,0
157,224,356,0,192,8,0,0,0,1,12,0
157,480,288,0,160,16,0,0,0,1,20,0
157,480,356,0,160,8,0,0,0,1,28,0
157,288,288,0,64,16,0,0,0,1,40,0
157,264,256,0,16,48,0,0,0,1,41,0
157,232,240,0,48,16,0,0,0,1,53,0
157,168,240,0,80,16,0,0,0,1,59,0
157,19,359,0,64,16,0,0,0,1,68,0
157,56,240,0,16,16,0,0,0,1,69,0
157,56,360,0,16,16,0,0,0,1,73,0
157,8,240,0,32,16,0,0,0,1,74,0
157,153,176,0,16,16,0,0,0,1,176,0
157,95,176,0,16,16,0,0,0,1,181,0
157,124,176,0,16,16,0,0,0,1,182,0
157,66,176,0,16,16,0,0,0,1,184,0
157,8,176,0,16,16,0,0,0,1,185,0
157,182,176,0,16,16,0,0,0,1,190,0
157,264,176,0,16,16,0,0,0,1,191,0
157,264,136,0,16,64,0,0,0,1,232,0
157,37,176,0,16,16,0,0,0,1,237,0
157,320,160,0,96,16,0,0,0,1,305,0
157,368,58,0,224,16,0,0,0,1,347,0
157,560,58,0,160,16,0,0,0,1,370,0
157,464,160,0,128,16,0,0,0,1,410,0
157,600,160,0,96,16,0,0,0,1,411,0
157,304,112,0,64,16,0,0,0,1,418,0
157,421,99,0,64,8,0,0,0,1,662,0
157,560,86,0,8,40,0,0,0,1,669,0
157,588,103,0,56,8,0,0,0,1,690,0
157,500,98,0,48,8,0,0,0,1,731,0
157,384,200,0,56,8,0,0,0,1,804,0
157,188,295,0,80,16,0,0,0,1,1093,0
157,24,120,0,64,16,0,0,0,1,1825,0
157,616,24,0,8,40,0,0,0,1,2120,0
155,600,288,0,1,1,0,0,0,0,6,0
155,600,359,0,2,1,80,0,0,1,7,0
155,360,288,0,1,2,0,0,0,0,30,0
155,360,360,0,2,2,100,0,0,1,31,0
155,96,240,0,1,3,0,0,0,1,62,0
155,96,360,0,2,3,0,0,0,0,63,0
172,224,168,0,1,0,0,0,0,1,83,1
172,190,168,0,0,0,0,0,0,1,240,1
155,8,144,0,1,4,0,0,0,1,247,0
155,240,144,0,2,4,0,0,0,1,248,0
169,256,72,0,0,0,0,0,0,1,388,1
169,556,120,0,1,0,0,0,0,1,817,1
169,556,88,0,0,0,0,0,0,1,827,1
172,368,152,0,1,0,0,0,0,0,859,1
169,212,320,0,1,0,0,0,0,0,1051,1
169,212,288,0,0,0,0,0,0,0,1061,1
169,148,288,0,0,0,0,0,0,0,1075,1
169,148,320,0,0,0,0,0,0,0,1077,1
172,528,152,0,1,0,0,0,0,1,1668,1
155,72,120,0,1,5,0,0,0,0,1983,0
155,224,120,0,2,5,300,0,0,1,1984,0
155,224,58,0,3,5,0,0,0,0,1999,0
155,595,24,0,1,6,0,0,0,0,2094,0
155,208,24,0,2,6,0,0,0,1,2095,0
166,632,264,0,0,0,180,0,0,1,21,1
166,272,264,0,0,0,0,0,0,1,43,1
253,128,240,0,255,0,5,0,0,1,209,0
253,406,328,0,16711680,0,7,0,0,1,223,0
253,373,328,0,16711680,0,7,0,0,1,224,0
253,478,328,0,16711680,0,7,0,0,1,225,0
253,442,328,0,16711680,0,7,0,0,1,226,0
253,513,328,0,16711680,0,7,0,0,1,227,0
253,352,321,0,16711680,0,0,0,0,1,775,0
253,549,328,0,16711680,0,7,0,0,1,790,0
253,585,328,0,16711680,0,7,0,0,1,797,0
253,334,328,0,16711680,0,7,0,0,1,1287,0
253,389,320,0,16711680,0,0,0,0,1,1288,0
253,423,320,0,16711680,0,0,0,0,1,1373,0
253,495,320,0,16711680,0,0,0,0,1,1388,0
253,530,320,0,16711680,0,0,0,0,1,1389,0
253,459,320,0,16711680,0,0,0,0,1,1390,0
253,566,319,0,16711680,0,0,0,0,1,1391,0
253,605,320,0,16711680,0,0,0,0,1,1528,0
253,625,328,0,16711680,0,7,0,0,1,1553,0
1234567890
24,368,224,96,16,192,336,10000,0,0,0,0
24,368,224,96,16,384,336,10000,0,0,0,0
24,368,224,96,16,480,336,10000,0,0,0,0
24,368,48,16,16,352,272,10000,0,0,0,0
24,368,48,16,16,352,288,10000,0,0,0,0
24,368,48,16,16,352,304,10000,0,0,0,0
24,368,48,16,16,352,320,10000,0,0,0,0
24,368,48,16,16,352,336,10000,0,0,0,0
24,368,48,16,16,352,352,10000,0,0,0,0
24,368,48,16,16,592,272,10000,0,0,0,0
24,368,48,16,16,592,288,10000,0,0,0,0
24,368,48,16,16,592,304,10000,0,0,0,0
24,368,48,16,16,592,320,10000,0,0,0,0
24,368,48,16,16,592,336,10000,0,0,0,0
24,368,224,16,16,576,336,10000,0,0,0,0
24,400,224,64,16,608,336,10000,0,0,0,0
24,448,224,16,16,368,336,10000,0,0,0,0
24,368,224,64,16,288,336,10000,0,0,0,0
24,384,224,80,16,112,336,10000,0,0,0,0
24,368,224,64,16,16,336,10000,0,0,0,0
24,368,128,16,16,96,336,10000,0,0,0,0
24,368,128,16,16,96,320,10000,0,0,0,0
24,368,128,16,16,96,304,10000,0,0,0,0
24,368,128,16,16,96,288,10000,0,0,0,0
24,368,128,16,16,96,272,10000,0,0,0,0
24,368,128,16,16,96,256,10000,0,0,0,0
24,368,128,16,16,96,240,10000,0,0,0,0
24,368,128,16,16,96,224,10000,0,0,0,0
24,384,128,16,16,80,336,10000,0,0,0,0
24,384,128,16,16,80,320,10000,0,0,0,0
24,384,128,16,16,80,304,10000,0,0,0,0
24,384,128,16,16,80,288,10000,0,0,0,0
24,384,128,16,16,80,272,10000,0,0,0,0
24,384,128,16,16,80,256,10000,0,0,0,0
24,384,128,16,16,80,240,10000,0,0,0,0
24,384,128,16,16,80,224,10000,0,0,0,0
24,336,112,32,16,80,208,10000,0,0,0,0
24,336,64,16,16,352,256,10000,0,0,0,0
24,352,64,16,16,592,256,10000,0,0,0,0
24,368,64,32,16,368,256,10000,0,0,0,0
24,368,64,32,16,400,256,10000,0,0,0,0
24,368,64,32,16,432,256,10000,0,0,0,0
24,368,64,32,16,464,256,10000,0,0,0,0
24,368,64,32,16,496,256,10000,0,0,0,0
24,368,64,32,16,528,256,10000,0,0,0,0
24,368,64,32,16,560,256,10000,0,0,0,0
987654321
LkgrD0AjEC53Lmxac01MNBQjfRhdCjVDFXF/WFwwfwEzOD0=
FwQvAwMnECpqJmBLPV8NN01sd11YGzwCEGM3AVEkLAIzJC1wZGA=
DAc5EQ0jXictL2JaekxIPEYpfktuGCJHHGtyDBY1YwF7Ljw=
EwArDAsx

