X1t4TlZ2AGU9Z2ZBIFhAO1oiN25LDCNXGm1TCls4IER+enVgKSQ9ZmRjbV8=
259,56,111,0,112,64,0,0,0,1,58,0
259,503,200,0,96,64,0,0,0,1,432,0
160,296,624,0,0,16777215,0,0,0,1,74,0
195,177,233,0,0,126,267,0,1100,1,33,0
195,522,503,0,0,128,271,0,0,1,1665,0
195,456,8,0,0,112,284,0,166,1,156,0
195,400,224,0,0,100,309,0,0,1,551,0
100,368,128,0,372,16776960,0,327,0,1,499,0
123,336,400,0,72,16777215,0,0,0,1,1285,0
100,216,368,0,216,16777215,0,329,0,1,1226,0
218,536,175,1,340,16777215,0,222,0,1,438,0
100,456,8,0,368,255,0,293,0,1,159,0
123,200,272,0,152,16777215,0,0,0,1,40,0
100,112,80,0,284,16777215,0,218,0,1,62,0
123,608,223,0,156,16777215,0,0,0,1,480,0
100,376,256,0,300,16777215,0,0,0,0,613,0
100,677,464,0,296,16777215,0,332,0,1,1864,0
100,824,280,0,448,0,0,269,0,0,683,0
123,776,392,0,156,16777215,0,0,0,1,849,0
100,253,510,0,256,16777215,0,89,0,1,1359,0
100,8,8,0,204,0,0,335,0,1,993,0
123,765,149,0,76,16777215,0,0,0,1,483,0
100,468,528,0,364,16777215,0,312,0,1,1667,0
123,72,487,0,124,16777215,0,0,0,1,1390,0
123,78,564,0,128,16777215,0,0,0,1,1459,0
197,792,624,0,2,1667,0,0,0,1,1661,0
197,824,353,0,4,0,0,0,0,1,752,0
197,512,343,0,4,0,0,0,0,1,947,0
197,768,560,0,2,1800,0,0,0,1,1795,0
197,738,560,0,2,0,0,0,0,1,1791,0
197,528,232,0,2,466,0,0,0,1,470,0
197,600,448,0,4,0,0,0,0,1,867,0
197,376,184,0,7,541,0,0,0,1,521,0
197,264,416,0,2,0,0,0,0,1,1208,0
174,736,51,0,1,264,0,0,0,0,256,1
174,452,342,0,1,950,0,0,0,0,953,1
174,152,416,0,1,1437,1439,0,0,0,1416,1
174,112,624,0,1,1454,1489,0,0,0,1457,1
174,23,249,0,1,49,0,0,0,0,43,1
174,296,336,0,1,1100,0,0,0,0,1099,1
174,208,336,0,1,1076,0,0,0,0,1120,1
174,200,464,0,1,1394,0,0,0,0,1396,1
174,232,416,0,1,1246,0,0,0,0,1244,1
174,16,144,0,1,78,92,0,0,0,94,1
174,56,338,0,1,8,0,0,0,0,10,1
174,416,104,0,1,141,0,0,0,0,127,1
194,571,504,0,0,128,0,0,0,1,1365,0
181,178,400,0,1194,128,0,0,0,1,1150,0
194,576,184,0,0,128,88,0,0,1,732,0
194,576,264,0,0,128,0,0,0,1,478,0
181,209.75,456,0,1311,128,0,0,0,1,1316,0
205,100,64,0,-1,0,0.30,0,0,1,83,0
186,797,254,0,32,32,0,0,0,1,646,0
188,720,176,0,0,348,0,0,0,1,345,0
188,816,176,0,0,264,0,0,0,1,296,0
188,832,88,0,90,206,0,0,0,1,193,0
188,707,581,0,0,1786,0,0,0,1,1831,0
188,796,580,0,0,1713,0,0,0,1,1755,0
188,137,624,0,0,1503,0,0,0,1,1499,0
185,360,512,0,0,32,1,0,0,1,1254,0
242,24,128,0,32,32,0,0,0,1,1991,0
242,547,74,0,32,32,0,0,0,0,194,0
242,448,328,0,32,32,0,0,0,1,1926,0
242,496,216,0,32,32,0,0,0,1,1028,0
242,464,88,0,32,32,0,0,0,1,1011,0
176,112,328,0,8,32,32,0,0,1,12,0
176,576,272,0,725,32,32,0,0,1,729,0
176,432,272,0,613,32,32,0,0,1,615,0
176,489,88,0,141,32,32,0,0,1,149,0
176,400,88,0,128,32,32,0,0,1,134,0
176,296,448,0,1258,32,32,0,0,1,1340,0
154,96,296,1,1,0.50,32,16,1,1,46,1
154,213,112,0,2,1.50,64,16,1,1,107,1
154,623,88,0,3,0.50,144,16,1,1,239,1
154,648,144,1,4,0.50,16,64,1,0,283,1
154,552,456,0,6,2,48,16,1,0,887,1
154,237.50,400,0,7,0.75,32,32,-1,1,1194,1
154,202.50,453,0,8,0.75,16,16,-1,1,1311,0
154,46,467,0,9,1.50,48,8,1,1,1409,1
154,224,616,0,10,5.50,64,16,1,0,1503,1
154,735,568,0,11,0.50,80,16,1,1,1701,1
210,703,232,0,630,270,0,0,0,1,416,0
210,703,248,0,632,270,0,0,0,1,419,0
210,464,224,0,0,270,0,0,0,1,632,0
210,464,144,0,0,90,0,0,0,1,504,0
210,464,192,0,504,270,0,0,0,1,454,0
210,464,176,0,421,270,0,0,0,1,495,0
210,464,128,0,0,90,0,0,0,1,421,0
210,464,208,0,0,270,0,0,0,1,630,0
210,112,96,0,84,90,0,0,0,1,82,0
210,118,64,0,0,0,0,0,0,1,84,0
158,16,336,0,0,16777215,0,1,0,1,2,0
290,720,632,0,224,16,1,0,0,1,1529,0
157,148,344,0,328,16,0,0,0,1,4,0
157,368,344,0,48,16,0,0,0,1,1059,0
157,232,320,0,16,32,0,0,0,1,1118,0
157,352,176,0,16,80,0,0,0,1,5,0
157,72,272,0,16,64,0,0,0,1,7,0
157,32,256,0,64,16,0,0,0,1,6,0
157,120,120,0,16,80,0,0,0,1,54,0
157,61,72,0,136,16,0,0,0,1,59,0
157,24,152,0,112,16,0,0,0,1,53,0
157,0,112,0,8,80,0,0,0,1,61,0
157,80,112,0,64,8,0,0,0,1,88,0
157,56,0,0,128,8,0,0,0,1,2172,0
157,385,200,0,64,32,0,0,0,1,476,0
157,528,296,0,224,16,0,0,0,1,545,0
157,512,240,0,96,16,0,0,0,1,430,0
157,456,200,0,16,96,0,0,0,1,423,0
157,512,160,0,128,16,0,0,0,1,426,0
157,480,136,0,32,32,0,0,0,1,474,0
157,488,112,0,112,16,0,0,0,1,142,0
157,440,32,0,16,80,0,0,0,1,140,0
157,488,0,0,96,8,0,0,0,1,2139,0
157,528,320,0,16,48,0,0,0,1,956,0
157,528,80,0,32,48,0,0,0,1,157,0
157,552,208,0,16,80,0,0,0,1,427,0
157,552,104,0,16,32,0,0,0,1,251,0
157,632,328,0,16,16,0,0,0,1,790,0
157,600,184,0,16,64,0,0,0,1,716,0
157,688,184,0,96,16,0,0,0,1,288,0
157,576,160,0,32,16,0,0,0,1,722,0
157,720,104,0,160,16,0,0,0,1,365,0
157,568,104,0,16,32,0,0,0,1,248,0
157,536,16,0,16,48,0,0,0,1,158,0
157,551,60,0,24,8,0,0,0,1,974,0
157,720,58,0,128,16,0,0,0,1,185,0
157,664,25,0,16,64,0,0,0,1,186,0
157,384,392,0,16,80,0,0,0,1,1140,0
157,584,392,0,16,112,0,0,0,1,800,0
157,488,382,0,96,80,0,0,0,1,930,0
157,632,360,0,16,16,0,0,0,1,793,0
157,400,32,0,32,32,0,0,0,1,2200,0
157,280,400,0,16,32,0,0,0,1,1148,0
157,224,424,0,240,16,0,0,0,1,1145,0
157,384,456,0,16,48,0,0,0,1,1263,0
157,304,472,0,80,16,0,0,0,1,1256,0
157,632,392,0,16,16,0,0,0,1,798,0
157,632,424,0,16,16,0,0,0,1,795,0
157,704,456,0,256,16,0,0,0,1,384,0
157,664,512,0,16,96,0,0,0,1,1693,0
157,695,230,0,16,80,0,0,0,1,413,0
157,743,262,0,80,16,0,0,0,1,400,0
157,712,294,0,16,48,0,0,0,1,660,0
157,736,360,0,64,16,0,0,0,1,771,0
157,760,408,0,112,16,0,0,0,1,395,0
157,722,536,0,8,48,0,0,0,1,1783,0
157,752,513,0,8,96,0,0,0,1,1708,0
157,781,536,0,8,48,0,0,0,1,1710,0
157,808,360,0,48,16,0,0,0,1,373,0
157,824,262,0,16,16,0,0,0,1,516,0
157,320,632,0,640,16,0,0,0,1,70,0
157,209,472,0,64,16,0,0,0,1,1335,0
157,232,520,0,192,16,0,0,0,1,1363,0
157,31,520,0,80,16,0,0,0,1,1442,0
169,64,304,0,0,0,0,0,0,1,8,1
155,96,296,0,1,1,0,0,0,1,44,0
155,96,152,0,2,1,0,0,0,1,45,0
172,80,272,0,0,0,0,0,0,1,49,1
172,80,144,0,0,0,0,0,0,0,78,1
169,48,80,0,0,0,0,0,0,1,92,1
155,192,112,0,1,2,0,0,0,1,105,0
155,400,112,0,2,2,0,0,0,1,106,0
169,344,104,0,0,0,0,0,0,0,128,1
169,432,72,0,0,0,0,0,0,1,141,1
169,560,58,0,1,0,0,0,0,1,206,1
155,616,88,0,1,3,0,0,0,1,237,0
155,760,88,0,2,3,0,0,0,1,238,0
172,800,96,0,0,0,0,0,0,1,264,1
155,648,144,0,1,4,0,0,0,1,281,0
155,824,144,0,2,4,0,0,0,1,282,0
172,736,176,0,0,0,0,0,0,0,348,1
172,783,254,0,0,0,0,0,0,1,466,1
172,416,192,0,0,0,0,0,0,1,541,1
172,560,200,0,0,0,0,0,0,1,725,1
155,552,456,0,1,6,0,0,0,1,885,0
155,416,456,0,2,6,0,0,0,1,886,0
155,416,344,0,3,6,0,0,0,1,898,0
169,464,310,0,0,0,0,0,0,1,950,1
172,312,336,0,0,0,0,0,0,1,1076,1
155,248,400,0,1,7,0,0,0,1,1192,0
155,96,400,0,2,7,0,0,0,1,1193,0
172,344,416,0,0,0,0,0,0,1,1246,1
172,344,464,0,0,0,0,0,0,0,1258,1
155,192,453,0,1,8,0,0,0,1,1309,0
155,256,453,0,2,8,0,0,0,1,1310,0
169,136,432,0,0,0,0,0,0,1,1394,1
155,25,467,0,1,9,0,0,0,1,1407,0
155,112,467,0,2,9,0,0,0,1,1408,0
172,71,512,0,0,0,0,0,0,1,1437,1
172,104,512,0,1,0,0,0,0,1,1439,1
169,160,528,0,0,0,0,0,0,1,1454,1
169,256,528,0,0,0,0,0,0,1,1489,1
155,224,616,0,1,10,0,0,0,1,1501,0
155,224,536,0,2,10,0,0,0,1,1502,0
155,728,568,0,1,11,0,0,0,1,1699,0
155,776,568,0,2,11,0,0,0,1,1700,0
172,752,496,0,0,0,0,0,0,0,1713,1
172,718,496,0,1,0,0,0,0,0,1786,1
166,230,129,0,0,0,90,0,0,1,99,1
166,280,128,0,0,0,90,0,0,1,101,1
166,328,128,0,0,0,90,0,0,1,103,1
166,136,112,0,0,0,0,0,0,1,121,1
166,496,8,0,0,0,270,0,0,0,166,1
166,584,128,0,0,0,90,0,0,1,187,1
166,632,128,0,0,0,90,0,0,1,189,1
166,545,74,0,0,0,0,0,0,1,190,1
166,256,240,0,0,0,270,0,0,0,1100,1
166,24,504,0,0,0,90,0,0,1,1400,1
166,72,504,0,0,0,90,0,0,1,1402,1
166,48,504,0,0,0,90,0,0,1,1403,1
166,632,472,0,0,0,270,0,0,0,1800,1
237,320,0,0,16777215,300,0,0,0,1,2112,0
157,144,488,0,16,48,0,0,0,1,1385,0
157,464,480,0,144,16,0,0,0,1,2085,0
157,456,568,0,32,32,0,0,0,1,1605,0
157,168,592,0,16,64,0,0,0,1,1450,0
157,152,592,0,16,64,0,0,0,1,1446,0
157,184,592,0,16,64,0,0,0,1,1486,0
157,264,592,0,16,64,0,0,0,1,1488,0
157,776,49,0,16,32,0,0,0,1,184,0
157,801,184,0,64,16,0,0,0,1,292,0
242,304,403,0,32,32,0,0,0,1,2056,0
242,304,496,0,32,32,0,0,0,1,1933,0
242,744,336,0,32,32,0,0,0,1,1894,0
242,752,32,0,32,32,0,0,0,1,319,0
242,760,608,0,32,32,0,0,0,1,1961,0
176,560,448,0,887,32,32,0,0,1,914,0
176,360,449,0,1258,32,32,0,0,1,1266,0
176,672,608,0,1800,32,32,0,0,1,1803,0
176,704,336,0,683,32,32,0,0,1,686,0
176,816,160,0,283,32,32,0,0,1,307,0
100,824,424,0,156,4210688,0,216,0,1,819,0
1234567890
25,272,176,112,64,0,80,10002,0,0,0,0
24,192,48,32,32,80,240,10000,0,0,0,0
24,192,48,32,32,80,272,10000,0,0,0,0
24,192,48,32,32,80,304,10000,0,0,0,0
24,192,48,32,32,80,144,10000,0,0,0,0
24,192,48,32,32,80,208,10000,0,0,0,0
24,80,32,16,64,16,160,10000,0,0,0,0
24,144,48,16,64,48,256,10000,0,0,0,0
24,320,16,16,16,208,288,10000,0,0,0,0
24,320,16,16,16,240,288,10000,0,0,0,0
24,320,16,16,16,272,288,10000,0,0,0,0
24,320,32,16,16,304,288,10000,0,0,0,0
24,336,16,16,16,320,304,10000,0,0,0,0
24,128,64,16,48,288,272,10000,0,0,0,0
24,64,16,32,16,288,256,10000,0,0,0,0
24,144,80,16,32,320,240,10000,0,0,0,0
24,64,16,32,16,256,224,10000,0,0,0,0
24,80,16,16,16,288,224,10000,0,0,0,0
24,80,16,16,16,304,224,10000,0,0,0,0
24,192,48,32,32,80,176,10000,0,0,0,0
24,192,32,16,16,320,224,10000,0,0,0,0
24,64,0,32,16,224,224,10000,0,0,0,0
24,64,16,32,16,176,224,10000,0,0,0,0
24,80,16,16,16,208,224,10000,0,0,0,0
24,256,240,48,16,592,624,10000,0,0,0,0
24,256,240,48,16,192,560,10000,0,0,0,0
24,256,240,48,16,304,432,10000,0,0,0,0
24,256,240,48,16,720,416,10000,0,0,0,0
24,256,240,48,16,272,480,10000,0,0,0,0
25,576,304,16,16,640,624,10002,0,0,0,0
24,320,240,48,16,688,464,10000,0,0,0,0
24,320,240,48,16,784,464,10000,0,0,0,0
24,368,240,96,32,736,384,10000,0,0,0,0
24,368,240,96,32,640,384,10000,0,0,0,0
24,368,240,96,32,640,352,10000,0,0,0,0
24,368,240,96,32,736,352,10000,0,0,0,0
24,368,240,96,32,640,320,10000,0,0,0,0
24,368,240,96,32,736,320,10000,0,0,0,0
24,368,240,96,32,640,288,10000,0,0,0,0
24,368,240,96,32,736,288,10000,0,0,0,0
24,368,240,96,32,288,352,10000,0,0,0,0
24,368,240,96,32,288,384,10000,0,0,0,0
24,368,240,96,32,192,384,10000,0,0,0,0
24,368,240,96,32,192,352,10000,0,0,0,0
24,352,288,112,32,0,400,10000,0,0,0,0
24,352,288,112,32,0,368,10000,0,0,0,0
24,352,288,112,32,0,336,10000,0,0,0,0
24,288,288,80,16,112,352,10000,0,0,0,0
24,288,288,80,16,112,368,10000,0,0,0,0
24,288,288,80,16,112,384,10000,0,0,0,0
24,288,288,80,16,112,400,10000,0,0,0,0
987654321
LkgrD0AjEC53Lmxac01MNBQjfRhdCjVDFXF/WFwwfwEzOD0=
FwQvAwMnECpqJmBLPV8NN01sd11YGzwCEGM3AVEkLAIzJC1wZGA=
DAc5EQ0jXictL2JaekxIPEYpfktuGCJHHGtyDBY1YwF7Ljw=
EwArDAs

