UVx6TlN0AGU9Z15PJUpKP2cielNLUhJLF2RlAX0+aBB+enVgKSQ9ZmRjbV9+SQ==
259,320,208,0,656,320,0,0,0,1,117,0
259,24,32,0,48,32,0,0,0,1,154,0
259,144,24,0,288,48,0,0,0,0,193,0
259,512,96,0,288,32,0,0,0,0,348,0
259,136,96,0,272,32,0,0,0,0,350,0
259,32,160,0,64,32,0,0,0,1,385,0
259,608,160,0,64,32,0,0,0,1,386,0
259,496,191,0,288,96,0,0,0,0,473,0
259,144,192,0,288,96,0,0,0,0,474,0
259,321,303,0,672,112,0,0,0,1,648,0
160,616,48,0,0,-1,0,0,0,1,10,0
100,624,80,0,104,8453888,0,270,0,1,337,0
100,16,192,0,128,4227327,0,270,0,1,332,0
100,624,192,0,120,16711808,0,270,0,1,333,0
100,16,80,0,72,16744448,0,270,0,1,338,0
224,520,96,0,16,16744448,0,0,0,0,451,0
100,208,192,0,96,65535,0,270,0,1,495,0
100,432,192,0,96,12615935,0,270,0,1,497,0
100,0,256,0,420,16744576,0,343,0,0,541,0
100,632,256,0,420,16744576,0,196,0,0,563,0
224,320,320,0,48,0,0,0,0,0,543,0
123,488,216,0,92,0,0,0,0,1,448,0
123,384,224,0,20,255,0,0,0,1,502,0
123,160,32,0,192,255,0,0,0,0,142,0
123,152,216,0,92,0,0,0,0,1,447,0
123,256,224,0,20,8421376,0,0,0,1,501,0
178,296,16,0,16,64,0,0,0,0,183,0
178,408,216,0,16,48,0,0,0,0,488,0
178,584,216,0,16,48,0,0,0,0,664,0
178,232,216,0,16,48,0,0,0,0,489,0
178,56,208,0,16,48,0,0,0,0,663,0
224,248,32,0,28,0,0,0,0,1,455,0
123,472,160,0,156,0,0,0,0,0,640,0
123,168,160,0,156,0,0,0,0,0,641,0
224,120,96,0,16,16744448,0,0,0,0,452,0
197,16,48,0,1,172,0,0,0,1,311,0
197,624,232,0,1,31,0,0,0,1,324,0
197,432,232,0,1,92,0,0,0,1,494,0
197,16,232,0,1,25,0,0,0,1,325,0
197,560,48,0,1,28,0,0,0,1,132,0
197,624,112,0,1,326,0,0,0,1,210,0
197,16,112,0,1,327,0,0,0,1,211,0
197,48,336,0,1,594,0,0,0,1,538,0
197,208,232,0,1,20,0,0,0,1,493,0
174,16,136,0,0,110,40,0,0,0,327,1
174,536,336,0,1,564,0,0,0,0,552,0
174,504,336,0,1,567,606,0,0,0,549,0
174,472,336,0,1,564,0,0,0,0,550,0
174,224,112,0,1,277,0,0,0,0,213,0
174,416,112,0,1,265,266,0,0,0,207,0
174,424,272,0,0,559,560,0,0,0,581,0
174,248,112,0,1,279,278,0,0,0,214,0
174,16,72,0,0,11,117,13,0,0,172,1
174,184,312,0,0,510,18,556,647,0,593,1
174,344,288,0,1,594,567,568,569,0,558,0
174,568,336,0,1,568,607,0,0,0,551,0
174,632,336,0,1,564,0,0,0,0,565,0
174,600,336,0,1,569,608,0,0,0,553,0
174,624,136,0,0,38,111,0,0,0,326,1
174,488,112,0,1,265,266,0,0,0,208,0
174,520,176,0,1,386,322,0,0,0,360,0
174,264,176,0,1,49,113,0,0,0,329,0
174,120,176,0,1,385,323,0,0,0,361,0
174,232,176,0,1,489,0,663,0,0,491,0
174,376,176,0,1,47,114,0,0,0,328,0
174,408,176,0,1,488,0,664,0,0,490,0
174,440,112,0,1,265,266,0,0,0,209,0
174,464,112,0,1,247,0,0,0,0,204,0
174,392,112,0,1,247,0,0,0,0,205,0
174,200,112,0,1,278,279,0,0,0,212,0
174,176,112,0,1,277,0,0,0,0,217,0
174,152,112,0,1,277,0,0,0,0,215,0
174,440,336,0,1,564,0,0,0,0,548,0
174,408,336,0,1,564,0,0,0,0,554,0
205,16,176,0,1,0,0.50,0,0,0,323,0
205,624,176,0,-1,0,0.50,0,0,0,322,0
220,48,320,0,16,32,0,0,0,0,606,0
220,48,320,0,16,32,0,0,0,0,608,0
220,48,320,0,16,32,0,0,0,0,607,0
219,48,320,0,16,32,0,0,0,1,539,0
220,352,96,0,32,32,0,0,0,0,299,1
220,288,96,0,32,32,0,0,0,0,300,1
220,352,160,0,32,32,0,0,0,0,469,1
220,288,160,0,32,32,0,0,0,0,470,1
188,256,232,0,0,0,399,22,401,1,398,0
188,384,232,0,0,55,109,0,59,1,397,0
185,320,336,0,0,32,1,0,0,1,517,0
242,632,96,0,32,32,0,0,0,1,275,0
242,320,160,0,32,32,0,0,0,1,276,0
242,8,96,0,32,32,0,0,0,1,395,0
242,512,160,0,32,32,0,0,0,1,435,0
242,128,160,0,32,32,0,0,0,1,436,0
242,320,96,0,32,32,0,0,0,1,477,0
242,320,256,0,32,32,0,0,0,1,555,0
242,48,320,0,32,32,0,0,0,1,557,0
242,320,272,0,32,32,0,0,0,0,647,0
176,16,32,0,289,32,32,0,0,1,330,0
176,320,32,0,117,32,32,0,0,0,556,0
176,256,32,0,289,32,32,0,0,1,290,0
176,256,32,0,0,32,32,0,0,1,119,0
176,256,32,0,18,32,32,0,0,1,118,0
176,256,32,0,20,32,32,0,0,1,120,0
176,256,32,0,92,32,32,0,0,1,121,0
176,256,32,0,109,32,32,0,0,1,122,0
176,256,32,0,22,32,32,0,0,1,123,0
176,256,32,0,25,32,32,0,0,1,124,0
176,256,32,0,110,32,32,0,0,1,125,0
176,256,32,0,31,32,32,0,0,1,127,0
176,256,32,0,0,32,32,0,0,1,128,0
176,256,32,0,28,32,32,0,0,1,129,0
176,256,32,0,131,32,32,0,0,1,130,0
176,256,32,0,141,32,32,0,0,1,143,0
176,256,32,0,163,32,32,0,0,1,153,0
176,256,32,0,111,32,32,0,0,1,126,0
176,320,256,0,470,32,32,0,0,1,471,0
176,320,256,0,469,32,32,0,0,1,472,0
176,320,256,0,473,32,32,0,0,1,475,0
176,320,256,0,563,32,32,0,0,1,645,0
176,320,256,0,543,32,32,0,0,1,646,0
176,320,256,0,541,32,32,0,0,1,644,0
176,320,256,0,474,32,32,0,0,1,476,0
176,320,256,0,648,32,32,0,0,1,649,0
176,224,160,0,447,32,32,0,0,1,677,0
176,256,160,0,641,32,32,0,0,1,642,0
176,384,160,0,640,32,32,0,0,1,643,0
176,416,160,0,448,32,32,0,0,1,676,0
176,240,96,0,423,32,32,0,0,1,421,0
176,240,96,0,424,32,32,0,0,1,422,0
176,240,96,0,452,32,32,0,0,1,453,0
176,320,64,0,141,32,32,0,0,1,182,0
176,320,64,0,183,32,32,0,0,1,184,0
176,320,64,0,193,32,32,0,0,1,194,0
176,400,96,0,416,32,32,0,0,1,419,0
176,400,96,0,418,32,32,0,0,1,420,0
176,400,96,0,451,32,32,0,0,1,454,0
176,408,296,0,620,32,80,0,0,1,626,0
176,408,296,0,621,32,80,0,0,1,627,0
176,408,296,0,622,32,80,0,0,1,628,0
175,208,32,0,142,15,1,0,0,0,141,0
273,552,96,0,115,0,0,0,0,1,247,0
273,88,96,0,116,0,0,0,0,1,277,0
175,584,96,0,415,80,0,0,0,0,416,0
175,592,96,0,414,180,0,0,0,0,418,0
175,56,96,0,412,80,0,0,0,0,423,0
175,48,96,0,413,180,0,0,0,0,424,0
273,144,320,0,539,0,0,0,0,1,564,0
273,536,288,0,581,0,0,0,0,1,567,0
273,568,288,0,581,0,0,0,0,1,568,0
273,600,288,0,581,0,0,0,0,1,569,0
273,184,320,0,593,0,0,0,0,1,594,0
175,488,248,0,623,180,0,0,0,0,620,0
175,512,248,0,625,530,0,0,0,0,621,0
175,536,248,0,624,710,0,0,0,0,622,0
154,320,296,0,1,0.50,32,16,1,1,512,0
158,64,48,0,0,16777215,0,1,0,1,9,0
216,8,312,0,50,0,0,0,0,1,519,0
216,32,280,0,51,0,0,0,0,1,521,0
216,16,296,0,51,0,0,0,0,1,520,0
216,160,272,0,52,0,0,0,0,1,528,0
216,528,96,0,58,0,0,0,0,0,414,0
216,512,96,0,51,0,0,0,0,0,415,0
216,488,264,0,52,0,0,0,0,0,623,0
216,216,280,0,55,0,0,0,0,1,533,0
216,240,296,0,59,0,0,0,0,1,534,0
216,144,288,0,53,0,0,0,0,1,527,0
216,136,288,0,51,0,0,0,0,1,526,0
216,48,272,0,52,0,0,0,0,1,522,0
216,168,272,0,51,0,0,0,0,1,529,0
216,208,272,0,55,0,0,0,0,1,535,0
216,512,264,0,53,0,0,0,0,0,625,0
216,536,264,0,53,0,0,0,0,0,624,0
216,120,304,0,58,0,0,0,0,1,525,0
216,232,296,0,58,0,0,0,0,1,532,0
216,256,312,0,51,0,0,0,0,1,546,0
216,271,313,0,54,0,0,0,0,1,544,0
216,368,312,0,46,0,0,0,0,1,537,0
216,264,312,0,54,0,0,0,0,1,545,0
216,192,264,0,54,0,0,0,0,1,531,0
216,184,264,0,53,0,0,0,0,1,530,0
216,96,280,0,55,0,0,0,0,1,524,0
216,72,288,0,53,0,0,0,0,1,523,0
216,168,32,0,71,0,0,0,0,0,289,0
216,112,96,0,52,0,0,0,0,0,412,0
216,128,96,0,56,0,0,0,0,0,413,0
157,144,64,0,320,32,0,0,0,1,82,0
157,488,64,0,304,32,0,0,0,1,2,0
157,144,128,0,320,32,0,0,0,1,33,0
157,496,128,0,320,32,0,0,0,1,34,0
157,200,184,0,208,16,0,0,0,1,42,0
157,336,8,0,512,16,0,0,0,1,44,0
157,440,184,0,208,16,0,0,0,1,54,0
157,488,240,0,304,16,0,0,0,1,57,0
157,152,240,0,304,16,0,0,0,1,58,0
157,352,208,0,32,48,0,0,0,1,61,0
157,288,208,0,32,48,0,0,0,1,62,0
157,24,8,0,48,16,0,0,0,1,152,0
157,32,184,0,64,16,0,0,0,1,321,0
157,608,184,0,64,16,0,0,0,1,320,0
157,320,352,0,656,32,0,0,0,1,514,0
157,296,312,0,16,48,0,0,0,1,515,0
157,344,312,0,16,48,0,0,0,1,516,0
157,40,32,0,16,32,0,0,0,1,163,0
157,616,8,0,48,16,0,0,0,1,131,0
172,304,48,0,0,0,0,0,0,1,11,1
172,304,64,0,0,0,0,0,0,1,13,1
169,352,16,0,0,0,0,0,0,0,18,1
169,368,16,0,0,0,0,0,0,0,20,1
169,432,16,0,0,0,0,0,0,0,22,1
169,480,16,0,0,0,0,0,0,0,25,1
169,576,16,0,0,0,0,0,0,0,28,1
169,528,16,0,0,0,0,0,0,0,31,1
172,304,128,0,1,0,0,0,0,1,38,1
172,304,112,0,0,0,0,0,0,1,40,1
172,544,176,0,0,0,0,0,0,1,47,1
172,64,176,0,0,0,0,0,0,1,49,1
172,304,176,0,0,0,0,0,0,1,55,0
172,304,224,0,1,0,0,0,0,1,59,0
169,384,16,0,0,0,0,0,0,0,92,1
169,304,192,0,1,0,0,0,0,1,399,0
169,320,192,0,0,0,0,0,0,1,401,0
155,320,296,0,1,1,0,0,0,0,510,0
155,320,56,0,2,1,0,0,0,0,511,0
166,416,16,0,0,0,270,0,0,0,109,1
166,464,16,0,0,0,270,0,0,0,110,1
166,512,16,0,0,0,270,0,0,0,111,1
166,272,216,0,0,0,180,0,0,0,113,1
166,368,216,0,0,0,0,0,0,0,114,1
166,600,80,0,0,0,270,0,0,1,115,1
166,40,80,0,0,0,270,0,0,1,116,1
166,384,80,0,0,0,345,0,0,0,265,0
166,496,80,0,0,0,195,0,0,0,266,0
166,144,80,0,0,0,345,0,0,0,278,0
166,256,80,0,0,0,195,0,0,0,279,0
166,392,248,0,0,0,202,0,0,0,559,0
166,248,248,0,0,0,337,0,0,0,560,0
253,536,16,0,16711808,0,0,0,0,1,334,0
253,488,16,0,4227327,0,0,0,0,1,335,0
253,512,16,0,8453888,0,1,0,0,1,336,0
253,464,16,0,16744448,0,1,0,0,1,339,0
253,376,16,0,8454143,0,0,0,0,1,498,0
253,392,16,0,12615935,0,0,0,0,1,499,0
253,416,16,0,255,0,1,0,0,1,503,0
253,440,16,0,8421376,0,0,0,0,1,518,0
253,360,16,0,16744576,0,0,0,0,1,542,0
176,320,160,0,299,32,32,0,0,1,302,0
176,320,160,0,348,32,32,0,0,1,349,0
176,320,160,0,350,32,32,0,0,1,351,0
176,320,160,0,300,32,32,0,0,1,301,0
1234567890
25,112,16,16,16,144,0,10002,0,0,0,0
25,112,16,16,16,160,0,10002,0,0,0,0
25,112,16,16,16,176,0,10002,0,0,0,0
25,112,16,16,16,192,0,10002,0,0,0,0
25,112,16,16,16,208,0,10002,0,0,0,0
25,112,16,16,16,224,0,10002,0,0,0,0
25,112,16,16,16,240,0,10002,0,0,0,0
25,112,16,16,16,256,0,10002,0,0,0,0
25,112,16,16,16,256,96,10002,0,0,0,0
25,112,16,16,16,368,96,10002,0,0,0,0
25,112,16,16,16,368,160,10002,0,0,0,0
25,112,16,16,16,256,160,10002,0,0,0,0
25,112,16,16,16,320,32,10002,0,0,0,0
25,112,16,16,16,336,32,10002,0,0,0,0
25,112,16,16,16,288,32,10002,0,0,0,0
25,112,16,16,16,288,16,10002,0,0,0,0
25,112,16,16,16,224,16,10002,0,0,0,0
25,112,16,16,16,240,16,10002,0,0,0,0
25,112,16,16,16,272,16,10002,0,0,0,0
25,112,16,16,16,272,112,10002,0,0,0,0
25,112,16,16,16,272,128,10002,0,0,0,0
25,112,16,16,16,288,112,10002,0,0,0,0
24,64,32,16,48,240,16,10000,0,0,0,0
24,416,192,16,32,400,192,10000,0,0,0,0
24,416,192,16,32,224,192,10000,0,0,0,0
24,128,32,32,16,368,160,10000,0,0,0,0
24,144,32,16,16,400,160,10000,0,0,0,0
24,144,32,16,16,416,160,10000,0,0,0,0
24,144,32,16,16,432,160,10000,0,0,0,0
24,144,32,16,16,448,160,10000,0,0,0,0
24,144,32,16,16,464,160,10000,0,0,0,0
24,144,32,16,16,480,160,10000,0,0,0,0
24,144,32,16,16,496,160,10000,0,0,0,0
24,144,32,16,16,512,160,10000,0,0,0,0
24,80,0,16,16,560,144,10000,0,0,0,0
24,96,0,16,16,576,144,10000,0,0,0,0
24,96,0,16,16,592,144,10000,0,0,0,0
24,112,0,16,16,608,144,10000,0,0,0,0
24,368,208,32,16,192,160,10000,0,0,0,0
24,368,208,32,16,160,160,10000,0,0,0,0
24,368,208,32,16,128,160,10000,0,0,0,0
24,384,208,16,16,112,160,10000,0,0,0,0
24,160,32,16,16,96,160,10000,0,0,0,0
24,128,32,16,16,80,160,10000,0,0,0,0
24,128,96,16,16,224,224,10000,0,0,0,0
24,128,96,16,16,400,224,10000,0,0,0,0
24,144,48,16,16,224,144,10000,0,0,0,0
24,368,208,16,16,224,160,10000,0,0,0,0
24,368,208,16,16,240,160,10000,0,0,0,0
24,176,32,16,16,256,160,10000,0,0,0,0
24,112,16,16,16,112,144,10000,0,0,0,0
24,368,192,32,16,80,144,10000,0,0,0,0
24,64,16,48,16,16,144,10000,0,0,0,0
24,384,192,16,16,64,144,10000,0,0,0,0
24,96,16,16,16,528,144,10000,0,0,0,0
24,64,16,16,16,512,144,10000,0,0,0,0
24,368,192,16,16,544,144,10000,0,0,0,0
24,144,48,16,16,400,144,10000,0,0,0,0
24,160,16,16,16,528,160,10000,0,0,0,0
24,176,16,16,16,544,160,10000,0,0,0,0
987654321
Bkg4BwEuECtkOHlPIU8=

