UVx6TlN0AGU9Z2pPIU5DaBg+dFpBGDFBDWplARJhIEV+enVgKSQ9ZmRj
259,632,256,0,80,80,0,0,0,1,167,0
259,184,248,0,144,32,0,0,0,1,267,0
259,360,88,0,32,80,0,0,0,1,268,0
259,288,280,0,80,32,0,0,0,1,304,0
259,88,56,0,32,16,0,0,0,1,323,0
259,40,272,0,96,80,0,0,0,0,423,0
259,216,320,0,448,32,0,0,0,0,424,0
259,160,248,0,96,80,0,0,0,1,506,0
160,16,336,0,0,16711680,0,0,0,1,20,0
100,368.00,84,0,256,255,257,0,257,1,260,0
218,514.50,136,0,256,255,219,0,219,1,487,0
218,125.50,16,0,400,255,77,0,77,1,86,0
123,544,160,0,200,16711680,0,0,0,1,90,0
100,177.30,236,0,256,255,279,0,279,1,280,0
224,360,201,0,400,16711680,0,0,0,0,152,0
100,136,236,0,256,255,281,0,281,1,282,0
100,232.60,236,0,256,255,231,0,231,1,259,0
197,8,200,0,2,91,0,0,0,1,111,0
197,336,32,0,2,92,0,0,0,1,95,0
197,608,216,0,2,93,0,0,0,1,89,0
197,392,336,0,2,64,0,0,0,1,22,0
197,632,336,0,2,162,0,0,0,1,161,0
174,432,264,0,0,0,0,0,0,0,213,1
174,80,192,0,0,548,552,0,0,0,547,1
174,104,192,0,0,547,553,550,551,0,546,1
174,152,200,0,1,105,0,0,0,0,115,1
174,192,192,0,0,470,471,546,458,0,473,1
174,208,192,0,0,461,468,456,469,0,475,1
174,264,192,0,0,477,475,473,0,0,476,1
174,227,193,0,0,466,465,463,464,0,477,1
174,449,264,0,0,90,185,0,0,0,186,1
174,496,264,0,0,26,126,159,184,0,92,1
174,512,264,0,0,24,125,157,183,0,91,1
174,576,264,0,0,277,275,267,520,0,283,1
174,416,264,0,0,232,255,0,0,0,235,1
174,480,264,0,0,186,28,124,160,0,93,1
174,464,264,0,0,405,125,126,124,0,127,1
174,560,288,0,0,518,516,313,0,0,520,1
174,528,264,0,0,141,391,392,393,0,162,1
174,560,264,0,0,139,134,147,131,0,141,1
174,544,264,0,0,132,133,152,167,0,147,1
174,340,251,0,0,550,551,548,552,0,554,1
174,344,219,0,0,434,444,553,554,0,532,1
174,376,256,0,0,421,410,407,409,0,420,1
174,400,264,0,0,232,255,0,0,0,236,1
174,456,232,0,0,333,335,337,339,0,393,1
174,440,232,0,0,341,343,345,365,0,392,1
174,424,232,0,0,363,366,370,395,0,391,1
174,408,232,0,0,371,369,368,420,0,395,1
174,360,256,0,0,424,423,367,532,0,421,1
174,500,289,0,0,406,134,534,533,0,405,1
174,528,288,0,0,409,407,410,446,0,406,1
174,542,288,0,0,434,444,0,0,0,446,1
181,65.25,136,0,223,140,0,0,236,1,219,0
181,624,136,0,80,140,0,0,235,1,77,0
205,559.50,216,0,1,0,0.50,0,0,1,88,0
205,352.80,112,0,1,0,0.80,0,0,1,257,0
194,632,264,0,0,200,0,0,0,0,133,0
194,632,272,0,0,200,0,0,0,0,131,0
194,632,280,0,0,200,0,0,0,0,132,0
205,233.40,264,0,1,0,0.80,283,0,1,231,0
205,184.50,264,0,1,0,0.80,0,0,1,279,0
205,136.80,264,0,1,0,0.80,0,0,1,281,0
186,88,112,0,32,32,0,0,0,1,104,0
188,216,200,0,0,109,0,0,0,1,112,0
242,392,320,0,32,32,0,0,0,1,181,0
242,0,184,0,32,32,0,0,0,0,183,0
242,336,16,0,32,32,0,0,0,0,184,0
242,608,200,0,32,32,0,0,0,0,185,0
242,568,320,0,32,32,0,0,0,1,208,0
242,632,320,0,32,32,0,0,0,1,566,0
176,320,320,0,366,32,32,0,0,1,373,0
176,336,320,0,370,32,32,0,0,1,376,0
176,352,320,0,371,32,32,0,0,1,380,0
176,120,160,0,109,256,80,0,0,1,567,0
176,368,320,0,369,32,32,0,0,1,379,0
176,384,320,0,368,32,32,0,0,1,378,0
176,400,320,0,367,32,32,0,0,1,377,0
176,304,320,0,363,32,32,0,0,1,374,0
176,288,320,0,365,32,32,0,0,1,381,0
176,256,320,0,343,32,32,0,0,1,352,0
176,272,320,0,345,32,32,0,0,1,353,0
176,568,320,0,127,32,32,0,0,1,123,0
176,240,320,0,341,32,32,0,0,1,350,0
176,224,320,0,339,32,32,0,0,1,349,0
176,208,320,0,337,32,32,0,0,1,351,0
176,192,320,0,335,32,32,0,0,1,348,0
176,176,320,0,333,32,32,0,0,1,347,0
176,160,320,0,28,32,32,0,0,1,33,0
176,144,320,0,26,32,32,0,0,1,31,0
176,120,320,0,24,32,32,0,0,1,32,0
176,112,320,0,476,32,32,0,0,1,472,0
175,280,232,0,423,100,0,0,0,0,533,0
175,312,232,0,424,100,0,0,0,0,534,0
154,126.25,16,1,1,0.75,8,8,-1,1,80,1
154,513.75,136,1,2,0.75,16,16,-1,1,223,1
158,16,288,0,0,65535,0,1,0,1,21,0
210,80,48,0,0,180,0,0,0,1,295,0
210,96,48,0,0,180,0,0,0,1,294,0
210,408,176,0,0,180,0,0,0,1,505,0
210,392,176,0,0,180,0,0,0,1,504,0
210,304,176,0,0,180,0,0,0,1,502,0
210,320,176,0,0,180,0,0,0,1,503,0
210,440,312,0,68,90,0,0,0,1,67,0
210,440,328,0,69,90,0,0,0,1,66,0
210,472,328,0,66,270,0,0,0,1,69,0
210,128,288,0,502,0,0,0,0,1,500,0
210,144,288,0,503,0,0,0,0,1,501,0
210,176,288,0,504,0,0,0,0,1,499,0
210,192,288,0,505,0,0,0,0,1,498,0
210,472,312,0,67,270,0,0,0,1,68,0
210,263,288,0,295,0,0,0,0,1,292,0
210,280,288,0,294,0,0,0,0,1,293,0
157,328,352,0,1000,32,0,0,0,1,45,0
157,88,216,0,200,32,0,0,0,1,2,0
157,200,216,0,32,32,0,0,0,1,4,0
157,160,280,0,16,32,0,0,0,1,8,0
157,104,248,0,32,32,0,0,0,1,13,0
157,104,280,0,32,32,0,0,0,1,14,0
157,88,248,0,32,32,0,0,0,1,15,0
157,88,280,0,32,32,0,0,0,1,17,0
157,232,216,0,32,32,0,0,0,1,49,0
157,600,240,0,32,32,0,0,0,1,52,0
157,160,296,0,176,16,0,0,0,1,55,0
157,264,296,0,32,16,0,0,0,1,56,0
157,296,296,0,32,16,0,0,0,1,57,0
157,328,288,0,32,32,0,0,0,1,58,0
157,360,288,0,32,32,0,0,0,1,59,0
157,392,288,0,32,32,0,0,0,1,60,0
157,424,288,0,32,32,0,0,0,1,61,0
157,456,320,0,32,32,0,0,0,1,63,0
157,552,224,0,176,16,0,0,0,1,70,0
157,224,80,0,240,96,0,0,0,1,75,0
157,592,120,0,16,16,0,0,0,1,96,0
157,592,88,0,16,16,0,0,0,1,97,0
157,592,56,0,16,16,0,0,0,1,98,0
157,48,112,0,16,16,0,0,0,1,99,0
157,48,88,0,16,16,0,0,0,1,100,0
157,48,56,0,16,16,0,0,0,1,101,0
157,64,80,0,16,96,0,0,0,1,102,0
157,88,40,0,48,16,0,0,0,1,103,0
157,576,160,0,16,16,0,0,0,1,108,0
157,456,296,0,176,16,0,0,0,1,122,0
157,640,296,0,96,16,0,0,0,1,158,0
157,16,296,0,56,16,0,0,0,1,19,0
157,8,160,0,48,16,0,0,0,1,107,0
157,224,280,0,32,32,0,0,0,1,173,0
157,240,280,0,32,32,0,0,0,1,174,0
157,240,216,0,32,32,0,0,0,1,176,0
157,368,280,0,160,32,0,0,0,1,234,0
157,480,80,0,208,96,0,0,0,1,248,0
157,360,48,0,32,32,0,0,0,1,249,0
157,384,168,0,176,16,1,0,0,1,72,0
169,72,304,0,0,0,0,0,0,0,24,1
169,88,304,0,0,0,0,0,0,0,26,1
169,104,304,0,0,0,0,0,0,0,28,1
169,408,304,0,0,0,0,0,0,1,64,1
155,16,16,0,1,1,0,0,0,1,78,0
155,624,16,0,2,1,0,0,0,1,79,0
155,624,136,0,3,1,0,0,0,1,82,0
155,16,136,0,4,1,0,0,0,1,83,0
155,16,16,0,5,1,0,0,0,1,84,0
172,72,112,0,0,0,0,0,0,1,105,1
169,16,168,0,0,0,0,0,0,0,109,1
169,488,304,0,0,0,0,0,0,0,134,1
169,592,256,0,0,0,0,0,0,1,139,1
155,624,136,0,1,2,0,0,0,1,221,0
155,16,136,0,2,2,0,0,0,1,222,0
155,16,16,0,3,2,0,0,0,1,225,0
155,624,16,0,4,2,0,0,0,1,226,0
169,240,232,0,0,0,0,0,0,1,232,1
172,344,112,0,0,0,0,0,0,1,255,1
169,152,232,0,0,0,0,0,0,1,275,1
169,200,232,0,0,0,0,0,0,1,277,1
172,256,264,0,0,0,0,0,0,1,313,1
169,120,304,0,0,0,0,0,0,0,333,1
169,136,304,0,0,0,0,0,0,0,335,1
169,152,304,0,0,0,0,0,0,0,337,1
169,168,304,0,0,0,0,0,0,0,339,1
169,184,304,0,0,0,0,0,0,0,341,1
169,200,304,0,0,0,0,0,0,0,343,1
169,216,304,0,0,0,0,0,0,0,345,1
169,248,304,0,0,0,0,0,0,0,363,1
169,232,304,0,0,0,0,0,0,0,365,1
169,264,304,0,0,0,0,0,0,0,366,1
169,344,304,0,0,0,0,0,0,0,367,1
169,328,304,0,0,0,0,0,0,0,368,1
169,312,304,0,0,0,0,0,0,0,369,1
169,280,304,0,0,0,0,0,0,0,370,1
169,296,304,0,0,0,0,0,0,0,371,1
169,376,304,0,0,0,0,0,0,0,407,1
169,392,304,0,0,0,0,0,0,0,409,1
169,360,304,0,0,0,0,0,0,0,410,1
169,408,304,0,0,0,0,0,0,0,434,1
169,424,304,0,0,0,0,0,0,0,444,1
169,16,264,0,1,0,0,0,0,0,456,1
172,40,288,0,0,0,0,0,0,0,458,1
169,0,232,0,0,0,0,0,0,0,461,1
169,31,232,0,0,0,0,0,0,0,463,1
169,16,232,0,0,0,0,0,0,0,464,1
169,48,232,0,0,0,0,0,0,0,465,1
169,64,232,0,0,0,0,0,0,0,466,1
169,0,264,0,1,0,0,0,0,0,468,1
169,32,264,0,1,0,0,0,0,0,469,1
169,48,264,0,1,0,0,0,0,0,470,1
169,64,264,0,1,0,0,0,0,0,471,1
172,120,264,0,0,0,0,0,0,1,516,1
172,168,264,0,0,0,0,0,0,1,518,1
169,8,304,0,0,0,0,0,0,0,548,1
169,40,304,0,0,0,0,0,0,0,550,1
169,24,304,0,0,0,0,0,0,0,551,1
169,0,304,0,0,0,0,0,0,0,552,1
169,56,304,0,0,0,0,0,0,0,553,1
166,528,304,0,0,0,270,0,0,0,124,1
166,520,304,0,0,0,270,0,0,0,125,1
166,512,304,0,0,0,270,0,0,0,126,1
166,600,304,0,0,0,270,0,0,1,157,1
166,608,304,0,0,0,270,0,0,1,159,1
166,616,304,0,0,0,270,0,0,1,160,1
253,104,120,0,65280,90,6,0,0,1,116,0
253,72,120,0,65280,270,6,0,0,1,117,0
253,152,200,0,65280,0,7,0,0,1,118,0
253,472,216,0,16711680,90,4,0,0,1,191,0
253,248,200,0,65280,270,5,0,0,1,193,0
253,592,128,0,255,270,4,0,0,1,196,0
253,64,128,0,255,90,5,0,0,1,197,0
253,56,40,0,255,0,5,0,0,1,198,0
253,576,32,0,255,270,5,0,0,1,199,0
253,536,288,0,16711680,270,5,0,0,1,201,0
253,72,296,0,16776960,180,4,0,0,1,202,0
1234567890
25,272,256,192,96,0,0,10002,0,0,0,0
25,272,256,192,96,192,0,10002,0,0,0,0
25,272,256,192,96,384,0,10002,0,0,0,0
25,272,256,192,96,576,0,10002,0,0,0,0
25,272,256,192,96,0,96,10002,0,0,0,0
25,272,256,192,96,192,96,10002,0,0,0,0
25,272,256,192,96,384,96,10002,0,0,0,0
25,272,256,192,96,576,96,10002,0,0,0,0
25,272,256,192,96,0,192,10002,0,0,0,0
25,272,256,192,96,192,192,10002,0,0,0,0
25,272,256,192,96,384,192,10002,0,0,0,0
25,272,256,192,96,576,192,10002,0,0,0,0
25,272,256,192,96,480,288,10002,0,0,0,0
25,448,256,16,96,464,304,10002,0,0,0,0
25,528,320,32,16,416,304,10002,0,0,0,0
25,528,320,32,16,384,304,10002,0,0,0,0
25,528,320,32,16,352,304,10002,0,0,0,0
25,528,320,32,16,320,304,10002,0,0,0,0
25,528,320,32,16,288,304,10002,0,0,0,0
25,528,320,32,16,256,304,10002,0,0,0,0
25,528,320,32,16,224,304,10002,0,0,0,0
25,528,320,32,16,192,304,10002,0,0,0,0
25,528,320,32,16,384,320,10002,0,0,0,0
25,528,320,32,16,352,320,10002,0,0,0,0
25,528,320,32,16,320,320,10002,0,0,0,0
25,528,320,32,16,288,320,10002,0,0,0,0
25,528,320,32,16,256,320,10002,0,0,0,0
25,528,320,32,16,224,320,10002,0,0,0,0
25,528,320,32,16,192,320,10002,0,0,0,0
25,528,320,32,16,160,320,10002,0,0,0,0
25,528,320,32,16,160,304,10002,0,0,0,0
25,528,320,32,16,128,304,10002,0,0,0,0
25,528,320,32,16,128,320,10002,0,0,0,0
25,528,320,32,16,96,304,10002,0,0,0,0
25,528,320,32,16,96,320,10002,0,0,0,0
25,528,320,32,16,64,320,10002,0,0,0,0
25,528,320,32,16,64,304,10002,0,0,0,0
25,528,320,32,16,32,304,10002,0,0,0,0
25,528,320,32,16,32,320,10002,0,0,0,0
25,528,320,32,16,48,288,10002,0,0,0,0
25,528,320,32,16,0,288,10002,0,0,0,0
25,528,320,16,16,32,288,10002,0,0,0,0
24,80,32,16,64,608,48,10000,0,0,0,0
24,64,144,48,16,576,176,10000,0,0,0,0
24,432,208,16,16,528,192,10000,0,0,0,0
24,432,64,32,32,592,304,10000,0,0,0,0
24,448,192,16,16,48,304,10000,0,0,0,0
24,464,256,32,32,480,304,10000,0,0,0,0
24,64,16,64,16,304,304,10000,0,0,0,0
24,304,320,64,32,512,304,10000,0,0,0,0
24,528,64,32,32,608,256,10000,0,0,0,0
24,128,112,32,16,128,160,10000,0,0,0,0
24,96,32,32,32,224,160,10000,0,0,0,0
24,400,192,16,32,400,128,10000,0,0,0,0
24,400,192,16,32,400,160,10000,0,0,0,0
24,400,192,16,32,400,224,10000,0,0,0,0
24,400,192,16,32,400,256,10000,0,0,0,0
24,416,256,48,16,176,0,10000,0,0,0,0
24,416,256,48,16,224,0,10000,0,0,0,0
24,416,256,48,16,272,0,10000,0,0,0,0
24,416,256,48,16,320,0,10000,0,0,0,0
24,416,256,48,16,368,0,10000,0,0,0,0
24,416,256,48,16,128,0,10000,0,0,0,0
24,416,256,48,16,80,0,10000,0,0,0,0
24,416,256,48,16,32,0,10000,0,0,0,0
24,448,208,16,16,32,16,10000,0,0,0,0
24,416,192,16,32,384,128,10000,0,0,0,0
24,416,192,16,32,384,160,10000,0,0,0,0
24,416,192,16,32,384,224,10000,0,0,0,0
24,416,192,16,32,384,256,10000,0,0,0,0
24,416,192,16,32,384,288,10000,0,0,0,0
24,416,192,16,32,384,320,10000,0,0,0,0
24,400,192,16,32,400,288,10000,0,0,0,0
24,400,192,16,32,400,320,10000,0,0,0,0
24,64,32,16,64,0,48,10000,0,0,0,0
24,192,48,32,32,0,256,10000,0,0,0,0
24,416,192,16,32,384,192,10000,0,0,0,0
24,400,192,16,32,400,192,10000,0,0,0,0
24,368,192,32,16,528,272,10000,0,0,0,0
24,368,192,32,16,560,272,10000,0,0,0,0
24,368,208,32,16,544,288,10000,0,0,0,0
24,368,208,32,16,576,288,10000,0,0,0,0
24,464,112,32,16,48,320,10000,0,0,0,0
24,416,160,16,16,576,304,10000,0,0,0,0
24,64,160,16,32,0,224,10000,0,0,0,0
24,528,64,32,32,624,304,10000,0,0,0,0
24,80,160,16,16,576,320,10000,0,0,0,0
24,256,176,32,32,32,240,10000,0,0,0,0
24,448,208,16,16,544,240,10000,0,0,0,0
24,448,208,16,16,544,256,10000,0,0,0,0
24,320,16,16,16,560,256,10000,0,0,0,0
24,416,160,16,16,528,256,10000,0,0,0,0
24,432,192,16,16,528,240,10000,0,0,0,0
24,320,16,16,16,576,256,10000,0,0,0,0
24,512,48,32,16,464,80,10000,0,0,0,0
24,496,32,64,32,176,240,10000,0,0,0,0
24,496,32,64,32,112,240,10000,0,0,0,0
24,464,64,32,16,336,144,10000,0,0,0,0
24,464,64,32,16,192,16,10000,0,0,0,0
24,464,128,32,16,304,144,10000,0,0,0,0
24,464,128,32,16,400,16,10000,0,0,0,0
24,464,112,32,16,464,272,10000,0,0,0,0
24,464,80,32,32,496,256,10000,0,0,0,0
24,464,160,32,16,64,16,10000,0,0,0,0
24,144,48,16,64,112,128,10000,0,0,0,0
24,304,240,16,16,256,128,10000,0,0,0,0
24,256,240,48,16,528,0,10000,0,0,0,0
24,400,256,16,32,256,144,10000,0,0,0,0
24,432,320,48,32,528,16,10000,0,0,0,0
987654321
R0g=
R0hqQg==
R0hqQg==
R0hqQg=

