UVx6TlN0AGU9Z0xUOENMNBh9KQsaS2YOSSknVA59PFliZml8NQ==
160,616,352,0,0,16777215,0,0,0,1,363,0
178,120,323,0,16,96,0,0,0,0,153,0
178,200,96,0,32,32,0,0,0,0,203,0
174,40,344,0,1,91,0,0,0,0,90,1
174,120,274,0,1,127,0,0,0,0,137,1
174,90,168,0,0,50,0,0,0,0,62,1
174,208,168,0,1,191,0,0,0,0,195,1
174,40,32,0,1,15,0,0,0,0,27,1
219,32,40,0,64,16,0,0,0,1,19,1
219,64,40,0,64,16,0,0,0,1,33,1
219,240,44,0,32,8,0,0,0,1,212,1
219,292,24,0,8,32,0,0,0,1,213,1
219,292,56,0,8,32,0,0,0,1,262,1
219,292,80,0,8,32,0,0,0,1,263,1
188,64,40,0,90,25,0,0,0,1,21,0
176,0,64,0,62,32,32,0,0,1,54,0
176,272,24,0,231,32,32,0,0,1,234,0
176,240,64,0,250,32,32,0,0,1,274,0
176,208,24,0,203,32,32,0,0,1,202,0
176,272,64,0,233,32,32,0,0,1,242,0
176,272,64,0,0,32,32,0,0,1,241,0
176,240,192,0,331,32,32,0,0,1,319,0
176,120,144,0,153,32,32,0,0,1,152,0
176,80,16,0,34,32,32,0,0,1,40,0
176,280,168,0,309,32,32,0,0,1,320,0
176,240,240,0,349,32,32,0,0,1,344,0
154,8,40,0,1,11,16,16,1,1,17,1
154,40,352,0,2,2.50,16,16,1,1,93,1
154,120,323,0,3,5,16,96,1,1,129,1
154,212,232,0,4,5,8,128,1,1,193,1
154,280,104,0,5,2,32,16,1,1,311,1
154,240,200,0,6,0.50,32,16,1,1,333,1
154,296,200,0,7,0.50,32,16,1,1,351,1
158,232,32,0,1,16777215,0,1,0,1,20,0
157,64,360,0,128,8,0,0,0,1,2,0
157,192,360,0,128,8,0,0,0,1,3,0
157,320,360,0,128,8,0,0,0,1,4,0
157,448,360,0,128,8,0,0,0,1,5,0
157,568,360,0,128,8,0,0,0,1,6,0
157,573,360,0,128,8,0,0,0,1,7,0
157,578,360,0,128,8,0,0,0,1,8,0
157,583,360,0,128,8,0,0,0,1,9,0
157,588,360,0,128,8,0,0,0,1,10,0
157,593,360,0,128,8,0,0,0,1,11,0
157,120,48,0,16,32,0,0,0,1,44,0
157,112,72,0,32,16,0,0,0,1,45,0
157,120,16,0,16,32,0,0,0,1,47,0
157,80,72,0,32,16,0,0,0,1,48,0
157,48,72,0,32,16,0,0,0,1,49,0
157,8,128,0,16,32,0,0,0,1,67,0
157,8,160,0,16,32,0,0,0,1,70,0
157,36,144,0,8,128,0,0,0,1,72,0
157,24,264,0,16,128,0,0,0,1,74,0
157,24,256,0,16,128,0,0,0,1,75,0
157,56,288,0,16,128,0,0,0,1,79,0
157,56,312,0,16,128,0,0,0,1,81,0
157,16,352,0,32,16,0,0,0,1,86,0
157,72,168,0,16,112,0,0,0,1,98,0
157,44,200,0,8,16,0,0,0,1,100,0
157,60,136,0,8,16,0,0,0,1,101,0
157,104,144,0,16,128,0,0,0,1,106,0
157,104,176,0,16,128,0,0,0,1,107,0
157,88,288,0,16,96,0,0,0,1,109,0
157,88,288,0,16,96,0,0,0,1,110,0
157,136,211,0,16,128,0,0,0,1,120,0
157,136,184,0,16,128,0,0,0,1,121,0
157,152,96,0,16,112,0,0,0,1,122,0
157,184,104,0,16,128,0,0,0,1,143,0
157,184,64,0,16,128,0,0,0,1,144,0
157,168,232,0,16,128,0,0,0,1,145,0
157,152,316,0,16,40,0,0,0,1,146,0
157,184,352,0,16,40,0,0,0,1,159,0
157,184,276,0,16,40,0,0,0,1,165,0
157,216,360,0,16,128,0,0,0,1,167,0
157,200,208,0,16,16,0,0,0,1,170,0
157,200,216,0,16,16,0,0,0,1,171,0
157,220,104,0,8,128,0,0,0,1,177,0
157,220,232,0,8,128,0,0,0,1,190,0
157,16,72,0,32,16,0,0,0,1,50,0
157,272,88,0,32,16,0,0,0,1,251,0
157,304,144,0,16,32,0,0,0,1,295,0
157,304,112,0,16,32,0,0,0,1,297,0
157,240,136,0,32,16,0,0,0,1,298,0
157,248,136,0,32,16,0,0,0,1,299,0
157,296,168,0,32,16,0,0,0,1,300,0
157,264,168,0,32,16,0,0,0,1,301,0
157,264,184,0,32,16,0,0,0,1,328,0
157,296,184,0,32,16,0,0,0,1,330,0
157,272,48,0,32,16,0,0,0,1,231,0
157,272,64,0,32,16,0,0,0,1,233,0
157,240,88,0,32,16,0,0,0,1,250,0
155,8,40,0,1,1,0,0,0,0,15,0
155,56,40,0,2,1,0,0,0,0,16,0
169,48,0,0,0,0,0,0,0,1,25,1
169,80,0,0,0,0,0,0,0,1,34,1
155,40,352,0,1,2,0,0,0,0,91,0
155,40,232,0,2,2,0,0,0,0,92,0
155,120,323,0,1,3,0,0,0,0,127,0
155,120,168,0,2,3,0,0,0,0,128,0
155,212,232,0,1,4,0,0,0,0,191,0
155,212,104,0,2,4,0,0,0,0,192,0
155,280,104,0,1,5,0,0,0,0,309,0
155,280,136,0,2,5,0,0,0,0,310,0
155,240,200,0,1,6,0,0,0,0,331,0
155,240,248,0,2,6,0,0,0,0,332,0
155,296,200,0,1,7,0,0,0,0,349,0
155,240,200,0,2,7,0,0,0,1,350,0
155,240,216,0,3,7,0,0,0,0,353,0
253,0,72,0,8388608,270,3,0,0,1,58,0
1234567890
25,224,224,16,16,640,352,10002,0,0,0,0
25,176,176,80,80,0,0,10002,0,0,0,0
25,176,176,80,80,80,0,10002,0,0,0,0
25,176,176,80,80,160,0,10002,0,0,0,0
25,176,176,80,80,240,0,10002,0,0,0,0
25,176,176,80,80,320,0,10002,0,0,0,0
25,176,176,80,80,400,0,10002,0,0,0,0
25,176,176,80,80,480,0,10002,0,0,0,0
25,176,176,80,80,560,0,10002,0,0,0,0
25,176,176,80,80,560,80,10002,0,0,0,0
25,176,176,80,80,480,80,10002,0,0,0,0
25,176,176,80,80,0,80,10002,0,0,0,0
25,176,176,80,80,80,80,10002,0,0,0,0
25,176,176,80,80,160,80,10002,0,0,0,0
25,176,176,80,80,240,80,10002,0,0,0,0
25,176,176,80,80,320,80,10002,0,0,0,0
25,176,176,80,80,400,80,10002,0,0,0,0
25,176,176,80,80,0,160,10002,0,0,0,0
25,176,176,80,80,80,160,10002,0,0,0,0
25,176,176,80,80,0,240,10002,0,0,0,0
25,176,176,80,80,0,320,10002,0,0,0,0
25,176,176,80,80,80,240,10002,0,0,0,0
25,176,176,80,80,80,320,10002,0,0,0,0
25,176,176,80,80,160,320,10002,0,0,0,0
25,176,176,80,80,240,320,10002,0,0,0,0
25,176,176,80,80,320,320,10002,0,0,0,0
25,176,176,80,80,400,320,10002,0,0,0,0
25,176,176,80,80,480,320,10002,0,0,0,0
25,176,176,80,80,560,320,10002,0,0,0,0
25,176,176,80,80,560,240,10002,0,0,0,0
25,176,176,80,80,560,160,10002,0,0,0,0
25,176,176,80,80,480,160,10002,0,0,0,0
25,176,176,80,80,480,240,10002,0,0,0,0
25,176,176,80,80,400,240,10002,0,0,0,0
25,176,176,80,80,320,160,10002,0,0,0,0
25,176,176,80,80,240,240,10002,0,0,0,0
25,176,176,80,80,160,160,10002,0,0,0,0
25,176,176,80,80,160,240,10002,0,0,0,0
25,176,176,80,80,240,160,10002,0,0,0,0
25,176,176,80,80,320,240,10002,0,0,0,0
25,176,176,80,80,400,160,10002,0,0,0,0
987654321
KgE5ERMxQw==
FAwuBgQ=
Aww=
Aww=

