UVx6TlN0AGU9Z0xUOENMNBgBQnZvMxUOSSknVA59PFliZml8NQ==
259,528,280,0,250,32,0,0,0,1,398,0
259,536,280,0,250,32,0,0,0,1,414,0
160,232,40,0,0,16777215,0,0,0,1,203,0
100,528,280,0,256,0,0,0,0,1,360,0
195,520,280,0,0,128,0,0,349,1,358,0
100,592,280,0,256,0,0,0,0,1,362,0
123,32,280,0,128,0,0,0,0,1,447,0
123,128,280,0,128,0,0,0,0,1,448,0
123,240,280,0,128,0,0,0,0,1,449,0
123,293,314,0,128,0,0,0,0,1,452,0
123,270,296,0,128,0,0,0,0,1,450,0
100,560,280,0,256,0,0,0,0,1,361,0
100,496,280,0,256,0,0,0,0,1,364,0
123,231,318,0,128,0,0,0,0,1,453,0
123,184,328,0,128,0,0,0,0,1,451,0
123,144,326,0,128,0,0,0,0,1,455,0
123,94,325,0,128,0,0,0,0,1,456,0
123,26,328,0,128,0,0,0,0,1,454,0
197,368,64,0,2,0,0,0,0,1,248,0
174,40,168,0,1,38,34,0,0,0,41,1
174,24,208,0,1,82,78,163,0,0,84,1
174,344,64,0,1,251,252,250,0,0,268,1
174,360,232,0,1,312,322,0,0,0,302,1
174,472,232,0,1,289,290,0,0,1,291,1
174,274,344,0,1,490,487,485,489,0,501,1
174,272,344,0,1,471,469,0,0,0,503,1
174,352,296,0,1,324,0,0,0,0,326,1
205,152.50,48,0,1,0,0.50,0,0,1,40,0
205,231.50,96,0,1,0,0.50,0,0,1,92,0
219,232,128,0,32,32,0,0,0,1,211,1
219,80,200,0,32,32,0,0,0,1,212,1
186,392,64,0,32,32,0,0,0,1,247,0
186,576,232,0,32,32,0,0,0,1,292,0
219,80,216,0,32,32,0,0,0,1,440,1
188,232,144,0,0,126,0,0,0,1,128,0
188,176,232,0,0,259,0,0,0,1,261,0
188,80,232,0,0,89,0,0,0,1,91,0
154,524.50,320,0,1,0.50,16,16,1,1,393,1
158,32,48,0,1,16777215,0,1,0,1,8,0
210,0,152,0,25,270,0,0,0,1,12,0
210,0,184,0,0,270,0,0,0,1,25,0
210,56,160,0,0,270,0,0,0,1,112,0
210,136,144,0,10,90,0,0,0,1,11,0
210,16,232,0,112,0,0,0,0,1,111,0
210,216,136,0,249,90,0,0,0,1,190,0
210,624,0,0,0,180,0,0,0,1,249,0
210,640,224,0,0,90,0,0,0,1,282,0
210,368,328,0,339,0,0,0,0,1,338,0
210,112,192,0,154,270,0,0,0,1,118,0
210,408,272,0,0,270,0,0,0,1,339,0
210,352,328,0,339,0,0,0,0,1,340,0
210,408,328,0,446,270,0,0,0,1,396,0
210,576,32,0,282,90,0,0,0,1,269,0
210,40,96,0,12,0,0,0,0,1,10,0
210,176,96,0,0,180,0,0,0,1,154,0
210,0,256,0,0,270,0,0,0,1,446,0
157,16,112,0,32,32,0,0,0,1,5,0
157,48,112,0,32,32,0,0,0,1,6,0
157,56,64,0,8,32,0,0,0,1,14,0
157,56,80,0,8,32,0,0,0,1,15,0
157,56,112,0,8,32,0,0,0,1,16,0
157,56,112,0,8,32,0,0,0,1,17,0
157,56,144,0,8,32,0,0,0,1,18,0
157,0,168,0,32,8,0,0,0,1,20,0
157,56,152,0,8,32,0,0,0,1,21,0
157,40,168,0,40,8,0,0,0,1,22,0
157,56,144,0,8,32,0,0,0,1,23,0
157,16,168,0,32,8,0,0,0,1,24,0
157,112,64,0,32,32,0,0,0,1,26,0
157,112,80,0,32,32,0,0,0,1,27,0
157,112,104,0,32,32,0,0,0,1,28,0
157,144,64,0,32,32,0,0,0,1,31,0
157,176,64,0,32,32,0,0,0,1,32,0
157,184,64,0,32,32,0,0,0,1,33,0
157,40,168,0,40,8,0,0,0,1,42,0
157,48,184,0,32,32,0,0,0,1,44,0
157,144,104,0,32,32,0,0,0,1,62,0
157,144,80,0,32,32,0,0,0,1,63,0
157,152,144,0,32,32,0,0,0,1,64,0
157,152,128,0,32,32,0,0,0,1,65,0
157,152,104,0,32,32,0,0,0,1,66,0
157,152,72,0,32,32,0,0,0,1,67,0
157,152,184,0,32,32,0,0,0,1,68,0
157,152,168,0,32,32,0,0,0,1,69,0
157,48,216,0,32,32,0,0,0,1,73,0
157,112,216,0,32,32,0,0,0,1,77,0
157,184,80,0,32,32,0,0,0,1,94,0
157,272,48,0,32,32,0,0,0,1,95,0
157,184,160,0,32,32,0,0,0,1,98,0
157,264,80,0,32,32,0,0,0,1,120,0
157,264,112,0,32,32,0,0,0,1,124,0
157,264,144,0,32,32,0,0,0,1,125,0
157,264,176,0,32,32,0,0,0,1,135,0
157,264,200,0,32,32,0,0,0,1,136,0
157,152,208,0,32,32,0,0,0,1,139,0
157,144,216,0,32,32,0,0,0,1,140,0
157,264,216,0,32,32,0,0,0,1,146,0
157,104,184,0,8,32,0,0,0,1,161,0
157,104,184,0,8,32,0,0,0,1,162,0
157,208,152,0,16,16,0,0,0,1,191,0
157,16,56,0,32,16,0,0,0,1,201,0
157,48,56,0,32,16,0,0,0,1,202,0
157,216,56,0,32,16,0,0,0,1,204,0
157,240,56,0,32,16,0,0,0,1,205,0
157,272,24,0,32,32,0,0,0,1,206,0
157,296,80,0,32,32,0,0,0,1,209,0
157,328,80,0,32,32,0,0,0,1,210,0
157,272,16,0,32,32,0,0,0,1,219,0
157,352,80,0,32,32,0,0,0,1,226,0
157,384,80,0,32,32,0,0,0,1,227,0
157,448,80,0,32,32,0,0,0,1,228,0
157,416,80,0,32,32,0,0,0,1,229,0
157,448,32,0,32,32,0,0,0,1,234,0
157,448,16,0,32,32,0,0,0,1,235,0
157,592,32,0,32,32,0,0,0,1,236,0
157,592,16,0,32,32,0,0,0,1,237,0
157,480,80,0,32,32,0,0,0,1,238,0
157,512,80,0,32,32,0,0,0,1,239,0
157,544,80,0,32,32,0,0,0,1,240,0
157,576,80,0,32,32,0,0,0,1,241,0
157,608,80,0,32,32,0,0,0,1,242,0
157,624,80,0,32,32,0,0,0,1,243,0
157,328,248,0,32,32,0,0,0,1,271,0
157,392,248,0,32,32,0,0,0,1,273,0
157,424,248,0,32,32,0,0,0,1,274,0
157,456,248,0,32,32,0,0,0,1,275,0
157,488,248,0,32,32,0,0,0,1,276,0
157,520,248,0,32,32,0,0,0,1,277,0
157,552,248,0,32,32,0,0,0,1,278,0
157,584,248,0,32,32,0,0,0,1,279,0
157,624,248,0,32,32,0,0,0,1,280,0
157,608,248,0,32,32,0,0,0,1,281,0
157,328,272,0,32,32,0,0,0,1,314,0
157,328,304,0,32,32,0,0,0,1,315,0
157,328,336,0,32,32,0,0,0,1,316,0
157,328,344,0,32,32,0,0,0,1,317,0
157,360,344,0,32,32,0,0,0,1,318,0
157,392,344,0,32,32,0,0,0,1,319,0
157,392,312,0,32,32,0,0,0,1,320,0
157,392,280,0,32,32,0,0,0,1,321,0
157,592,304,0,32,16,0,0,0,1,346,0
157,560,304,0,32,16,0,0,0,1,351,0
157,536,304,0,32,16,0,0,0,1,352,0
157,512,304,0,32,16,0,0,0,1,353,0
157,488,304,0,32,16,0,0,0,1,354,0
157,472,304,0,32,16,0,0,0,1,355,0
157,448,304,0,32,16,0,0,0,1,356,0
157,424,304,0,32,16,0,0,0,1,357,0
157,176,240,0,32,16,0,0,0,1,375,0
157,192,240,0,32,16,0,0,0,1,376,0
157,152,224,0,32,16,0,0,0,1,377,0
157,424,352,0,32,16,0,0,0,1,378,0
157,456,352,0,32,16,0,0,0,1,379,0
157,488,352,0,32,16,0,0,0,1,380,0
157,520,352,0,32,16,0,0,0,1,381,0
157,544,352,0,32,16,0,0,0,1,382,0
157,576,352,0,32,16,0,0,0,1,383,0
157,608,352,0,32,16,0,0,0,1,384,0
157,632,352,0,32,16,0,0,0,1,385,0
157,592,320,0,32,16,0,0,0,1,387,0
157,16,240,0,32,16,0,0,0,1,437,0
157,48,240,0,32,16,0,0,0,1,438,0
157,80,240,0,32,16,0,0,0,1,439,0
157,112,240,0,32,16,0,0,0,1,441,0
157,144,240,0,32,16,0,0,0,1,442,0
157,264,240,0,32,16,0,0,0,1,444,0
157,296,240,0,32,16,0,0,0,1,445,0
157,16,352,0,32,16,0,0,0,1,457,0
157,48,352,0,32,16,0,0,0,1,458,0
157,80,352,0,32,16,0,0,0,1,459,0
157,112,352,0,32,16,0,0,0,1,460,0
157,144,352,0,32,16,0,0,0,1,461,0
157,176,352,0,32,16,0,0,0,1,462,0
157,208,352,0,32,16,0,0,0,1,463,0
157,238,352,0,32,16,0,0,0,1,464,0
157,271,352,0,32,16,0,0,0,1,465,0
157,264,352,0,32,16,0,0,0,1,466,0
157,304,352,0,32,16,0,0,0,1,467,0
157,296,352,0,32,16,0,0,0,1,468,0
157,16,288,0,32,16,0,0,0,1,491,0
157,40,288,0,32,16,0,0,0,1,492,0
157,72,288,0,32,16,0,0,0,1,493,0
157,104,288,0,32,16,0,0,0,1,494,0
157,168,264,0,32,32,0,0,0,1,499,0
157,168,296,0,32,32,0,0,0,1,500,0
169,112,16,0,0,0,0,0,0,1,34,1
172,64,48,0,0,0,0,0,0,0,38,1
172,64,168,0,0,0,0,0,0,0,78,1
172,0,208,0,0,0,0,0,0,1,82,1
172,216,96,0,0,0,0,0,0,1,89,1
172,216,144,0,0,0,0,0,0,1,126,1
172,104,168,0,0,0,0,0,0,1,163,1
169,184,16,0,0,0,0,0,0,1,207,1
169,187,200,0,0,0,0,0,0,0,259,1
172,344,232,0,0,0,0,0,0,1,312,1
172,344,264,0,0,0,0,0,0,1,322,1
172,344,296,0,0,0,0,0,0,1,324,1
172,608,296,0,0,0,0,0,0,1,349,1
155,520,320,0,1,1,0,0,0,1,391,0
155,544,320,0,2,1,0,0,0,1,392,0
172,224,232,0,0,0,0,0,0,1,469,1
172,208,232,0,0,0,0,0,0,1,471,1
169,240,232,0,0,0,0,0,0,0,485,1
172,230,264,0,0,0,0,0,0,0,487,1
169,229,280,0,0,0,0,0,0,0,489,1
172,216,312,0,0,0,0,0,0,0,490,1
166,296,40,0,0,0,0,0,0,1,244,1
166,296,24,0,0,0,0,0,0,1,245,1
166,296,8,0,0,0,0,0,0,1,246,1
166,472,40,0,0,0,0,0,0,1,250,1
166,472,8,0,0,0,0,0,0,1,251,1
166,472,24,0,0,0,0,0,0,1,252,1
166,640,96,0,0,0,200,0,0,1,289,1
166,280,104,0,0,0,337,0,0,1,290,1
166,288,192,0,0,0,0,0,0,1,299,1
166,288,208,0,0,0,0,0,0,1,300,1
166,288,224,0,0,0,0,0,0,1,301,1
166,536,312,0,0,0,272,0,0,1,389,1
1234567890
25,176,176,80,80,0,0,10002,0,0,0,0
25,176,176,80,80,80,0,10002,0,0,0,0
25,176,176,80,80,160,0,10002,0,0,0,0
25,176,176,80,80,240,0,10002,0,0,0,0
25,176,176,80,80,320,0,10002,0,0,0,0
25,176,176,80,80,400,0,10002,0,0,0,0
25,176,176,80,80,480,0,10002,0,0,0,0
25,176,176,80,80,560,0,10002,0,0,0,0
25,176,176,80,80,560,80,10002,0,0,0,0
25,176,176,80,80,480,80,10002,0,0,0,0
25,176,176,80,80,400,80,10002,0,0,0,0
25,176,176,80,80,320,80,10002,0,0,0,0
25,176,176,80,80,240,80,10002,0,0,0,0
25,176,176,80,80,0,80,10002,0,0,0,0
25,176,176,80,80,80,80,10002,0,0,0,0
25,176,176,80,80,160,80,10002,0,0,0,0
25,176,176,80,80,0,160,10002,0,0,0,0
25,176,176,80,80,80,160,10002,0,0,0,0
25,176,176,80,80,160,160,10002,0,0,0,0
25,176,176,80,80,240,160,10002,0,0,0,0
25,176,176,80,80,320,160,10002,0,0,0,0
25,176,176,80,80,400,160,10002,0,0,0,0
25,176,176,80,80,480,160,10002,0,0,0,0
25,176,176,80,80,560,160,10002,0,0,0,0
25,176,176,80,80,0,240,10002,0,0,0,0
25,176,176,80,80,80,240,10002,0,0,0,0
25,176,176,80,80,160,240,10002,0,0,0,0
25,176,176,80,80,240,240,10002,0,0,0,0
25,176,176,80,80,320,240,10002,0,0,0,0
25,176,176,80,80,400,240,10002,0,0,0,0
25,176,176,80,80,560,240,10002,0,0,0,0
25,176,176,80,80,560,320,10002,0,0,0,0
25,176,176,80,80,480,320,10002,0,0,0,0
25,176,176,80,80,480,240,10002,0,0,0,0
25,176,176,80,80,400,320,10002,0,0,0,0
25,176,176,80,80,240,320,10002,0,0,0,0
25,176,176,80,80,160,320,10002,0,0,0,0
25,176,176,80,80,80,320,10002,0,0,0,0
25,176,176,80,80,0,320,10002,0,0,0,0
987654321
KgE5ERMxQw==
FAwuBgQ=
Aww=
Aww

