UVx6TlN0AGU9Z3lCMkJDPxgLaV1LEBxNHmx0VA59PFliZml8NTgheng=
259,512,96,0,256,160,0,0,0,1,116,0
259,472,312,0,128,32,0,0,0,1,118,0
259,440,256,0,192,144,0,0,0,1,146,0
259,472,208,0,128,80,0,0,0,1,150,0
259,584,256,0,96,160,0,0,0,1,153,0
160,472,232,0,0,8454016,0,0,0,1,43,0
224,136,64,0,24,8454016,0,0,0,1,152,0
218,416,176,0,256,0,0,293,0,1,137,0
224,256,216,0,124,0,0,0,0,1,136,0
100,520,256,0,256,255,0,195,0,1,113,0
218,520,176,0,256,0,0,254,0,1,138,0
100,312,104,0,256,8454016,0,311,0,1,135,0
195,616,184,0,0,80,237,144,160,1,140,0
224,592,208,0,76,255,0,0,0,1,174,0
197,264,296,0,2,129,0,0,0,1,126,0
197,512,240,0,4,0,0,0,0,1,45,0
197,432,240,0,4,0,0,0,0,1,44,0
174,408,144,0,1,0,0,0,0,0,72,1
174,504,144,0,1,180,0,0,0,0,75,1
174,536,144,0,1,189,0,0,0,0,76,1
174,473,144,0,1,186,0,0,0,0,74,1
174,441,144,0,1,189,0,0,0,0,73,1
174,136,72,0,1,56,58,53,0,0,55,1
205,459.50,296,0,1,0,0.50,0,0,1,114,0
219,72,121,0,32,32,0,0,0,1,49,1
219,72,216,0,32,32,0,0,0,1,51,1
219,280,152,0,32,32,0,0,0,1,61,1
186,200,232,0,32,32,0,0,0,1,64,0
219,72,280,0,32,32,0,0,0,1,69,1
219,296,304,0,32,16,0,0,0,1,70,1
219,360,88,0,32,32,0,0,0,1,123,1
219,304,176,0,16,16,0,0,0,1,134,1
220,592,160,0,32,32,0,0,0,0,186,1
220,592,160,0,32,32,0,0,0,0,180,1
219,592,160,0,32,32,0,0,0,1,185,1
219,280,88,0,32,32,0,0,0,1,53,1
220,168,88,0,32,32,0,0,0,0,58,1
220,168,304,0,96,16,0,0,0,0,129,1
188,240,296,0,0,107,164,163,0,1,66,0
242,328,136,0,32,32,0,0,0,1,167,0
242,352,280,0,32,32,0,0,0,1,168,0
242,504,224,0,32,32,0,0,0,1,171,0
176,520,312,0,153,32,32,0,0,1,155,0
176,520,328,0,154,32,32,0,0,1,156,0
176,352,296,0,146,32,64,0,0,1,147,0
176,384,128,0,98,32,32,0,0,1,100,0
176,384,128,0,92,32,32,0,0,1,90,0
176,384,128,0,93,32,32,0,0,1,91,0
176,384,128,0,99,32,32,0,0,1,97,0
176,592,128,0,155,32,32,0,0,1,157,0
176,592,128,0,153,32,32,0,0,1,154,0
176,328,136,0,161,32,32,0,0,1,117,0
176,576,224,0,150,96,32,0,0,1,151,0
175,488,112,0,89,30,0,0,0,0,92,0
175,520,112,0,94,20,0,0,0,0,93,0
175,456,112,0,96,15,0,0,0,0,98,0
175,552,112,0,95,25,0,0,0,0,99,0
175,360,120,0,116,15,0,0,0,0,161,0
273,328,56,0,185,0,0,0,0,1,189,0
154,558.40,320,1,1,0.90,16,16,-1,1,21,1
154,592.70,216.47,0,2,0.50,16,16,-1,1,144,1
158,120,184,0,0,8454016,0,1,0,1,33,0
216,520,136,0,50,0,1,0,0,1,94,0
216,552,136,0,51,0,1,0,0,1,95,0
216,488,136,0,50,0,1,0,0,1,89,0
216,456,136,0,51,0,1,0,0,1,96,0
157,320,344,0,640,32,0,0,0,1,12,0
157,8,168,0,16,320,0,0,0,1,13,0
157,320,16,0,640,32,0,0,0,1,14,0
157,632,168,0,16,320,0,0,0,1,15,0
157,72,168,0,32,64,0,0,0,1,16,0
157,120,192,0,64,16,0,0,0,1,29,0
157,168,168,0,32,64,0,0,0,1,30,0
157,104,88,0,96,32,0,0,0,1,31,0
157,200,152,0,32,32,0,0,0,1,34,0
157,472,160,0,176,32,0,0,0,1,39,0
157,400,208,0,32,64,0,0,0,1,40,0
157,544,200,0,32,48,0,0,0,1,41,0
157,472,248,0,208,16,0,0,0,1,42,0
157,224,88,0,80,32,0,0,0,1,46,0
157,80,249,0,48,32,0,0,0,1,52,0
157,320,88,0,48,32,0,0,0,1,54,0
157,256,152,0,16,32,0,0,0,1,60,0
157,184,240,0,64,16,0,0,0,1,62,0
157,248,304,0,64,16,0,0,0,1,63,0
157,88,304,0,64,16,0,0,0,1,68,0
157,344,304,0,64,16,0,0,0,1,71,0
157,616,160,0,16,32,0,0,0,1,81,0
157,568,160,0,16,32,0,0,0,1,82,0
157,304,136,0,16,64,0,0,0,1,84,0
157,392,72,0,32,64,0,0,0,1,85,0
157,312,192,0,32,16,0,0,0,1,101,0
157,376,152,0,16,16,0,0,0,1,102,0
157,376,216,0,16,16,0,0,0,1,104,0
157,336,224,0,16,80,0,0,0,1,106,0
157,464,304,0,112,16,0,0,0,1,109,0
157,528,280,0,16,64,0,0,0,1,111,0
157,552,272,0,48,16,0,0,0,1,115,0
157,616,248,0,16,16,0,0,0,1,121,0
157,616,272,0,16,16,0,0,0,1,122,0
157,328,160,0,32,16,0,0,0,1,132,0
155,40,40,0,1,1,0,0,0,1,19,0
155,40,320,0,2,1,0,0,0,1,20,0
155,600,320,0,3,1,0,0,0,1,23,0
155,600,40,0,4,1,0,0,0,1,24,0
172,216,136,0,0,0,0,0,0,1,56,1
169,328,264,0,0,0,0,0,0,1,107,1
155,568,200,0,1,2,0,0,0,1,142,0
155,616,232,0,2,2,5,0,0,1,143,0
166,557.50,320,0,21,0,0,0,0,1,25,1
166,557.50,320,0,21,0,180,0,0,1,26,1
166,557.50,320,0,21,0,90,0,0,1,27,1
166,557.50,320,0,21,0,270,0,0,1,28,1
166,288,176,0,0,21,0,0,0,1,59,1
166,416,232,0,0,0,0,0,0,0,160,1
166,88,288,0,0,0,0,0,0,0,163,1
166,88,272,0,0,0,0,0,0,0,164,1
1234567890
25,400,48,64,48,16,32,10002,0,0,0,0
25,400,48,64,48,80,32,10002,0,0,0,0
25,400,48,64,48,144,32,10002,0,0,0,0
25,400,48,64,48,208,32,10002,0,0,0,0
25,400,48,64,48,272,32,10002,0,0,0,0
25,400,48,64,48,336,32,10002,0,0,0,0
25,400,48,64,48,400,32,10002,0,0,0,0
25,400,48,64,48,464,32,10002,0,0,0,0
25,400,48,64,48,528,32,10002,0,0,0,0
25,400,48,64,48,592,32,10002,0,0,0,0
25,400,48,64,48,16,80,10002,0,0,0,0
25,400,48,64,48,16,128,10002,0,0,0,0
25,400,48,64,48,16,176,10002,0,0,0,0
25,400,48,64,48,16,224,10002,0,0,0,0
25,400,48,64,48,16,272,10002,0,0,0,0
25,400,48,64,48,16,320,10002,0,0,0,0
25,400,48,64,48,80,320,10002,0,0,0,0
25,400,48,64,48,144,320,10002,0,0,0,0
25,400,48,64,48,208,320,10002,0,0,0,0
25,400,48,64,48,272,320,10002,0,0,0,0
25,400,48,64,48,336,320,10002,0,0,0,0
25,400,48,64,48,400,320,10002,0,0,0,0
25,400,48,64,48,464,320,10002,0,0,0,0
25,400,48,64,48,528,320,10002,0,0,0,0
25,400,48,64,48,592,320,10002,0,0,0,0
25,400,48,64,48,528,80,10002,0,0,0,0
25,400,48,64,48,400,80,10002,0,0,0,0
25,400,48,64,48,272,80,10002,0,0,0,0
25,400,48,64,48,144,80,10002,0,0,0,0
25,400,48,64,48,144,128,10002,0,0,0,0
25,400,48,64,48,80,128,10002,0,0,0,0
25,400,48,64,48,80,224,10002,0,0,0,0
25,400,48,64,48,144,224,10002,0,0,0,0
25,400,48,64,48,144,176,10002,0,0,0,0
25,400,48,64,48,144,272,10002,0,0,0,0
25,400,48,64,48,272,272,10002,0,0,0,0
25,400,48,64,48,272,224,10002,0,0,0,0
25,400,48,64,48,208,224,10002,0,0,0,0
25,400,48,64,48,208,128,10002,0,0,0,0
25,400,48,64,48,272,128,10002,0,0,0,0
25,400,48,64,48,272,176,10002,0,0,0,0
25,400,48,64,48,336,128,10002,0,0,0,0
25,400,48,64,48,336,224,10002,0,0,0,0
25,400,48,64,48,528,224,10002,0,0,0,0
25,400,48,64,48,592,224,10002,0,0,0,0
25,400,48,64,48,528,128,10002,0,0,0,0
25,400,48,64,48,592,128,10002,0,0,0,0
25,400,48,64,48,400,272,10002,0,0,0,0
25,400,48,64,48,528,272,10002,0,0,0,0
25,400,48,64,48,464,128,10002,0,0,0,0
25,400,48,64,48,400,128,10002,0,0,0,0
25,16,240,32,16,416,224,10002,0,0,0,0
25,16,240,32,16,448,224,10002,0,0,0,0
25,16,240,32,16,496,224,10002,0,0,0,0
25,400,48,64,48,528,176,10002,0,0,0,0
25,16,240,32,16,496,176,10002,0,0,0,0
25,16,240,32,16,464,176,10002,0,0,0,0
25,16,240,32,16,432,176,10002,0,0,0,0
25,16,240,32,16,400,176,10002,0,0,0,0
987654321
PikYMDI=

