UVx6TlN0AGU9Z15aOlN3O1AldVFPUgRnKlEmVA59PFliZml8NTgheng=
160,40,336,0,0,16777215,0,0,0,1,11,0
224,504,32,0,128,0,0,0,0,0,148,0
100,632,120,0,256,65318,0,90,0,0,185,0
123,304,64,0,128,0,0,0,0,0,54,0
100,480,128,0,256,65280,0,270,0,0,190,0
100,488,128,0,256,0,0,213,0,0,42,0
123,499,318,0,128,0,0,0,0,0,435,0
123,352,232,0,128,0,0,0,0,0,307,0
123,625,315,0,128,0,0,0,0,1,460,0
224,88,320,0,128,0,0,0,0,0,498,0
123,344,296,0,128,0,0,0,0,0,445,0
224,504,240,0,128,0,0,0,0,0,304,0
100,128,32,0,248,0,0,230,0,1,5,0
224,320,136,0,128,0,0,0,0,0,249,0
123,192,104,0,128,0,0,0,0,0,23,0
224,208,224,0,128,0,0,0,0,0,303,0
197,80,136,0,2,488,0,0,0,1,492,0
174,456,72,0,1,481,307,303,304,0,480,1
174,625,120,0,1,180,190,54,0,0,176,1
174,112,176,0,1,486,23,54,249,0,493,1
174,408,72,0,1,24,5,23,42,0,71,1
174,240,144,0,1,24,249,148,185,0,83,1
174,591,336,0,1,448,450,435,445,0,454,1
174,576,280,0,1,418,0,148,185,0,420,1
205,615.50,232,0,1,0,0.50,0,0,1,399,0
205,400.50,72,0,1,0,0.50,0,0,1,28,0
205,549,336,0,1,0,0.50,0,0,1,434,0
205,8.50,136,0,1,0,0.50,0,0,1,20,0
205,239.50,232,0,1,0,0.50,0,0,1,366,0
186,224,336,0,32,32,0,0,0,1,453,0
188,248,72,0,0,0,0,0,24,1,30,0
188,256,264,0,0,310,0,0,0,1,320,0
185,536,168,0,0,16,1,0,0,1,161,0
185,576,168,0,0,16,1,0,0,1,163,0
185,592,168,0,0,16,1,0,0,1,165,0
185,552,168,0,0,16,1,0,0,1,403,0
185,616,168,0,0,16,1,0,0,1,404,0
185,512,168,0,0,16,1,0,0,1,405,0
242,192,56,0,32,32,0,0,0,1,206,0
242,240,128,0,32,32,0,0,0,1,208,0
242,480,216,0,32,32,0,0,0,1,210,0
242,480,56,0,32,32,0,0,0,1,212,0
242,208,248,0,32,32,0,0,0,1,291,0
242,248,320,0,32,32,0,0,0,1,495,0
154,310.50,248,0,3,0.50,32,32,1,1,334,1
154,365,240,0,1,0.50,64,16,1,1,340,1
158,24,72,0,0,16777215,0,1,0,1,10,0
210,616,336,0,0,0,0,0,0,1,444,0
210,312,336,0,463,0,0,0,0,1,457,0
210,360,336,0,427,0,0,0,0,1,441,0
210,248,336,0,0,0,0,0,0,1,463,0
210,176,168,0,246,0,0,0,0,1,16,0
210,168,72,0,0,0,0,0,0,1,246,0
210,168,264,0,444,0,0,0,0,1,427,0
157,288,352,0,720,32,0,0,0,1,243,0
157,320,8,0,640,32,0,0,0,1,2,0
157,48,88,0,96,32,0,0,0,1,3,0
157,144,64,0,32,80,0,0,0,1,4,0
157,296,184,0,336,32,0,0,0,1,6,0
157,48,160,0,96,48,0,0,0,1,7,0
157,144,152,0,32,32,0,0,0,1,8,0
157,224,88,0,128,32,0,0,0,1,17,0
157,208,144,0,32,80,0,0,0,1,18,0
157,224,72,0,32,32,0,0,0,1,41,0
157,432,64,0,32,80,0,0,0,1,56,0
157,432,96,0,32,80,0,0,0,1,76,0
157,240,160,0,32,32,0,0,0,1,85,0
157,392,80,0,144,16,0,0,0,1,93,0
157,392,104,0,144,16,0,0,0,1,94,0
157,392,130,0,144,16,0,0,0,1,95,0
157,504,136,0,16,128,0,0,0,1,135,0
157,544,152,0,16,96,0,0,0,1,150,0
157,584,136,0,16,128,0,0,0,1,152,0
157,632,160,0,32,80,0,0,0,1,153,0
157,632,32,0,32,80,0,0,0,1,171,0
157,0,176,0,16,352,0,0,0,1,198,0
157,640,200,0,16,352,0,0,0,1,200,0
157,288,272,0,288,16,0,0,0,1,267,0
157,232,256,0,16,48,0,0,0,1,285,0
157,608,256,0,48,48,0,0,0,1,396,0
157,568,192,0,144,16,0,0,0,1,406,0
157,536,240,0,144,16,0,0,0,1,412,0
157,600,288,0,368,16,0,0,0,1,421,0
157,136,216,0,16,128,0,0,0,1,426,0
157,424,272,0,16,48,0,0,0,1,430,0
157,280,312,0,32,64,0,0,0,1,437,0
157,344,328,0,16,48,0,0,0,1,458,0
157,72,308,0,16,80,0,0,0,1,464,0
157,600,296,0,368,16,0,0,0,1,472,0
157,64,184,0,144,16,0,0,0,1,490,0
172,288,72,0,0,0,0,0,0,1,24,1
172,464,168,0,0,0,0,0,0,1,180,1
155,264,248,0,1,3,20,0,0,1,332,0
155,320,248,0,2,3,0,0,0,1,333,0
155,320,240,0,1,1,0,0,0,1,338,0
155,432,240,0,2,1,0,0,0,1,339,0
169,496,200,0,0,0,0,0,0,0,418,1
169,560,304,0,0,0,0,0,0,1,448,1
169,416,304,0,0,0,0,0,0,1,450,1
172,464,184,0,0,0,0,0,0,1,481,1
169,136,104,0,0,0,0,0,0,1,486,1
172,96,136,0,0,0,0,0,0,1,488,1
166,152,216,0,0,0,0,0,0,0,310,1
1234567890
25,240,48,16,16,-32,32,10002,0,0,0,0
25,240,48,16,16,-16,48,10002,0,0,0,0
25,208,48,32,64,32,272,10002,0,0,0,0
25,208,48,32,64,64,272,10002,0,0,0,0
25,208,48,32,64,112,288,10002,0,0,0,0
25,208,48,32,64,176,288,10002,0,0,0,0
25,208,48,32,64,208,288,10002,0,0,0,0
25,208,48,32,64,416,304,10002,0,0,0,0
25,208,48,32,64,640,288,10002,0,0,0,0
25,208,48,32,64,352,240,10002,0,0,0,0
25,208,48,32,64,496,240,10002,0,0,0,0
25,208,48,32,64,656,192,10002,0,0,0,0
25,208,48,32,64,592,192,10002,0,0,0,0
25,208,48,32,64,128,208,10002,0,0,0,0
25,208,48,32,64,160,192,10002,0,0,0,0
25,208,48,32,64,272,176,10002,0,0,0,0
25,208,48,32,64,512,144,10002,0,0,0,0
25,208,48,32,64,192,128,10002,0,0,0,0
25,208,48,32,64,224,112,10002,0,0,0,0
25,208,48,32,64,352,96,10002,0,0,0,0
25,208,48,32,64,272,96,10002,0,0,0,0
25,208,48,32,64,416,80,10002,0,0,0,0
25,208,48,32,64,496,80,10002,0,0,0,0
25,208,48,32,64,624,32,10002,0,0,0,0
25,208,48,32,64,560,16,10002,0,0,0,0
25,208,48,32,64,480,16,10002,0,0,0,0
25,208,48,32,64,416,16,10002,0,0,0,0
25,208,48,32,64,208,16,10002,0,0,0,0
25,208,48,32,64,272,16,10002,0,0,0,0
25,208,48,32,64,336,16,10002,0,0,0,0
25,208,48,32,64,304,32,10002,0,0,0,0
25,208,48,32,64,240,48,10002,0,0,0,0
25,208,48,32,64,128,64,10002,0,0,0,0
25,208,48,32,64,160,64,10002,0,0,0,0
25,208,48,32,64,96,16,10002,0,0,0,0
25,208,48,32,64,0,16,10002,0,0,0,0
25,208,48,32,64,64,16,10002,0,0,0,0
25,208,48,32,64,96,96,10002,0,0,0,0
25,208,48,32,64,16,96,10002,0,0,0,0
987654321
Vg==
VQ==
VA==
Uw==

