UVx6TlN0AGU9Z2xFMllIKVwlN3BPDDRxDWB2FEo5IEV+enVgKSQ9ZmRjbV8=
259,251,288,0,32,32,0,0,0,1,557,0
259,192,152,0,64,368,0,0,0,1,850,0
259,296,288,0,272,128,0,0,0,1,873,0
259,320,160,0,208,128,0,0,0,1,914,0
259,336,312,0,352,80,0,0,0,1,932,0
259,536,224,0,240,320,0,0,0,1,951,0
259,0,64,0,32,32,0,0,0,1,1009,0
160,505,52,0,1,16777215,0,0,0,1,646,0
100,192,320,0,256,0,0,92,0,1,147,0
100,568,32,0,256,0,0,292,0,0,625,0
100,521,10,0,164,0,0,242,0,0,647,0
100,512,136,0,244,0,0,273,0,1,616,0
224,96,192,0,96,0,0,0,0,1,941,0
100,376,328,0,264,0,0,88,0,1,125,0
100,168,224,0,104,0,0,301,0,1,146,0
178,140.15,16,0,32,32,0,0,0,0,997,0
100,259,240,0,124,0,0,335,0,1,199,0
100,111,11,0,256,0,66,236,0,1,48,0
218,184,72,0,244,0,0,270,0,1,942,0
100,256,136,0,256,0,0,267,0,1,533,0
195,144,16,0,0,128,230,66,1007,1,1006,0
100,288,136,0,108,0,0,265,0,1,534,0
197,248,96,0,4,0,0,0,0,1,555,0
174,296,328,0,1,144,141,112,0,0,88,1
174,96,72,0,1,53,76,77,78,0,55,1
194,608,24,0,0,148,211,0,0,0,623,0
181,500,160,0,614,128,0,0,0,1,610,0
205,360,328,0,1,0,0.35,0,0,0,99,0
181,283.50,256,0,138,128,0,0,0,1,140,0
189,232,120,0,0,104,284,496,0,1,478,0
186,380,224,0,32,32,0,0,0,1,174,0
219,560,248,0,16,16,0,0,0,1,554,1
219,448,184,0,16,16,0,0,0,1,617,1
219,608,272,0,16,16,0,0,0,1,547,1
219,576,296,0,16,16,0,0,0,1,546,1
219,472,240,0,64,16,0,0,0,1,548,1
219,520,144,0,48,16,0,0,0,1,618,1
220,456,48,0,32,16,0,0,0,0,649,1
220,416,48,0,32,16,0,0,0,0,679,1
220,376,48,0,32,16,0,0,0,0,680,1
188,476,328,0,0,369,0,0,0,1,238,0
188,400,328,0,0,112,428,0,0,1,100,0
185,192,328,0,0,32,1,0,0,1,82,0
185,448,264,0,0,16,1,0,0,1,549,0
185,472,264,0,0,16,1,0,0,1,550,0
185,496,264,0,0,16,1,0,0,1,551,0
185,576,320,0,0,16,1,0,0,1,552,0
185,608,296,0,0,16,1,0,0,1,553,0
185,463,56,0,0,16,1,0,0,1,648,0
185,432,56,0,0,16,1,0,0,1,676,0
185,405,56,0,0,16,1,0,0,1,677,0
185,376,56,0,0,16,1,0,0,1,678,0
242,96,104,0,32,32,0,0,0,1,93,0
242,376,264,0,32,32,0,0,0,1,567,0
242,536,312,0,32,32,0,0,0,1,622,0
242,615,113,0,32,32,0,0,0,1,826,0
242,340,33,0,32,32,0,0,0,1,833,0
176,576,96,0,623,32,32,0,0,1,667,0
176,536,312,0,609,32,32,0,0,1,900,0
176,536,312,0,619,32,32,0,0,1,903,0
176,536,312,0,589,32,32,0,0,1,901,0
176,536,312,0,618,32,32,0,0,1,960,0
176,536,312,0,580,32,32,0,0,1,902,0
176,536,312,0,625,32,32,0,0,1,972,0
176,536,312,0,647,32,32,0,0,1,981,0
176,617,112,0,689,32,32,0,0,1,961,0
176,616,112,0,691,32,32,0,0,1,963,0
176,616,112,0,690,32,32,0,0,1,962,0
176,248,280,0,99,32,32,0,0,1,899,0
176,96,104,0,79,32,32,0,0,1,923,0
175,192,128,0,71,100,1,0,0,0,76,0
175,192,152,0,72,100,1,0,0,0,77,0
175,192,176,0,73,100,1,0,0,0,78,0
175,192,200,0,74,300,1,0,0,0,79,0
175,616,240,0,547,60,1,0,0,0,580,0
175,576,264,0,546,60,1,0,0,0,589,0
175,448,208,0,548,60,1,0,0,0,609,0
175,520,92,0,618,60,1,0,0,0,619,0
175,384,80,0,680,60,1,0,0,0,689,0
175,419,78,0,679,80,1,0,0,0,690,0
175,448,80,0,649,60,1,0,0,0,691,0
154,101.78,184,0,1,0.26,25,24,1,1,27,1
154,71.90,152,0,2,0.30,32,24,1,1,33,1
154,72.96,88.91,0,4,0.50,8,8,-1,1,66,1
154,197.55,288,0,5,0.35,16,16,1,1,85,1
154,250.50,256,0,6,0.50,16,16,-1,1,138,1
154,235.61,334.17,0,7,0.50,16,16,-1,1,496,1
154,506.50,160,0,8,0.50,16,16,-1,1,614,1
158,56,144,0,0,16777215,0,1,0,1,7,0
210,536,328,0,0,0,0,0,0,1,545,0
216,560,200,0,72,0,0,0,0,1,608,0
216,272,256,0,71,0,0,0,0,1,607,0
210,264,224,0,545,0,0,0,0,1,390,0
216,272,56,0,79,0,0,0,0,1,598,0
157,144,344,0,296,32,0,0,0,1,38,0
157,464,344,0,1272,32,0,0,0,1,2,0
157,80,320,0,32,24,0,0,0,1,8,0
157,48,256,0,96,32,0,0,0,1,13,0
157,144,320,0,48,96,0,0,0,1,14,0
157,152,200,0,32,144,0,0,0,1,19,0
157,56,200,0,32,24,0,0,0,1,20,0
157,0,272,0,40,352,0,0,0,1,21,0
157,120,120,0,96,16,0,0,0,1,24,0
157,0,144,0,40,96,0,0,0,1,41,0
157,96,72,0,24,8,0,0,0,1,49,0
157,192,32,0,80,96,0,0,0,1,62,0
157,216,152,0,32,144,0,0,0,1,70,0
157,272,320,0,16,96,0,0,0,1,87,0
157,312,280,0,64,16,0,0,0,1,101,0
157,336,288,0,16,32,0,0,0,1,102,0
157,256,232,0,112,16,0,0,0,1,131,0
157,232,320,0,16,96,0,0,0,1,132,0
157,253,344,0,48,96,0,0,0,1,133,0
157,376,288,0,16,16,0,0,0,1,155,0
157,368,232,0,48,16,0,0,0,1,163,0
157,432,264,0,16,64,0,0,0,1,164,0
157,504,312,0,16,32,0,0,0,1,243,0
157,472,288,0,80,16,0,0,0,1,252,0
157,304,208,0,16,32,0,0,0,1,269,0
157,432,184,0,16,96,0,0,0,1,282,0
157,328,184,0,64,16,0,0,0,1,293,0
157,392,136,0,96,16,0,0,0,1,399,0
157,264,168,0,16,16,0,0,0,1,532,0
157,288,104,0,112,16,0,0,0,1,543,0
157,352,112,0,16,32,0,0,0,1,544,0
157,640,192,0,16,720,0,0,0,1,620,0
157,592,136,0,80,16,0,0,0,1,621,0
157,592,72,0,16,16,0,0,0,1,624,0
157,432,120,0,16,32,0,0,0,1,634,0
157,328,56,0,64,16,0,0,0,1,643,0
157,536,16,0,16,112,0,0,0,1,644,0
157,512,64,0,64,16,0,0,0,1,645,0
157,448,112,0,48,16,0,0,0,1,658,0
157,408,0,0,1280,16,0,0,0,1,749,0
157,0,256,0,32,368,1,0,0,1,44,0
157,8,32,0,16,48,0,0,0,1,1008,0
155,88,184,0,1,1,0,0,0,1,25,0
155,128,184,0,2,1,0,0,0,1,26,0
155,56,152,0,1,2,0,0,0,1,31,0
155,80,152,0,2,2,0,0,0,1,32,0
169,152,80,0,0,0,0,0,0,1,53,1
155,48,80,0,1,4,0,0,0,1,64,0
155,160,120,0,2,4,0,0,0,1,65,0
155,184,288,0,1,5,0,0,0,1,83,0
155,200,288,0,2,5,0,0,0,1,84,0
169,328,304,0,0,0,0,0,0,1,112,1
155,224,256,0,1,6,0,0,0,1,136,0
155,352,256,0,2,6,0,0,0,1,137,0
172,312,224,0,0,0,0,0,0,1,141,1
169,424,296,0,0,0,0,0,0,1,144,1
169,344,144,0,0,0,0,0,0,1,428,1
155,216,352,0,1,7,0,0,0,1,494,0
155,392,192,0,2,7,0,0,0,1,495,0
155,480,160,0,1,8,0,0,0,1,612,0
155,616,160,0,2,8,0,0,0,1,613,0
166,104,128,0,0,0,270,0,0,1,23,1
166,80,128,0,0,0,270,0,0,1,29,1
166,168,128,0,0,0,0,0,0,0,71,1
166,168,152,0,0,0,2,0,0,0,72,1
166,168,176,0,0,0,0,0,0,0,73,1
166,168,200,0,0,0,0,0,0,0,74,1
166,232,184,0,0,0,0,0,0,1,369,1
166,8,64,0,0,0,2,0,0,0,1007,1
253,76,244,0,16777215,0,0,0,0,1,15,0
253,52,244,0,16777215,0,0,0,0,1,16,0
253,28,244,0,16777215,0,0,0,0,1,17,0
253,128,287,0,16711680,0,3,0,0,1,68,0
253,80,312,0,16777215,0,0,0,0,1,69,0
253,12,112,0,16711680,0,2,0,0,1,356,0
253,352,136,0,16777215,0,0,0,0,1,568,0
253,376,288,0,16777215,0,0,0,0,1,569,0
253,264,232,0,16777215,0,0,0,0,1,570,0
253,264,168,0,16777215,0,0,0,0,1,571,0
253,234,272,0,16777215,0,0,0,0,1,700,0
196,168.50,127.50,0,0,0,0,0,0,0,0,0
196,168.50,151.50,0,0,0,0,0,0,0,0,0
196,168.50,175.50,0,0,0,0,0,0,0,0,0
1234567890
24,192,336,16,16,48,288,10000,0,0,0,0
24,192,320,16,16,48,272,10000,0,0,0,0
24,160,320,16,16,16,272,10000,0,0,0,0
24,160,336,16,16,16,288,10000,0,0,0,0
24,176,320,16,16,32,272,10000,0,0,0,0
24,176,336,16,16,32,288,10000,0,0,0,0
25,96,256,48,48,16,272,10002,0,0,0,0
25,96,256,48,48,64,272,10002,0,0,0,0
25,48,256,48,48,16,320,10002,0,0,0,0
25,48,256,48,48,64,320,10002,0,0,0,0
25,48,256,48,48,112,272,10002,0,0,0,0
25,48,256,48,48,112,320,10002,0,0,0,0
25,48,256,48,48,112,224,10002,0,0,0,0
25,48,256,48,48,112,176,10002,0,0,0,0
25,48,256,48,48,112,128,10002,0,0,0,0
25,48,256,48,48,64,224,10002,0,0,0,0
25,48,256,48,48,16,224,10002,0,0,0,0
25,48,256,48,48,64,176,10002,0,0,0,0
25,48,256,48,48,16,176,10002,0,0,0,0
25,48,256,48,48,64,128,10002,0,0,0,0
25,48,256,48,48,16,128,10002,0,0,0,0
25,48,256,48,48,16,80,10002,0,0,0,0
25,48,256,48,48,64,80,10002,0,0,0,0
25,48,256,48,48,112,80,10002,0,0,0,0
25,48,256,48,48,112,32,10002,0,0,0,0
25,48,256,48,48,64,32,10002,0,0,0,0
25,48,256,48,48,16,32,10002,0,0,0,0
25,48,256,48,48,16,-16,10002,0,0,0,0
25,48,256,48,48,64,-16,10002,0,0,0,0
25,48,256,48,48,112,-16,10002,0,0,0,0
24,80,32,16,64,48,144,10000,0,0,0,0
24,64,32,16,32,64,176,10000,0,0,0,0
24,432,64,32,32,384,240,10000,0,0,0,0
25,176,176,64,80,160,80,10002,0,0,0,0
25,176,176,64,80,160,160,10002,0,0,0,0
25,176,176,64,80,160,240,10002,0,0,0,0
25,176,176,64,80,160,320,10002,0,0,0,0
25,176,176,64,80,224,240,10002,0,0,0,0
25,176,176,64,80,288,240,10002,0,0,0,0
25,176,176,64,80,352,240,10002,0,0,0,0
25,176,176,16,80,416,240,10002,0,0,0,0
25,176,240,80,16,272,320,10002,0,0,0,0
25,176,240,80,16,352,320,10002,0,0,0,0
25,176,176,32,80,384,160,10002,0,0,0,0
25,176,176,32,80,352,144,10002,0,0,0,0
25,176,176,48,32,304,192,10002,0,0,0,0
25,240,176,16,80,416,160,10002,0,0,0,0
25,176,176,48,16,384,144,10002,0,0,0,0
987654321
LkgiDRAnEDBqPi1LPUFCIxQ4c1FdXjxHD2B7WFclf1U6Kys0JXZkImZ9b08rFmI6TyV6Nk4=

