Vl16VkxwAHk1ZzUCAE5fHUYpflYCMAV2KiknVA59PFliZml8NTgh
259,32,1920,0,32,32,0,0,0,1,30,0
259,32,1968,0,32,64,0,0,0,1,42,0
259,376,1984,0,600,150,0,0,0,1,50,0
259,664,2000,0,600,150,0,0,0,1,51,0
259,800,1577,0,48,104,0,0,0,1,58,0
259,812,1320,0,32,64,0,0,0,1,249,0
259,792,1120,0,320,320,0,0,0,1,513,0
259,912,896,0,80,144,0,0,0,1,514,0
259,1288,1304,0,400,1456,0,0,0,1,515,0
259,232,1552,0,496,288,0,0,0,1,516,0
259,557,1272,0,160,560,0,0,0,1,519,0
259,224,1120,0,528,256,0,0,0,1,520,0
259,40,672,0,112,656,0,0,0,1,521,0
259,552,416,0,944,336,0,0,0,1,522,0
259,1248,448,0,448,288,0,0,0,1,524,0
160,752,880,0,0,65280,0,0,0,1,10,0
195,680,1360,0,0,156,272,241,245,1,237,0
195,696,624,0,0,160,319,0,360,1,359,0
100,752,1352,0,396,0,0,270,0,1,215,0
100,560,1592,0,576,255,0,270,0,0,64,0
100,680,1632,0,256,0,0,270,0,0,121,0
123,384,1776,0,172,0,0,0,0,0,3,0
123,128,1776,0,184,0,0,0,0,0,2,0
178,800,1577,0,48,104,0,0,0,0,77,0
123,760,672,0,128,0,0,0,0,0,360,0
197,1052,1289,0,2,280,0,0,0,1,269,0
197,177,792,0,2,441,0,0,0,1,453,0
197,936,1450,0,1,202,0,0,0,1,207,0
197,804,880,0,1,0,0,0,0,1,497,0
197,1053,1812,0,1,542,0,0,0,1,150,0
197,1038,664,0,3,310,0,0,0,1,308,0
174,833,880,0,1,498,500,502,0,0,496,0
174,987,1735,0,0,316,148,0,0,0,542,0
193,560,1656,0,0,47,56,0,0,0,73,1
193,504,1712,0,1,82,285,327,105,1,80,1
174,896,664,0,1,298,0,0,0,1,310,0
205,808,1335,0,-1,0,0.90,0,0,1,214,0
205,832,1448,0,-1,0,0.50,0,0,0,225,0
205,904.50,736,0,1,0,0.50,0,0,1,341,0
189,560,1576,0,0,200,270,0,0,1,65,0
181,87,1800,0,119,261,317,0,0,1,114,0
220,632,1848,0,8,8,0,0,0,0,43,1
186,368,880,0,32,32,0,0,0,1,459,0
186,296,792,0,32,32,0,0,0,1,460,0
186,232,680,0,32,32,0,0,0,1,461,0
186,800,1620,0,32,32,0,0,0,1,57,0
219,1000,728,0,16,240,0,0,0,1,298,0
219,284,888,0,224,16,0,0,0,1,443,1
219,284,800,0,224,16,0,0,0,1,441,1
188,528,792,0,0,491,0,0,0,1,494,0
188,640,792,0,0,355,0,0,0,1,358,0
188,568,792,0,0,490,0,0,0,1,493,0
188,520,1712,0,0,64,0,0,0,1,99,0
188,552,1712,0,0,64,0,0,0,1,98,0
188,536,1712,0,0,64,0,0,0,1,96,0
188,568,1712,0,0,64,0,0,0,1,62,0
188,584,1712,0,0,64,0,0,0,1,95,0
188,600,1712,0,0,64,0,0,0,1,97,0
188,636,1610,0,90,159,0,0,0,1,163,0
188,752,792,0,0,355,0,0,0,1,357,0
188,616,1712,0,0,84,93,144,121,1,7,0
188,608,792,0,0,489,0,0,0,1,492,0
188,32,1936,0,0,36,321,0,0,1,29,0
188,32,1936,0,0,562,563,565,578,1,564,0
188,816,736,0,0,338,342,345,0,1,344,0
185,32,1952,0,0,16,-1,0,0,1,40,0
185,938,1096,0,0,64,1,0,0,1,291,0
242,264,1760,0,32,32,0,0,0,1,552,0
176,800,1808,0,48,312,32,0,0,1,69,0
176,312,1912,0,3,64,32,0,0,1,112,0
176,216,1912,0,2,64,32,0,0,1,111,0
176,32,1888,0,30,32,32,0,0,1,33,0
176,1004,1827,0,192,80,32,0,0,1,186,0
175,304,1960,0,43,360,0,0,0,0,36,0
175,744,1640,0,77,60,0,0,0,0,82,0
273,720,1744,0,47,1,0,0,0,1,93,0
273,912,1768,0,142,1,0,0,0,1,144,0
175,680,1728,0,148,60,0,0,0,0,159,0
175,1008,1880,0,180,60,0,0,0,0,192,0
175,992,1672,0,198,60,1,0,0,0,316,0
175,160,1824,0,525,360,0,0,0,0,321,0
289,504,1616,0,73,0,0,0,0,1,327,0
175,152,1880,0,566,90,0,0,0,0,562,0
175,114,1867,0,567,180,0,0,0,0,563,0
175,89,1833,0,568,270,0,0,0,0,565,0
154,800,1808,0,1,0.31,328,16,1,0,48,0
154,424.50,1800,0,2,0.50,16,16,-1,1,119,1
154,1036,1820,0,3,0.90,16,16,-1,0,142,1
154,1004,1820,0,4,0.50,80,16,1,0,180,1
154,808,1488,0,5,0.50,8,8,-1,0,241,0
154,968,1144,0,6,0.50,16,8,-1,0,274,1
154,1040,784,0,7,0.25,32,16,-1,0,304,0
154,400,1016,1,8,0.50,8,8,-1,0,376,1
154,586,617,1,9,0.50,16,16,-1,1,387,0
154,566,784,1,10,0.50,16,16,-1,1,394,1
154,616,640,0,11,0.65,32,16,1,0,420,1
210,368,608,0,0,180,0,0,0,1,448,0
210,224,608,0,0,180,0,0,0,1,451,0
210,296,608,0,0,180,0,0,0,1,450,0
210,296,944,0,450,0,0,0,0,1,456,0
210,224,944,0,451,0,0,0,0,1,457,0
210,368,944,0,448,0,0,0,0,1,454,0
158,64,1736,0,1,16777215,0,1,0,1,9,0
216,552,1816,0,62,0,1,0,0,0,525,0
216,88,1856,0,33,0,1,0,0,0,578,0
216,152,1856,0,32,0,1,0,0,0,566,0
216,216,1856,0,31,0,1,0,0,0,567,0
157,709,1577,0,136,104,0,0,0,1,5,0
157,484,1648,0,16,192,0,0,0,1,101,0
157,640,1613,0,8,32,0,0,0,1,162,0
157,240,1704,0,488,16,0,0,0,1,518,0
157,616,1728,0,24,32,0,0,0,1,6,0
157,560,1728,0,88,32,0,0,0,1,60,0
157,504,1728,0,24,32,0,0,0,1,61,0
157,376,1728,0,200,32,0,0,0,1,106,0
157,120,1736,0,264,16,0,0,0,1,517,0
157,800,1872,0,328,120,0,0,0,1,45,0
157,344,1920,0,600,32,0,0,0,1,19,0
157,64,1984,0,128,32,0,0,0,1,37,0
157,64,1952,0,32,32,0,0,0,1,38,0
157,8,1824,0,16,176,0,0,0,1,107,0
157,8,1920,0,32,32,0,0,0,1,31,0
157,0,1952,0,32,32,0,0,0,1,39,0
157,640,1549,0,8,80,0,0,0,1,161,0
157,560,1560,0,160,16,0,0,0,1,102,0
157,648,1439,0,24,176,0,0,0,1,206,0
157,828,1466,0,272,32,0,0,0,1,201,0
157,660,1461,0,16,128,0,0,0,1,209,0
157,660,1365,0,16,48,0,0,0,1,210,0
157,716,1312,0,160,80,0,0,0,1,205,0
157,800,1625,0,48,8,0,0,0,1,56,0
157,896,1312,0,136,80,0,0,0,1,247,0
157,800,1533,0,64,16,0,0,0,1,233,0
157,892,1378,0,112,80,0,0,0,1,211,0
157,832,1360,0,8,16,0,0,0,1,213,0
157,832,1398,0,8,40,0,0,0,1,212,0
157,892,1577,0,144,104,0,0,0,1,53,0
157,1076,1696,0,32,608,0,0,0,1,166,0
157,1052,1908,0,16,192,0,0,0,1,165,0
157,1052,912,0,16,608,0,0,0,1,267,0
157,1076,1000,0,32,784,0,0,0,1,264,0
157,576,593,0,184,32,0,0,0,1,371,0
157,672,808,0,552,32,0,0,0,1,352,0
157,656,936,0,368,112,0,0,0,1,487,0
157,864,744,0,168,16,0,0,0,1,337,0
155,800,1808,0,1,1,0,0,0,1,46,0
155,800,1685,0,2,1,0,0,0,1,47,0
155,800,1637,0,3,1,0,0,0,0,71,0
155,40,1800,0,1,2,0,0,0,1,117,0
155,472,1800,0,2,2,0,0,0,1,118,0
155,1036,1820,0,1,3,0,0,0,1,140,1
155,1036,1650,0,2,3,60,0,0,1,141,0
155,1036,1633,0,3,3,0,0,0,0,156,0
155,1004,1820,0,1,4,0,0,0,1,178,0
155,1004,1458,0,2,4,0,0,0,0,179,0
169,948,1418,0,0,0,0,0,0,1,202,0
155,1004,672,0,3,4,0,0,0,0,217,0
155,808,1488,0,1,5,0,0,0,1,239,0
155,672,1488,0,2,5,0,0,0,1,240,0
172,796,1335,0,1,0,0,0,0,1,245,1
155,968,1144,0,1,6,0,0,0,1,272,0
155,968,1280,0,2,6,0,0,0,0,273,0
155,1040,784,0,1,7,0,0,0,1,302,0
155,1040,696,0,2,7,0,0,0,1,303,0
169,852,704,0,1,0,0,0,0,1,338,0
172,748,736,0,1,0,0,0,0,1,342,0
169,668,760,0,0,0,0,0,0,1,355,0
155,400,1016,0,1,8,0,0,0,1,374,0
155,424,1016,0,2,8,0,0,0,1,375,0
155,492,617,0,1,9,0,0,0,1,385,0
155,492,784,0,2,9,0,0,0,1,386,0
155,660,784,0,3,9,0,0,0,1,389,0
155,660,617,0,4,9,0,0,0,1,390,0
155,660,784,0,1,10,0,0,0,1,392,0
155,660,617,0,2,10,0,0,0,1,393,0
155,492,617,0,3,10,0,0,0,1,396,0
155,492,784,0,4,10,0,0,0,1,397,0
155,616,640,0,1,11,0,0,0,1,418,0
155,512,640,0,2,11,0,0,0,0,419,0
169,468,760,0,0,0,0,0,0,1,464,1
169,815,851,0,1,0,0,0,0,0,498,1
169,815,820,0,0,0,0,0,0,0,500,1
166,1036,1820,0,142,0,180,0,0,1,148,0
166,968,1144,0,274,0,0,0,0,1,280,1
166,576,701,0,0,387,0,0,0,1,372,1
166,572,697,0,0,394,0,0,0,1,398,1
166,608,824,0,0,0,270,0,0,1,489,1
166,568,824,0,0,0,270,0,0,1,490,1
166,528,824,0,0,0,270,0,0,1,491,1
253,608,1568,0,255,0,0,0,0,1,104,0
253,512,1568,0,255,0,0,0,0,1,103,0
216,280,1856,0,30,0,1,0,0,0,568,0
157,956,968,0,16,608,0,0,0,1,270,0
157,672,617,0,8,80,0,0,0,1,416,0
157,680,669,0,8,184,0,0,0,1,354,0
157,476,669,0,16,184,0,0,0,1,368,0
157,672,708,0,8,24,0,0,0,1,415,0
157,860,700,0,16,8,0,0,0,1,340,0
157,900,680,0,96,32,0,0,0,1,309,0
157,672,744,0,8,32,0,0,0,1,414,0
157,437,936,0,80,112,0,0,0,1,447,0
157,251,968,0,320,48,0,0,0,1,446,0
157,131,761,0,80,368,0,0,0,1,444,0
157,812,1280,0,32,16,0,0,0,1,248,0
157,864,772,0,168,40,0,0,0,1,353,0
157,856,904,0,32,176,0,0,0,1,495,0
185,941,952,0,0,64,1,0,0,1,297,0
157,672,676,0,8,24,0,0,0,1,432,0
157,316,593,0,304,32,0,0,0,1,445,0
157,887,593,0,408,32,0,0,0,1,265,0
185,1012,784,0,0,16,-1,0,0,1,299,0
185,1040,784,0,304,16,-1,0,0,1,306,0
185,1073,1024,0,0,64,1,0,0,1,292,0
157,1052,1521,0,16,464,0,0,0,1,130,0
157,956,1378,0,16,80,0,0,0,1,204,0
219,960,1720,0,8,192,0,0,0,1,84,1
219,1004,1621,0,80,16,0,0,0,1,198,0
242,852,1838,0,224,32,0,0,0,0,285,0
242,432,776,0,32,32,0,0,0,1,442,0
242,872,648,0,32,32,0,0,0,1,311,0
242,1004,1342,0,80,32,0,0,0,1,286,0
242,824,1661,0,32,32,0,0,0,1,75,0
176,752,856,0,529,48,48,0,0,0,530,0
176,496,776,0,464,32,32,1,0,1,467,0
176,432,776,0,464,32,32,0,0,1,477,0
176,432,776,0,531,32,32,0,0,1,532,0
176,618,640,0,420,32,32,0,0,1,422,0
176,1024,944,0,304,32,32,0,0,1,332,0
176,1024,944,0,527,32,32,0,0,1,528,0
176,1004,1434,0,179,80,32,0,0,1,221,0
176,1004,1342,0,274,80,32,0,0,1,268,0
176,928,1504,0,225,32,32,0,0,1,254,0
176,928,1504,0,241,32,32,0,0,1,259,0
176,824,1661,0,93,32,32,0,0,1,88,0
176,824,1661,0,144,32,32,0,0,1,145,0
216,697,852,0,75,0,1,0,0,0,529,0
216,672,848,0,71,0,1,0,0,0,502,0
216,304,712,0,20,0,1,0,0,0,531,0
216,1008,880,0,79,0,1,0,0,0,527,0
216,800,1648,0,7,0,0,0,0,0,105,0
224,816,656,0,84,0,0,0,0,0,345,0
1234567890
25,544,336,16,16,0,1712,10002,0,0,0,0
25,544,336,16,16,16,1712,10002,0,0,0,0
25,544,336,16,16,32,1712,10002,0,0,0,0
25,544,336,16,16,48,1712,10002,0,0,0,0
25,544,336,16,16,64,1712,10002,0,0,0,0
25,544,336,16,16,80,1712,10002,0,0,0,0
25,544,336,16,16,96,1712,10002,0,0,0,0
25,544,336,16,16,112,1712,10002,0,0,0,0
25,544,336,16,16,128,1712,10002,0,0,0,0
25,544,336,16,16,144,1712,10002,0,0,0,0
25,544,336,16,16,160,1712,10002,0,0,0,0
25,544,336,16,16,176,1712,10002,0,0,0,0
25,544,336,16,16,192,1712,10002,0,0,0,0
25,544,336,16,16,208,1712,10002,0,0,0,0
25,544,336,16,16,224,1712,10002,0,0,0,0
25,544,336,16,16,240,1712,10002,0,0,0,0
25,544,336,16,16,256,1712,10002,0,0,0,0
25,544,336,16,16,272,1712,10002,0,0,0,0
25,544,336,16,16,240,1728,10002,0,0,0,0
25,544,336,16,16,256,1728,10002,0,0,0,0
25,544,336,16,16,272,1728,10002,0,0,0,0
24,64,320,16,16,768,1488,10000,0,0,0,0
24,80,320,16,16,784,1488,10000,0,0,0,0
24,96,320,16,16,800,1488,10000,0,0,0,0
24,96,336,16,16,800,1504,10000,0,0,0,0
24,80,336,16,16,784,1504,10000,0,0,0,0
24,64,336,16,16,768,1504,10000,0,0,0,0
24,64,80,16,16,1040,1792,10000,0,0,0,0
24,64,64,16,16,1040,1776,10000,0,0,0,0
24,64,48,16,16,1040,1760,10000,0,0,0,0
24,64,48,16,16,1040,1744,10000,0,0,0,0
24,64,48,16,16,928,1424,10000,0,0,0,0
24,64,48,16,16,928,1408,10000,0,0,0,0
24,176,0,16,16,1056,1264,10000,0,0,0,0
24,416,176,16,16,1024,656,10000,0,0,0,0
24,416,176,16,16,1040,656,10000,0,0,0,0
24,80,80,16,16,1024,640,10000,0,0,0,0
24,80,64,16,16,1024,624,10000,0,0,0,0
24,80,48,16,16,1024,608,10000,0,0,0,0
24,112,176,16,16,384,928,10000,0,0,0,0
24,112,160,16,16,384,912,10000,0,0,0,0
24,32,176,16,16,304,928,10000,0,0,0,0
24,0,176,16,16,160,928,10000,0,0,0,0
24,64,256,16,16,336,768,10000,0,0,0,0
24,80,256,16,16,352,768,10000,0,0,0,0
24,80,272,16,16,352,784,10000,0,0,0,0
24,64,272,16,16,336,784,10000,0,0,0,0
24,128,160,32,32,288,736,10000,0,0,0,0
24,144,240,16,16,272,752,10000,0,0,0,0
24,144,208,16,16,368,752,10000,0,0,0,0
24,64,192,32,16,288,848,10000,0,0,0,0
24,96,256,32,32,224,864,10000,0,0,0,0
24,128,256,32,32,208,768,10000,0,0,0,0
24,96,160,16,16,224,752,10000,0,0,0,0
24,464,192,32,16,256,864,10000,0,0,0,0
24,464,112,32,16,672,864,10000,0,0,0,0
24,416,160,16,16,688,768,10000,0,0,0,0
24,416,160,16,16,736,1408,10000,0,0,0,0
24,416,160,16,16,560,1664,10000,0,0,0,0
24,32,192,32,32,16,1920,10000,0,0,0,0
24,112,192,16,32,32,1888,10000,0,0,0,0
24,48,192,16,16,16,1904,10000,0,0,0,0
24,368,32,16,16,544,1840,10000,0,0,0,0
24,320,240,48,16,864,1488,10000,0,0,0,0
24,320,240,48,16,752,624,10000,0,0,0,0
24,496,224,16,64,960,992,10000,0,0,0,0
24,496,224,16,64,960,864,10000,0,0,0,0
24,528,224,16,64,960,1120,10000,0,0,0,0
24,528,128,32,32,1024,1056,10000,0,0,0,0
24,528,64,32,32,1024,960,10000,0,0,0,0
24,496,32,64,32,1008,1968,10000,0,0,0,0
24,496,32,64,32,944,1968,10000,0,0,0,0
24,368,16,16,16,992,1760,10000,0,0,0,0
24,368,16,16,16,1008,1760,10000,0,0,0,0
24,352,16,16,16,944,1488,10000,0,0,0,0
24,496,224,16,64,1008,752,10000,0,0,0,0
24,528,128,32,32,1024,720,10000,0,0,0,0
24,176,32,16,16,784,864,10000,0,0,0,0
24,160,32,16,16,768,864,10000,0,0,0,0
24,64,32,16,16,176,784,10000,0,0,0,0
24,64,48,16,16,176,800,10000,0,0,0,0
24,64,48,16,16,176,816,10000,0,0,0,0
24,64,48,16,16,176,832,10000,0,0,0,0
24,64,48,16,16,176,848,10000,0,0,0,0
24,64,48,16,16,176,864,10000,0,0,0,0
24,64,48,16,16,176,880,10000,0,0,0,0
24,64,48,16,16,176,896,10000,0,0,0,0
24,64,48,16,16,176,912,10000,0,0,0,0
24,64,48,16,16,176,928,10000,0,0,0,0
24,464,192,32,16,512,864,10000,0,0,0,0
24,464,64,32,16,576,1888,10000,0,0,0,0
24,384,0,16,16,784,1664,10000,0,0,0,0
24,384,0,16,16,800,1408,10000,0,0,0,0
24,384,0,16,16,1008,1344,10000,0,0,0,0
24,432,32,32,16,992,864,10000,0,0,0,0
987654321
NA04JRInVSc=

