UVx6TlN0AGU9Z2lPIUBIO0Y2N0hJEzpXFHU7SBJhIEV+enVgKSQ9Zg==
259,32,192,0,32,32,0,0,0,1,71,0
259,0,32,0,32,32,0,0,0,1,73,0
259,0,64,0,32,32,0,0,0,1,74,0
259,0,96,0,32,32,0,0,0,1,75,0
259,0,128,0,32,32,0,0,0,1,76,0
259,5,133,0,32,32,0,0,0,1,77,0
259,0,160,0,32,32,0,0,0,1,78,0
259,0,192,0,32,32,0,0,0,1,79,0
259,152,320,0,1024,128,0,0,0,1,94,0
259,544,240,0,32,32,0,0,0,1,95,0
259,0,224,0,32,32,0,0,0,1,96,0
259,0,248,0,32,32,0,0,0,1,97,0
160,432,240,0,0,16777215,0,0,0,1,4,0
123,184,88,0,256,0,0,0,0,1,2,0
189,344,80,0,0,128,176,0,0,1,69,0
189,216,144,0,0,128,270,0,0,1,17,0
189,56,48,0,0,128,0,0,0,1,49,0
188,192,240,0,0,0,0,0,0,1,18,0
185,264,264,0,0,32,1,0,0,1,66,0
185,314,264,0,0,32,1,0,0,1,67,0
185,360,264,0,0,32,1,0,0,1,68,0
158,104,240,0,0,16777215,0,1,0,1,3,0
157,32,256,0,32,32,0,0,0,1,8,0
157,64,256,0,32,32,0,0,0,1,9,0
157,96,256,0,32,32,0,0,0,1,10,0
157,160,256,0,32,32,0,0,0,1,12,0
157,192,256,0,32,32,0,0,0,1,13,0
157,464,256,0,32,32,0,0,0,1,14,0
157,32,224,0,32,32,0,0,0,1,19,0
157,32,160,0,32,32,0,0,0,1,20,0
157,32,128,0,32,32,0,0,0,1,21,0
157,224,256,0,32,32,0,0,0,1,22,0
157,112,160,0,32,32,0,0,0,1,28,0
157,16,312,0,32,32,0,0,0,1,29,0
157,48,320,0,32,32,0,0,0,1,30,0
157,80,328,0,32,32,0,0,0,1,31,0
157,112,336,0,32,32,0,0,0,1,32,0
157,144,336,0,32,32,0,0,0,1,33,0
157,176,344,0,32,32,0,0,0,1,34,0
157,208,344,0,32,32,0,0,0,1,35,0
157,32,96,0,32,32,0,0,0,1,36,0
157,32,64,0,32,32,0,0,0,1,37,0
157,32,32,0,32,32,0,0,0,1,38,0
157,240,344,0,32,32,0,0,0,1,39,0
157,256,272,0,32,32,0,0,0,1,40,0
157,288,272,0,32,32,0,0,0,1,41,0
157,320,272,0,32,32,0,0,0,1,42,0
157,352,272,0,32,32,0,0,0,1,43,0
157,384,272,0,32,32,0,0,0,1,44,0
157,272,344,0,32,32,0,0,0,1,45,0
157,304,344,0,32,32,0,0,0,1,46,0
157,336,344,0,32,32,0,0,0,1,47,0
157,368,344,0,32,32,0,0,0,1,48,0
157,400,344,0,32,32,0,0,0,1,50,0
157,432,344,0,32,32,0,0,0,1,51,0
157,464,344,0,32,32,0,0,0,1,52,0
157,496,344,0,32,32,0,0,0,1,53,0
157,528,344,0,32,32,0,0,0,1,54,0
157,544,312,0,32,32,0,0,0,1,55,0
157,560,280,0,32,32,0,0,0,1,56,0
157,576,248,0,32,32,0,0,0,1,57,0
157,496,256,0,32,32,0,0,0,1,58,0
157,512,240,0,32,32,0,0,0,1,59,0
157,576,216,0,32,32,0,0,0,1,60,0
157,576,184,0,32,32,0,0,0,1,61,0
157,576,120,0,32,32,0,0,0,1,62,0
157,576,88,0,32,32,0,0,0,1,63,0
157,240,96,0,32,32,0,0,0,1,64,0
157,128,256,0,32,32,0,0,0,1,11,0
157,432,256,0,32,32,0,0,0,1,16,0
157,400,256,0,32,32,0,0,0,1,15,0
157,16,344,0,32,32,0,0,0,1,80,0
157,48,344,0,32,32,0,0,0,1,81,0
157,80,344,0,32,32,0,0,0,1,82,0
157,112,344,0,32,32,0,0,0,1,83,0
157,144,352,0,32,32,0,0,0,1,84,0
157,576,152,0,32,32,0,0,0,1,85,0
157,576,304,0,32,128,0,0,0,1,86,0
157,608,296,0,32,128,0,0,0,1,87,0
157,608,168,0,32,128,0,0,0,1,88,0
157,608,56,0,32,128,0,0,0,1,89,0
157,576,56,0,32,128,0,0,0,1,90,0
157,624,128,0,32,256,0,0,0,1,91,0
157,624,232,0,32,256,0,0,0,1,92,0
157,552,344,0,32,32,0,0,0,1,93,0
157,32,16,0,32,32,0,0,0,1,98,0
157,8,8,0,32,32,0,0,0,1,99,0
172,176,176,0,0,0,0,0,0,1,23,1
1234567890
25,0,48,48,48,0,240,10002,0,0,0,0
25,0,0,48,48,0,192,10002,0,0,0,0
25,0,0,48,48,0,144,10002,0,0,0,0
25,0,0,48,48,0,96,10002,0,0,0,0
25,0,0,48,48,0,48,10002,0,0,0,0
25,0,0,48,48,0,0,10002,0,0,0,0
25,0,0,48,48,48,0,10002,0,0,0,0
25,0,0,48,48,96,0,10002,0,0,0,0
25,0,0,48,48,144,0,10002,0,0,0,0
25,0,0,48,48,192,0,10002,0,0,0,0
25,0,0,48,48,240,0,10002,0,0,0,0
25,0,0,48,48,288,0,10002,0,0,0,0
25,0,0,48,48,336,0,10002,0,0,0,0
25,0,0,48,48,384,0,10002,0,0,0,0
25,0,0,48,48,432,0,10002,0,0,0,0
25,0,0,48,48,480,0,10002,0,0,0,0
25,0,0,48,48,528,0,10002,0,0,0,0
25,0,0,48,48,576,0,10002,0,0,0,0
25,0,0,48,48,48,240,10002,0,0,0,0
25,0,0,48,48,96,240,10002,0,0,0,0
25,0,0,48,48,144,240,10002,0,0,0,0
25,0,0,48,48,192,240,10002,0,0,0,0
25,0,0,48,48,240,240,10002,0,0,0,0
25,0,0,48,48,288,240,10002,0,0,0,0
25,0,0,48,48,336,240,10002,0,0,0,0
25,0,0,48,48,384,240,10002,0,0,0,0
25,0,0,48,48,432,240,10002,0,0,0,0
25,0,0,48,48,480,240,10002,0,0,0,0
25,0,0,48,48,528,240,10002,0,0,0,0
25,0,0,48,48,576,240,10002,0,0,0,0
25,0,0,48,48,576,192,10002,0,0,0,0
25,0,0,48,48,576,144,10002,0,0,0,0
25,0,0,48,48,576,48,10002,0,0,0,0
25,0,0,48,48,576,96,10002,0,0,0,0
25,528,256,32,32,224,80,10002,0,0,0,0
25,528,256,32,32,96,144,10002,0,0,0,0
24,272,96,32,16,176,176,10000,0,0,0,0
25,0,0,48,48,0,288,10002,0,0,0,0
25,0,0,48,48,48,288,10002,0,0,0,0
25,0,0,48,48,96,288,10002,0,0,0,0
25,0,0,48,48,144,288,10002,0,0,0,0
25,0,0,48,48,192,288,10002,0,0,0,0
25,0,0,48,48,240,288,10002,0,0,0,0
25,0,0,48,48,288,288,10002,0,0,0,0
25,0,0,48,48,336,288,10002,0,0,0,0
25,0,0,48,48,384,288,10002,0,0,0,0
25,0,0,48,48,432,288,10002,0,0,0,0
25,0,0,48,48,480,288,10002,0,0,0,0
25,0,0,48,48,528,288,10002,0,0,0,0
25,0,0,48,48,576,288,10002,0,0,0,0
25,0,0,48,48,576,336,10002,0,0,0,0
25,0,0,48,48,528,336,10002,0,0,0,0
25,0,0,48,48,480,336,10002,0,0,0,0
25,0,0,48,48,432,336,10002,0,0,0,0
25,0,0,48,48,384,336,10002,0,0,0,0
25,0,0,48,48,336,336,10002,0,0,0,0
25,0,0,48,48,288,336,10002,0,0,0,0
25,0,0,48,48,240,336,10002,0,0,0,0
25,0,0,48,48,192,336,10002,0,0,0,0
25,0,0,48,48,144,336,10002,0,0,0,0
25,0,0,48,48,96,336,10002,0,0,0,0
25,0,0,48,48,48,336,10002,0,0,0,0
25,0,0,48,48,0,336,10002,0,0,0,0
25,0,0,48,48,624,336,10002,0,0,0,0
25,0,0,48,48,624,288,10002,0,0,0,0
25,0,0,48,48,624,240,10002,0,0,0,0
25,0,0,48,48,624,192,10002,0,0,0,0
25,0,0,48,48,624,0,10002,0,0,0,0
25,0,0,48,48,624,144,10002,0,0,0,0
25,0,0,48,48,624,64,10002,0,0,0,0
987654321

