UVx6TlN0AGU9Z0hCNUJeMhgOTmJ0J3wSVTU7SBJhIEV+enVg
160,280,248,0,0,16777215,0,0,0,1,36,0
100,272,288,0,100,65535,0,272,0,1,234,0
218,176,104,0,400,16711680,0,270,0,1,196,0
100,176,288,0,100,65535,0,272,0,1,232,0
218,376,8,1,400,16711680,0,270,0,1,194,0
218,496,8,0,400,16711680,0,270,0,1,197,0
218,424,168,0,400,16711680,0,270,0,1,195,0
100,224,288,0,100,65535,0,272,0,1,233,0
123,256,64,0,84,12615680,0,0,0,1,251,0
174,576,96,0,1,13,0,0,0,0,5,1
186,104,192,0,32,32,0,0,0,1,135,0
188,272,328,0,0,105,112,0,0,1,102,0
188,72,264,0,0,82,81,80,79,1,137,0
188,176,328,0,0,105,112,0,0,1,104,0
188,224,328,0,0,105,112,0,0,1,103,0
185,336,120,0,0,32,1,0,0,1,26,0
185,416,120,0,0,32,1,0,0,1,38,0
185,464,312,0,0,32,1,0,0,1,76,0
185,256,120,0,0,32,1,0,0,1,189,0
242,376,312,0,64,32,0,0,0,1,254,0
154,462,112,0,1,0.50,32,32,1,1,56,1
158,104,96,0,0,16777215,0,1,0,1,8,0
210,32,264,0,149,0,0,0,0,1,143,0
210,328,328,0,0,0,0,0,0,1,150,0
210,232,200,0,150,0,0,0,0,1,151,0
210,424,256,0,0,0,0,0,0,1,149,0
157,104,112,0,32,32,0,0,0,1,10,0
157,136,112,0,32,32,0,0,0,1,2,0
157,72,112,0,32,32,0,0,0,1,7,0
157,168,112,0,32,32,0,0,0,1,9,0
157,216,112,0,32,32,0,0,0,1,10,0
157,296,112,0,32,32,0,0,0,1,21,0
157,376,112,0,32,32,0,0,0,1,22,0
157,424,272,0,32,32,0,0,0,1,27,0
157,600,176,0,32,32,0,0,0,1,30,0
157,360,272,0,32,32,0,0,0,1,31,0
157,328,272,0,32,32,0,0,0,1,34,0
157,296,272,0,32,32,0,0,0,1,35,0
157,568,112,0,32,32,0,0,0,1,40,0
157,600,112,0,32,32,0,0,0,1,41,0
157,72,80,0,32,32,0,0,0,1,43,0
157,72,48,0,32,32,0,0,0,1,44,0
157,72,16,0,32,32,0,0,0,1,45,0
157,600,80,0,32,32,0,0,0,1,59,0
157,600,48,0,32,32,0,0,0,1,60,0
157,376,160,0,128,32,0,0,0,1,67,0
157,600,144,0,32,32,0,0,0,1,68,0
157,424,208,0,32,32,0,0,0,1,72,0
157,424,184,0,32,32,0,0,0,1,73,0
157,360,344,0,32,32,0,0,0,1,84,0
157,328,344,0,32,32,0,0,0,1,85,0
157,296,344,0,32,32,0,0,0,1,86,0
157,264,344,0,32,32,0,0,0,1,87,0
157,269,349,0,32,32,0,0,0,1,88,0
157,392,344,0,32,32,0,0,0,1,89,0
157,424,344,0,32,32,0,0,0,1,90,0
157,424,312,0,32,32,0,0,0,1,91,0
157,424,296,0,32,32,0,0,0,1,92,0
157,264,272,0,32,32,0,0,0,1,93,0
157,248,272,0,32,32,0,0,0,1,94,0
157,184,344,0,128,32,0,0,0,1,95,0
157,296,128,0,32,32,0,0,0,1,97,0
157,8,312,0,16,32,0,0,0,1,114,0
157,104,280,0,32,32,0,0,0,1,115,0
157,176,272,0,32,32,0,0,0,1,116,0
157,224,216,0,32,32,0,0,0,1,118,0
157,208,272,0,32,32,0,0,0,1,119,0
157,224,272,0,32,32,0,0,0,1,120,0
157,40,280,0,32,32,0,0,0,1,125,0
157,72,280,0,32,32,0,0,0,1,126,0
157,104,344,0,32,32,0,0,0,1,127,0
157,80,344,0,32,32,0,0,0,1,128,0
157,56,344,0,32,32,0,0,0,1,129,0
157,32,344,0,32,32,0,0,0,1,130,0
157,16,344,0,32,32,0,0,0,1,131,0
157,136,208,0,32,32,0,0,0,1,132,0
157,104,208,0,32,32,0,0,0,1,133,0
157,104,248,0,32,32,0,0,0,1,134,0
157,104,232,0,32,32,0,0,0,1,146,0
157,256,192,0,32,32,0,0,0,1,175,0
157,272,192,0,64,32,0,0,0,1,177,0
157,296,160,0,32,32,0,0,0,1,178,0
157,248,216,0,16,16,0,0,0,1,179,0
157,248,232,0,16,16,0,0,0,1,180,0
157,248,248,0,16,16,0,0,0,1,181,0
157,224,240,0,32,32,0,0,0,1,186,0
157,192,112,0,32,32,0,0,0,1,190,0
157,600,16,0,32,32,0,0,0,1,193,0
157,424,16,0,320,32,0,0,0,1,211,0
157,216,16,0,96,32,0,0,0,1,212,0
157,120,16,0,96,32,0,0,0,1,213,0
157,8,120,0,16,296,0,0,0,1,214,0
157,32,16,0,48,32,0,0,0,1,215,0
157,464,352,0,48,32,0,0,0,1,216,0
157,8,280,0,32,32,0,0,0,1,225,0
157,504,352,0,32,32,0,0,0,1,237,0
157,504,320,0,32,32,0,0,0,1,238,0
157,504,288,0,32,32,0,0,0,1,239,0
157,504,256,0,32,32,0,0,0,1,240,0
157,504,224,0,32,32,0,0,0,1,241,0
157,536,224,0,32,32,0,0,0,1,242,0
157,568,224,0,32,32,0,0,0,1,243,0
157,600,224,0,32,32,0,0,0,1,244,0
157,600,208,0,32,32,0,0,0,1,245,0
155,456,112,0,1,1,0,0,0,1,54,0
155,488,112,0,2,1,0,0,0,1,55,0
169,104,296,0,0,0,0,0,0,1,112,1
166,576,160,0,0,0,180,0,0,1,13,1
166,320,184,0,0,0,270,0,0,1,79,1
166,336,184,0,0,0,270,0,0,1,80,1
166,352,184,0,0,0,270,0,0,1,81,1
166,368,184,0,0,0,270,0,0,1,82,1
166,24,312,0,0,0,0,0,0,0,105,1
1234567890
24,512,224,32,64,464,272,10000,0,0,0,0
24,496,224,16,64,432,272,10000,0,0,0,0
24,496,192,64,32,224,128,10000,0,0,0,0
24,464,176,32,16,240,160,10000,0,0,0,0
24,432,32,32,16,352,304,10000,0,0,0,0
25,176,176,80,80,0,0,10002,0,0,0,0
25,176,176,80,80,80,0,10002,0,0,0,0
25,176,176,80,80,160,0,10002,0,0,0,0
25,176,176,80,80,240,0,10002,0,0,0,0
25,176,176,80,80,320,0,10002,0,0,0,0
25,176,176,80,80,400,0,10002,0,0,0,0
25,176,176,80,80,480,0,10002,0,0,0,0
25,176,176,80,80,560,0,10002,0,0,0,0
25,176,176,80,80,560,80,10002,0,0,0,0
25,176,176,80,80,480,80,10002,0,0,0,0
25,176,176,80,80,400,80,10002,0,0,0,0
25,176,176,80,80,320,80,10002,0,0,0,0
25,176,176,80,80,240,80,10002,0,0,0,0
25,176,176,80,80,160,80,10002,0,0,0,0
25,176,176,80,80,80,80,10002,0,0,0,0
25,176,176,80,80,0,80,10002,0,0,0,0
25,176,176,80,80,0,160,10002,0,0,0,0
25,176,176,80,80,80,160,10002,0,0,0,0
25,176,176,80,80,160,160,10002,0,0,0,0
25,176,176,80,80,240,160,10002,0,0,0,0
25,176,176,80,80,320,160,10002,0,0,0,0
25,176,176,80,80,400,160,10002,0,0,0,0
25,176,176,80,80,480,160,10002,0,0,0,0
25,176,176,80,80,560,160,10002,0,0,0,0
25,176,176,80,80,560,240,10002,0,0,0,0
25,176,176,80,80,480,240,10002,0,0,0,0
25,176,176,80,80,400,240,10002,0,0,0,0
25,176,176,80,80,320,240,10002,0,0,0,0
25,176,176,80,80,240,240,10002,0,0,0,0
25,176,176,80,80,160,240,10002,0,0,0,0
25,176,176,80,80,80,240,10002,0,0,0,0
25,176,176,80,80,0,240,10002,0,0,0,0
25,176,176,80,80,0,320,10002,0,0,0,0
25,176,176,80,80,80,320,10002,0,0,0,0
25,176,176,80,80,160,320,10002,0,0,0,0
25,176,176,80,80,240,320,10002,0,0,0,0
25,176,176,80,80,320,320,10002,0,0,0,0
25,176,176,80,80,400,320,10002,0,0,0,0
25,176,176,80,80,480,320,10002,0,0,0,0
25,176,176,80,80,560,320,10002,0,0,0,0
987654321
JQ0mBQk3XQ==
IgQsCxMq
Nx0/EBM=
JgY+FQUwQCxr

