UVx6TlN0AGU9Z1VXNERDdnctdlpLDGEOSSknVA59PFliZml8NQ==
160,464,312,0,0,16777215,0,0,0,1,123,0
100,96,32,0,99,128,0,270,0,1,23,0
123,97,241,0,90,128,0,0,0,1,40,0
123,248,224,0,70,0,0,0,0,1,100,0
195,228.50,232,0,105,128,270,0,98,1,106,0
195,228.50,232,0,105,128,272,0,99,1,101,0
100,208,224,0,200,16777215,0,270,0,1,44,0
100,512,232,0,200,16777215,0,270,0,1,119,0
100,416,232,0,200,16777215,0,270,0,1,120,0
100,144,32,0,200,16777215,0,270,0,1,41,0
100,40,32,0,200,16777215,0,270,0,1,42,0
100,304,232,0,200,16777215,0,270,0,1,122,0
197,528,312,0,2,0,0,0,0,1,127,0
197,504,312,0,10,138,0,0,0,1,125,0
197,424,312,0,5,157,0,0,0,1,124,0
197,96,64,0,5,21,0,0,0,1,16,0
174,144,128,0,1,55,51,58,0,0,54,1
174,248,264,0,1,95,0,0,0,0,97,1
174,336,312,0,1,89,88,86,0,0,94,1
205,528.50,144,0,1,0,0.50,0,0,1,159,0
205,344,224,0,1,0,0.50,0,0,1,59,0
186,320,96,0,32,32,0,0,0,1,139,0
219,368,296,0,32,32,0,0,0,1,86,1
219,368,264,0,32,32,0,0,0,1,88,1
219,368,232,0,32,32,0,0,0,1,89,1
188,320,152,0,0,126,0,0,0,1,140,0
188,504,200,0,0,144,0,0,0,1,160,0
188,464,200,0,0,141,0,0,0,1,164,0
185,96,192,0,0,32,1,0,0,1,27,0
185,96,312,0,0,32,1,0,0,1,28,0
154,228,232,0,1,0.50,32,2,-1,1,105,1
158,16,64,0,0,16777215,0,1,0,1,56,0
157,16,16,0,32,32,0,0,0,1,34,0
157,48,16,0,32,32,0,0,0,1,2,0
157,80,16,0,32,32,0,0,0,1,3,0
157,112,16,0,32,32,0,0,0,1,4,0
157,144,16,0,32,32,0,0,0,1,5,0
157,176,16,0,32,32,0,0,0,1,6,0
157,112,80,0,32,32,0,0,0,1,7,0
157,80,80,0,32,32,0,0,0,1,8,0
157,80,112,0,32,32,0,0,0,1,9,0
157,112,112,0,32,32,0,0,0,1,10,0
157,176,48,0,32,32,0,0,0,1,11,0
157,176,80,0,32,32,0,0,0,1,12,0
157,176,112,0,32,32,0,0,0,1,13,0
157,176,144,0,32,32,0,0,0,1,14,0
157,176,176,0,32,32,0,0,0,1,15,0
157,144,144,0,32,32,0,0,0,1,24,0
157,112,144,0,32,32,0,0,0,1,25,0
157,80,144,0,32,32,0,0,0,1,26,0
157,16,328,0,32,32,0,0,0,1,29,0
157,48,328,0,32,32,0,0,0,1,35,0
157,80,328,0,32,32,0,0,0,1,36,0
157,112,328,0,32,32,0,0,0,1,37,0
157,144,328,0,32,32,0,0,0,1,38,0
157,176,328,0,32,32,0,0,0,1,39,0
157,176,208,0,32,32,0,0,0,1,45,0
157,208,208,0,32,32,0,0,0,1,46,0
157,240,208,0,32,32,0,0,0,1,47,0
157,272,208,0,32,32,0,0,0,1,48,0
157,208,328,0,32,32,0,0,0,1,49,0
157,240,328,0,32,32,0,0,0,1,50,0
157,272,328,0,32,32,0,0,0,1,57,0
157,368,176,0,32,32,0,0,0,1,60,0
157,336,168,0,32,32,0,0,0,1,61,0
157,304,168,0,32,32,0,0,0,1,62,0
157,272,176,0,32,32,0,0,0,1,63,0
157,368,208,0,32,32,0,0,0,1,64,0
157,344,224,0,32,16,0,0,0,1,75,0
157,312,224,0,32,16,0,0,0,1,76,0
157,280,224,0,32,16,0,0,0,1,77,0
157,368,168,0,32,32,0,0,0,1,78,0
157,272,168,0,32,32,0,0,0,1,79,0
157,368,216,0,32,32,0,0,0,1,80,0
157,304,328,0,32,32,0,0,0,1,83,0
157,336,328,0,32,32,0,0,0,1,84,0
157,368,328,0,32,32,0,0,0,1,85,0
157,400,328,0,32,32,0,0,0,1,90,0
157,400,216,0,32,32,0,0,0,1,91,0
157,432,216,0,32,32,0,0,0,1,92,0
157,432,328,0,32,32,0,0,0,1,93,0
157,248,280,0,32,32,0,0,0,1,96,0
157,464,216,0,32,32,0,0,0,1,107,0
157,496,216,0,32,32,0,0,0,1,108,0
157,528,216,0,32,32,0,0,0,1,109,0
157,464,328,0,32,32,0,0,0,1,110,0
157,496,328,0,32,32,0,0,0,1,111,0
157,528,328,0,32,32,0,0,0,1,112,0
157,560,296,0,32,32,0,0,0,1,113,0
157,560,264,0,32,32,0,0,0,1,114,0
157,560,232,0,32,32,0,0,0,1,115,0
157,560,216,0,32,32,0,0,0,1,116,0
157,560,328,0,32,32,0,0,0,1,117,0
157,368,136,0,32,32,0,0,0,1,128,0
157,272,136,0,32,32,0,0,0,1,129,0
157,272,104,0,32,32,0,0,0,1,130,0
157,368,104,0,32,32,0,0,0,1,131,0
157,368,72,0,32,32,0,0,0,1,132,0
157,272,72,0,32,32,0,0,0,1,133,0
157,272,40,0,32,32,0,0,0,1,134,0
157,368,40,0,32,32,0,0,0,1,135,0
157,336,32,0,32,32,0,0,0,1,136,0
157,304,32,0,32,32,0,0,0,1,137,0
157,496,152,0,32,32,0,0,0,1,146,0
157,560,184,0,32,32,0,0,0,1,147,0
157,560,152,0,32,32,0,0,0,1,148,0
157,560,120,0,32,32,0,0,0,1,149,0
157,560,88,0,32,32,0,0,0,1,150,0
157,528,88,0,32,32,0,0,0,1,151,0
157,496,88,0,32,32,0,0,0,1,152,0
157,432,72,0,32,32,0,0,0,1,153,0
157,496,120,0,32,32,0,0,0,1,154,0
157,464,152,0,32,32,0,0,0,1,161,0
157,432,152,0,32,32,0,0,0,1,162,0
157,432,184,0,32,32,0,0,0,1,163,0
157,16,80,0,32,32,0,0,0,1,51,0
157,48,80,0,32,32,0,0,0,1,55,0
157,336,296,0,32,32,0,0,0,1,95,0
157,504,296,0,32,32,0,0,0,1,141,0
157,320,112,0,32,32,0,0,0,1,138,0
157,528,296,0,32,32,0,0,0,1,126,0
155,272,232,0,1,1,0,0,0,1,103,0
155,168,232,0,2,1,0,0,0,1,104,0
169,480,168,0,0,0,0,0,0,1,144,1
172,512,144,0,0,0,0,0,0,1,157,1
166,0,152,0,0,0,0,0,0,1,21,1
166,0,112,0,0,0,0,0,0,1,58,1
166,168,232,0,0,0,270,0,0,0,98,1
166,272,232,0,0,0,270,0,0,0,99,1
253,80,64,0,16777215,0,0,0,0,1,17,0
253,112,64,0,16777215,0,0,0,0,1,18,0
253,344,224,0,16777215,0,0,0,0,1,65,0
253,336,224,0,16777215,0,0,0,0,1,66,0
253,328,224,0,16777215,0,0,0,0,1,68,0
253,320,224,0,16777215,0,0,0,0,1,69,0
253,312,224,0,16777215,0,0,0,0,1,70,0
253,304,224,0,16777215,0,0,0,0,1,71,0
253,296,224,0,16777215,0,0,0,0,1,72,0
253,352,224,0,16777215,0,0,0,0,1,73,0
253,288,224,0,16777215,0,0,0,0,1,74,0
253,344,184,0,16777215,180,0,0,0,1,81,0
253,296,184,0,16777215,180,0,0,0,1,82,0
1234567890
24,128,192,16,32,176,256,10000,0,0,0,0
24,432,32,32,16,192,272,10000,0,0,0,0
24,0,192,32,32,96,288,10000,0,0,0,0
24,0,192,32,32,64,288,10000,0,0,0,0
24,32,192,32,32,96,256,10000,0,0,0,0
24,112,224,32,32,64,256,10000,0,0,0,0
24,320,240,48,16,192,240,10000,0,0,0,0
25,0,48,48,48,0,16,10002,0,0,0,0
25,0,48,48,48,48,16,10002,0,0,0,0
25,0,48,48,48,96,16,10002,0,0,0,0
25,0,48,48,48,96,64,10002,0,0,0,0
25,0,48,48,48,0,96,10002,0,0,0,0
25,0,48,48,48,48,96,10002,0,0,0,0
25,0,48,48,48,48,144,10002,0,0,0,0
25,0,48,48,48,0,144,10002,0,0,0,0
25,0,48,48,48,0,192,10002,0,0,0,0
25,0,48,48,48,48,192,10002,0,0,0,0
25,0,48,48,48,48,240,10002,0,0,0,0
25,0,48,48,48,0,240,10002,0,0,0,0
25,0,48,48,48,0,288,10002,0,0,0,0
25,0,48,48,48,48,288,10002,0,0,0,0
25,0,48,48,48,96,112,10002,0,0,0,0
25,0,48,48,48,96,160,10002,0,0,0,0
25,0,48,48,48,96,208,10002,0,0,0,0
25,0,48,48,48,96,256,10002,0,0,0,0
25,0,48,48,48,96,304,10002,0,0,0,0
25,0,48,48,48,144,288,10002,0,0,0,0
25,0,48,48,48,144,240,10002,0,0,0,0
25,0,48,48,48,144,144,10002,0,0,0,0
25,0,48,48,48,144,96,10002,0,0,0,0
25,0,48,48,48,144,48,10002,0,0,0,0
25,0,48,48,48,144,0,10002,0,0,0,0
25,0,48,48,48,240,272,10002,0,0,0,0
25,0,48,48,48,192,272,10002,0,0,0,0
25,0,48,48,48,288,272,10002,0,0,0,0
25,0,48,48,48,288,224,10002,0,0,0,0
25,0,48,48,48,288,176,10002,0,0,0,0
25,0,48,48,48,336,176,10002,0,0,0,0
25,0,48,48,48,336,224,10002,0,0,0,0
25,0,48,48,48,336,272,10002,0,0,0,0
25,0,48,48,48,384,272,10002,0,0,0,0
25,0,48,48,48,384,224,10002,0,0,0,0
24,320,0,16,16,48,272,10000,0,0,0,0
25,16,240,32,16,176,224,10002,0,0,0,0
25,16,240,32,16,208,224,10002,0,0,0,0
25,16,240,32,16,240,224,10002,0,0,0,0
25,160,128,16,16,160,224,10002,0,0,0,0
25,0,0,16,48,144,192,10002,0,0,0,0
25,0,48,48,16,192,240,10002,0,0,0,0
25,0,48,48,16,240,240,10002,0,0,0,0
25,0,80,48,16,192,256,10002,0,0,0,0
25,0,80,48,16,240,256,10002,0,0,0,0
25,256,0,16,80,432,240,10002,0,0,0,0
25,256,0,16,16,432,224,10002,0,0,0,0
25,0,48,48,48,448,224,10002,0,0,0,0
25,0,48,48,48,448,272,10002,0,0,0,0
25,0,48,48,48,496,272,10002,0,0,0,0
25,0,48,48,48,496,224,10002,0,0,0,0
25,0,80,48,16,48,80,10002,0,0,0,0
25,0,48,48,16,48,64,10002,0,0,0,0
25,0,80,48,16,0,80,10002,0,0,0,0
25,0,48,48,16,0,64,10002,0,0,0,0
25,0,48,48,48,256,112,10002,0,0,0,0
25,0,48,48,48,304,112,10002,0,0,0,0
25,0,48,48,48,304,64,10002,0,0,0,0
25,0,48,48,48,256,64,10002,0,0,0,0
25,0,48,48,48,256,16,10002,0,0,0,0
25,0,48,48,48,304,16,10002,0,0,0,0
24,0,48,48,48,496,80,10000,0,0,0,0
24,0,48,48,48,480,160,10000,0,0,0,0
987654321
PxEtDQ4=
HxEtDQ4=
PxEtDQ4=
PwckUQs=

