Vlh4Vkx0AHEpcyFEMkZIKUMpaEwCGzNOEHVkHRJhIEV+enVgKSQ9ZmRj
259,360,232,0,16,48,0,0,0,1,26,0
259,344,232,0,16,48,0,0,0,1,27,0
259,328,232,0,16,48,0,0,0,1,28,0
259,312,232,0,16,48,0,0,0,1,29,0
259,296,232,0,16,48,0,0,0,1,30,0
259,280,232,0,16,48,0,0,0,1,31,0
259,264,232,0,16,48,0,0,0,1,32,0
259,248,232,0,16,48,0,0,0,1,33,0
259,232,232,0,16,48,0,0,0,1,34,0
259,216,232,0,16,48,0,0,0,1,35,0
259,200,232,0,16,48,0,0,0,1,36,0
259,184,232,0,16,48,0,0,0,1,37,0
259,168,232,0,16,48,0,0,0,1,38,0
259,632,232,0,16,48,0,0,0,1,180,0
259,648,232,0,16,48,0,0,0,1,194,0
259,664,232,0,16,48,0,0,0,1,195,0
259,680,232,0,16,48,0,0,0,1,196,0
259,696,232,0,16,48,0,0,0,1,197,0
259,712,232,0,16,48,0,0,0,1,198,0
259,728,232,0,16,48,0,0,0,1,199,0
259,744,232,0,16,48,0,0,0,1,200,0
259,760,232,0,16,48,0,0,0,1,201,0
259,496,56,0,32,80,0,0,0,1,360,0
259,496,328,0,240,80,0,0,0,0,538,0
259,496,136,0,256,32,0,0,0,0,565,0
259,496,280,0,96,16,0,0,0,0,582,0
259,424,176,0,112,32,0,0,0,0,596,0
259,496,144,0,256,96,0,0,0,1,601,0
259,568,176,0,112,32,0,0,0,0,610,0
259,576,312,0,64,48,0,0,0,1,627,0
259,496,312,0,32,48,0,0,0,1,628,0
259,432,312,0,96,48,0,0,0,1,663,0
259,528,312,0,32,48,0,0,0,1,666,0
259,240,216,0,416,80,0,0,0,1,715,0
259,776,232,0,16,48,0,0,0,1,738,0
259,792,232,0,16,48,0,0,0,1,739,0
259,808,232,0,16,48,0,0,0,1,740,0
259,824,232,0,16,48,0,0,0,1,741,0
259,840,232,0,16,48,0,0,0,1,742,0
259,872,232,0,16,48,0,0,0,1,746,0
259,888,232,0,16,48,0,0,0,1,747,0
259,856,232,0,16,48,0,0,0,1,748,0
259,904,232,0,16,48,0,0,0,1,749,0
259,920,232,0,16,48,0,0,0,1,753,0
259,496,280,0,32,16,0,0,0,1,788,0
160,496,248,0,0,16777215,0,0,0,1,231,0
178,584,232,0,80,48,0,0,0,0,702,0
178,792,232,0,336,48,0,0,0,0,658,0
100,320,208,0,256,16744576,0,269,0,1,757,0
100,544,192,0,256,16711680,0,219,0,1,511,0
100,432,248,0,256,16711680,0,89,0,1,606,0
100,384,136,0,272,16744576,0,338,0,1,524,0
100,608,136,0,256,16744576,0,203,0,1,525,0
100,560,248,0,256,16711680,0,89,0,1,623,0
100,496,128,0,256,16744576,0,269,0,1,780,0
100,592,208,0,256,16744576,0,269,0,1,778,0
100,672,208,0,256,16744576,0,269,0,1,767,0
100,752,208,0,256,16744576,0,269,0,1,768,0
100,240,208,0,256,16744576,0,269,0,1,761,0
100,160,208,0,256,16744576,0,269,0,1,765,0
100,80,208,0,256,16744576,0,269,0,1,766,0
100,448,192,0,256,16711680,0,320,0,1,510,0
100,400,208,0,256,16744576,0,269,0,1,779,0
197,360,256,0,2.50,18,0,0,0,1,23,0
197,632,256,0,3,407,0,0,0,1,238,0
197,576,336,0,2,690,0,0,0,1,447,0
174,408,177,0,1,91,728,788,0,0,438,0
174,584,176,0,1,413,433,574,666,0,439,0
174,464,336,0,1,0,0,723,0,0,463,1
186,496,176,0,32,32,0,0,0,1,172,0
188,464,336,0,0,794,0,0,0,1,791,0
185,160,208,0,5,32,-1,0,0,1,9,0
185,685.50,208,0,494,32,-1,0,0,1,490,0
242,608,240,0,32,32,0,0,0,1,329,0
176,464,256,0,601,32,32,1,0,1,602,0
176,472,248,0,715,32,48,0,0,1,529,0
176,552,160,0,610,32,32,0,0,1,614,0
176,552,160,0,596,32,32,0,0,1,597,0
176,552,160,0,565,32,32,0,0,1,578,0
176,552,152,0,628,32,48,0,0,1,534,0
176,592,232,0,467,32,48,0,0,1,468,0
176,592,232,0,658,32,48,0,0,1,660,0
176,464,312,0,69,32,48,0,0,1,417,0
176,528,312,0,601,32,48,0,0,1,733,0
176,656,312,0,478,32,48,0,0,1,498,0
176,352,240,0,68,32,32,0,0,1,66,0
176,208,232,0,3,32,32,0,0,1,8,0
176,496,64,0,105,32,32,0,0,1,504,0
289,256,80,0,4,0,0,0,0,1,68,0
289,640,40,0,601,0,0,0,0,1,707,0
289,408,96,0,728,0,0,0,0,1,723,0
175,448,72,0,105,60,1,0,0,0,728,0
289,352,352,0,407,0,0,0,0,1,794,0
154,160,208,0,1,0.50,32,32,-1,1,5,1
154,685.50,208,0,2,0.50,32,32,-1,1,494,1
210,448,264,0,150,270,0,0,0,1,165,0
210,552,176,0,0,0,0,0,0,1,388,0
210,944,256,0,0,0,0,0,0,1,452,0
210,440,176,0,0,0,0,0,0,1,150,0
210,544,264,0,0,90,0,0,0,1,451,0
210,608,328,0,452,90,0,0,0,1,260,0
158,48,256,0,1,16777215,0,1,0,1,10,0
157,224,272,0,448,32,0,0,0,1,16,0
157,32,312,0,704,48,0,0,0,1,355,0
157,216,360,0,560,48,0,0,0,1,672,0
157,240,192,0,416,32,0,0,0,1,19,0
157,368,152,0,32,48,0,0,0,1,275,0
157,464,184,0,32,16,0,0,0,1,270,0
157,528,184,0,32,16,0,0,0,1,269,0
157,768,272,0,448,32,0,0,0,1,202,0
157,624,312,0,32,48,0,0,0,1,313,0
157,776,360,0,560,48,0,0,0,1,671,0
157,752,192,0,416,32,0,0,0,1,261,0
157,784,152,0,352,48,0,0,0,1,107,0
157,848,312,0,416,48,0,0,0,1,633,0
157,192,152,0,320,48,0,0,0,1,349,0
157,584,232,0,80,48,0,0,0,1,407,0
157,216,72,0,528,112,0,0,0,1,76,0
157,776,72,0,528,112,0,0,0,1,615,0
157,496,112,0,32,32,0,0,0,1,648,0
157,408,232,0,80,48,0,0,0,1,18,0
157,520,272,0,16,8,0,0,0,1,574,0
157,528,280,0,32,16,0,0,0,1,433,0
157,464,328,0,32,16,0,0,0,1,690,0
157,472,272,0,16,8,0,0,0,1,482,0
157,464,280,0,32,16,0,0,0,1,478,0
157,16,192,0,32,128,0,0,0,1,287,0
157,280,496,0,1488,224,0,0,0,1,641,0
157,976,192,0,32,128,0,0,0,1,224,0
157,1016,208,0,48,160,0,0,0,1,784,0
155,160,208,0,1,1,0,0,0,0,3,0
155,344,232,0,2,1,0,0,0,0,4,0
155,496,232,0,3,1,0,0,0,0,69,0
172,480,176,0,0,0,0,0,0,1,91,1
155,496,304,0,4,1,0,0,0,0,403,0
172,480,272,0,0,0,0,0,0,1,413,1
155,752,208,0,1,2,0,0,0,1,492,0
155,664,208,0,2,2,0,0,0,1,493,0
166,608,152,0,0,0,180,0,0,1,105,0
166,384,152,0,0,0,358,0,0,0,774,0
255,496,232,0,136,128,1,0,0,1,467,0
253,360,256,0,255,0,6,0,0,1,53,0
253,376,256,0,16744448,0,6,0,0,1,80,0
253,392,256,0,16744448,0,6,0,0,1,81,0
253,408,256,0,16744448,0,6,0,0,1,82,0
253,424,256,0,16744448,0,6,0,0,1,83,0
253,440,256,0,16744448,0,6,0,0,1,84,0
253,552,256,0,16744448,0,6,0,0,1,204,0
253,568,256,0,16744448,0,6,0,0,1,205,0
253,584,256,0,16744448,0,6,0,0,1,206,0
253,616,256,0,16744448,0,6,0,0,1,207,0
253,632,256,0,255,0,6,0,0,1,210,0
253,648,256,0,255,0,6,0,0,1,211,0
253,664,256,0,255,0,6,0,0,1,212,0
253,600,256,0,16744448,0,6,0,0,1,253,0
253,344,256,0,255,0,6,0,0,1,52,0
253,328,256,0,255,0,6,0,0,1,51,0
253,312,256,0,255,0,6,0,0,1,50,0
253,296,256,0,255,0,6,0,0,1,48,0
253,280,256,0,255,0,6,0,0,1,49,0
253,264,256,0,255,0,6,0,0,1,47,0
253,248,256,0,255,0,6,0,0,1,46,0
253,232,256,0,255,0,6,0,0,1,45,0
253,216,256,0,255,0,6,0,0,1,44,0
253,200,256,0,255,0,6,0,0,1,43,0
253,184,256,0,255,0,6,0,0,1,42,0
253,168,256,0,255,0,6,0,0,1,41,0
253,152,208,0,255,180,6,0,0,1,55,0
253,400,128,0,255,0,6,0,0,1,515,0
253,432,128,0,255,0,6,0,0,1,516,0
253,464,128,0,255,0,6,0,0,1,517,0
253,528,128,0,255,0,6,0,0,1,518,0
253,568,128,0,255,0,6,0,0,1,519,0
253,592,128,0,255,0,6,0,0,1,520,0
253,136,208,0,255,180,6,0,0,1,56,0
253,120,208,0,255,180,6,0,0,1,57,0
253,104,208,0,255,180,6,0,0,1,62,0
253,88,208,0,255,180,6,0,0,1,61,0
253,72,208,0,255,180,6,0,0,1,60,0
253,56,208,0,255,180,6,0,0,1,59,0
253,40,208,0,255,180,6,0,0,1,58,0
176,688,232,0,4,32,48,0,0,1,71,0
176,824,232,0,494,32,32,0,0,1,592,0
176,912,232,0,482,32,48,0,0,1,499,0
176,912,232,0,582,32,48,0,0,1,583,0
176,912,232,0,0,32,48,0,0,1,489,0
176,912,232,0,478,32,48,0,0,1,676,0
176,912,232,0,538,32,48,0,0,1,632,0
253,680,256,0,255,0,6,0,0,1,213,0
253,696,256,0,255,0,6,0,0,1,214,0
253,712,256,0,255,0,6,0,0,1,215,0
253,728,256,0,255,0,6,0,0,1,216,0
253,744,256,0,255,0,6,0,0,1,217,0
253,760,256,0,255,0,6,0,0,1,218,0
253,776,256,0,255,0,6,0,0,1,220,0
253,792,256,0,255,0,6,0,0,1,221,0
253,808,256,0,255,0,6,0,0,1,222,0
253,824,256,0,255,0,6,0,0,1,422,0
253,840,208,0,255,180,6,0,0,1,421,0
253,856,208,0,255,180,6,0,0,1,423,0
253,872,208,0,255,180,6,0,0,1,424,0
253,888,208,0,255,180,6,0,0,1,425,0
253,904,208,0,255,180,6,0,0,1,426,0
253,920,208,0,255,180,6,0,0,1,428,0
253,936,208,0,255,180,6,0,0,1,429,0
100,832,208,0,256,16744576,0,269,0,1,769,0
100,904,208,0,256,16744576,0,269,0,1,770,0
1234567890
25,336,304,64,48,288,208,10002,0,0,0,0
25,336,304,64,48,208,208,10002,0,0,0,0
25,336,304,64,48,128,208,10002,0,0,0,0
25,336,304,64,48,48,208,10002,0,0,0,0
25,256,160,16,48,272,208,10002,0,0,0,0
25,256,160,16,48,352,208,10002,0,0,0,0
25,256,160,16,48,192,208,10002,0,0,0,0
25,256,160,16,48,112,208,10002,0,0,0,0
24,256,176,32,32,304,224,10000,0,0,0,0
24,256,176,32,32,144,224,10000,0,0,0,0
24,256,176,32,32,224,224,10000,0,0,0,0
24,256,176,32,32,64,224,10000,0,0,0,0
25,336,304,64,48,368,208,10002,0,0,0,0
25,256,160,16,48,432,208,10002,0,0,0,0
25,32,304,16,16,464,432,10002,0,0,0,0
25,256,208,16,32,496,176,10002,0,0,0,0
25,256,208,16,32,480,176,10002,0,0,0,0
25,256,160,16,48,32,208,10002,0,0,0,0
25,256,160,16,48,944,208,10002,0,0,0,0
25,256,160,16,48,544,208,10002,0,0,0,0
25,256,160,16,48,624,208,10002,0,0,0,0
25,256,160,16,48,704,208,10002,0,0,0,0
25,336,304,64,48,560,208,10002,0,0,0,0
25,336,304,64,48,640,208,10002,0,0,0,0
25,256,160,16,48,784,208,10002,0,0,0,0
25,336,304,64,48,720,208,10002,0,0,0,0
25,336,304,64,48,800,208,10002,0,0,0,0
25,336,304,64,48,880,208,10002,0,0,0,0
25,256,160,16,48,864,208,10002,0,0,0,0
25,112,176,32,48,448,192,10002,0,0,0,0
25,144,176,32,48,512,192,10002,0,0,0,0
25,112,176,32,48,512,240,10002,0,0,0,0
25,144,176,32,48,448,240,10002,0,0,0,0
25,96,240,16,16,528,160,10002,0,0,0,0
25,80,240,16,16,448,160,10002,0,0,0,0
25,32,176,48,32,560,144,10002,0,0,0,0
25,32,208,48,32,384,144,10002,0,0,0,0
25,16,208,16,16,432,160,10002,0,0,0,0
25,16,208,16,16,544,160,10002,0,0,0,0
24,304,80,16,16,480,432,10000,0,0,0,0
25,592,192,32,48,384,288,10002,0,0,0,0
25,592,192,32,48,416,288,10002,0,0,0,0
25,592,192,32,48,448,288,10002,0,0,0,0
25,592,192,32,48,480,288,10002,0,0,0,0
25,592,192,32,48,512,288,10002,0,0,0,0
25,592,192,32,48,544,288,10002,0,0,0,0
25,592,192,32,48,576,288,10002,0,0,0,0
24,256,176,32,32,656,224,10000,0,0,0,0
24,256,176,32,32,736,224,10000,0,0,0,0
24,256,176,32,32,816,224,10000,0,0,0,0
24,256,176,32,32,896,224,10000,0,0,0,0
24,256,176,32,32,576,224,10000,0,0,0,0
24,144,96,16,16,496,288,10000,0,0,0,0
24,128,96,16,16,480,288,10000,0,0,0,0
24,144,64,16,16,480,272,10000,0,0,0,0
24,128,80,16,16,496,272,10000,0,0,0,0
24,144,48,16,16,480,256,10000,0,0,0,0
24,128,48,16,16,496,256,10000,0,0,0,0
24,256,176,32,32,384,224,10000,0,0,0,0
24,96,16,32,16,448,304,10000,0,0,0,0
24,80,16,16,16,432,304,10000,0,0,0,0
24,80,16,16,16,416,304,10000,0,0,0,0
24,64,16,16,16,384,304,10000,0,0,0,0
24,80,16,16,16,400,304,10000,0,0,0,0
24,80,16,16,16,576,304,10000,0,0,0,0
24,80,16,16,16,560,304,10000,0,0,0,0
24,112,0,16,16,592,304,10000,0,0,0,0
24,64,0,32,16,512,304,10000,0,0,0,0
24,96,0,16,16,544,304,10000,0,0,0,0
24,368,0,16,16,560,288,10000,0,0,0,0
987654321
DQknBxM=

