Vlp6Ukx6AHkpcyFgMlFKL1hgVWp0OwJtVTU7SBJhIEV+enVgKSQ=
259,176,504,0,160,96,0,0,0,1,145,0
259,200,400,0,208,112,0,0,0,1,152,0
259,392,304,0,144,112,0,0,0,1,236,0
259,488,536,0,16,192,0,0,0,1,238,0
259,248,264,0,272,160,0,0,0,1,248,0
259,400,176,0,64,144,0,0,0,1,258,0
259,280,600,0,368,64,0,0,0,1,303,0
259,48,440,0,96,720,0,0,0,1,304,0
259,488,200,0,16,160,0,0,0,1,370,0
259,560,424,0,192,144,0,0,0,1,828,0
259,536,240,0,64,208,0,0,0,1,1104,0
259,750,240,0,384,208,0,0,0,1,1105,0
259,904,59,0,32,32,0,0,0,1,1106,0
259,960,320,0,64,336,0,0,0,1,1107,0
259,808,424,0,352,96,0,0,0,1,1108,0
259,776,536,0,528,96,0,0,0,1,1109,0
259,864,624,0,384,96,0,0,0,1,1110,0
259,768,704,0,160,80,0,0,0,1,1111,0
259,288,144,0,416,96,0,0,0,1,1187,0
259,744,120,0,512,48,0,0,0,1,1188,0
259,1056,288,0,128,368,0,0,0,1,1189,0
259,1128,496,0,176,880,0,0,0,1,1190,0
259,1024,728,0,368,144,0,0,0,1,1191,0
259,760,776,0,176,48,0,0,0,1,1192,0
259,584,704,0,176,256,0,0,0,1,1193,0
259,320,734,0,528,208,0,0,0,1,1194,0
160,808,736,0,1,16777215,0,0,0,1,1013,0
195,777,160,0,0,240,270,1086,596,1,632,0
123,784,224,0,284,0,0,0,0,1,431,0
224,408,416,0,128,255,0,0,0,1,1238,0
218,216,464,0,292,32768,0,90,0,1,1255,0
123,179,514,0,80,0,0,0,0,1,1307,0
197,720,736,0,2,0,0,0,0,1,1066,0
197,568,568,0,2,952,0,0,0,1,951,0
197,944,472,0,2,779,0,0,0,1,736,0
174,185,552,0,1,292,0,0,0,0,293,1
174,594,627,0,0,946,953,0,0,0,952,1
174,1013,359,0,0,802,780,0,0,0,779,1
174,992,568,0,1,980,0,0,0,0,979,1
193,685,129,0,0,672,0,0,0,1,1163,1
174,1016,288,0,0,864,865,1164,0,0,1167,1
174,568,128,0,0,418,417,0,0,0,392,1
174,593,128,0,0,420,419,0,0,0,393,1
174,624,128,0,0,415,421,0,0,0,394,1
174,766,123,0,0,657,658,656,0,0,596,1
193,1099,546,0,0,997,1005,0,0,1,1169,1
193,1080,299,0,0,1167,729,728,727,1,1166,1
174,296,296,0,0,138,117,0,0,0,108,1
174,296,264,0,0,57,127,65,69,0,138,1
174,199,456,0,1,77,0,0,0,0,35,1
174,232,456,0,1,189,193,215,0,0,41,1
174,440,312,0,1,9,0,0,0,0,15,1
205,792,472,0,1,0,0.50,0,0,0,865,0
205,663,472,0,1,0,0.50,0,0,0,729,0
205,760,472,0,1,0,0.50,0,0,0,864,0
205,728,472,0,1,0,0.50,0,0,0,727,0
205,696,472,0,1,0,0.50,0,0,0,728,0
205,824,472,0,1,0,0.50,0,0,0,1164,0
219,393,448,0,48,16,0,0,0,1,21,1
219,216,440,0,48,32,0,0,0,1,292,1
219,344,448,0,48,16,0,0,0,1,166,0
186,408,208,0,32,32,0,0,0,1,8,0
188,134,456,0,0,358,359,0,0,1,356,0
188,152,456,0,0,358,359,0,0,1,357,0
188,272,616,0,0,275,0,0,0,1,272,0
188,289,616,0,0,275,0,0,0,1,271,0
188,400,456,0,0,166,9,0,0,1,7,0
188,321,616,0,0,275,0,0,0,1,273,0
188,304,616,0,0,275,0,0,0,1,270,0
185,568,432,0,766,64,1,0,0,1,751,0
185,32,592,0,277,32,1,0,0,1,282,0
242,184,536,0,32,32,0,0,0,1,405,0
175,304,324,0,108,40,1,0,0,0,77,0
175,65,570,0,210,20,0,0,0,0,215,0
175,1066,359,0,764,60,0,0,0,0,780,0
175,552,616,0,954,10,0,0,0,0,953,0
154,128,288,0,1,5,32,112,1,1,59,1
154,192,304,0,3,5,32,112,1,1,67,1
154,224,312,0,4,5,32,112,1,1,71,1
154,256,319,0,5,5,32,112,1,1,119,1
154,160,296,0,2,5,32,112,1,1,129,0
154,152,560,0,6,10,80,16,1,1,191,1
154,224,560,0,7,10,64,16,1,1,195,1
154,184,704,0,8,10,144,16,1,1,212,1
154,32,592,0,9,4,32,16,-1,1,277,0
154,592,160,0,10,6,32,32,-1,1,659,1
154,668.94,277.28,0,12,0.40,16,64,1,1,674,1
154,568,432,0,13,4,32,32,-1,1,766,1
154,744,368,0,14,4,208,16,1,1,804,1
154,680,536,0,15,5,16,96,1,1,948,1
154,520,536,0,16,6,16,64,1,1,956,1
154,992,576,0,17,2,64,16,1,1,982,1
154,696,600,0,19,3,16,32,1,1,999,1
154,936,632,0,18,3.50,16,32,1,1,1007,1
154,776.36,204.03,0,11,0.50,32,32,-1,1,1086,1
210,112,402,0,0,270,0,0,0,1,56,0
210,112,384,0,0,270,0,0,0,1,226,0
210,360,456,0,89,0,0,0,0,1,88,0
210,345,456,0,90,0,0,0,0,1,87,0
210,304,416,0,86,90,0,0,0,1,91,0
210,329,456,0,91,0,0,0,0,1,86,0
210,304,448,0,88,90,0,0,0,1,89,0
210,256,544,0,56,90,0,0,0,1,55,0
210,448,592,0,373,90,0,0,0,1,280,0
210,536,152,0,0,180,0,0,0,1,373,0
210,520,152,0,0,180,0,0,0,1,372,0
210,552,152,0,0,180,0,0,0,1,374,0
210,448,576,0,372,90,0,0,0,1,279,0
210,449,608,0,374,90,0,0,0,1,281,0
210,304,432,0,87,90,0,0,0,1,90,0
210,256,528,0,226,90,0,0,0,1,225,0
158,432,456,0,1,16777215,0,1,0,1,3,0
216,232,400,0,54,0,0,0,0,1,44,0
216,197,400,0,59,0,0,0,0,1,42,0
216,168,408,0,5,1,0,0,0,1,346,0
216,624,528,0,79,0,0,0,0,1,1272,0
216,136,520,0,34,0,0,0,0,1,54,0
216,176,517,0,46,0,0,0,0,1,52,0
216,216,518,0,8,0,0,0,0,1,53,0
157,520,440,0,16,128,0,0,0,1,944,0
157,504,384,0,16,496,0,0,0,1,369,0
157,472,368,0,48,176,0,0,0,1,6,0
157,576,368,0,128,16,0,0,0,1,816,0
157,448,384,0,16,16,0,0,0,1,12,0
157,352,264,0,64,256,0,0,0,1,2,0
157,448,416,0,16,16,0,0,0,1,11,0
157,632,464,0,16,48,0,0,0,1,1128,0
157,376,456,0,16,16,0,0,0,1,180,0
157,368,512,0,224,112,0,0,0,1,5,0
157,832,480,0,416,16,0,0,0,1,724,0
157,312,400,0,16,112,0,0,0,1,23,0
157,216,472,0,80,32,0,0,0,1,49,0
157,136,464,0,48,16,0,0,0,1,46,0
157,104,368,0,16,496,0,0,0,1,45,0
157,720,352,0,416,16,0,0,0,1,376,0
157,448,352,0,16,16,0,0,0,1,173,0
157,384,352,0,16,16,0,0,0,1,336,0
157,296,352,0,16,16,0,0,0,1,26,0
157,280,352,0,16,16,0,0,0,1,98,0
157,592,576,0,160,16,0,0,0,1,866,0
157,464,600,0,32,64,0,0,0,1,269,0
157,384,624,0,128,16,0,0,0,1,268,0
157,576,224,0,16,176,0,0,0,1,375,0
157,744,144,0,464,16,0,0,0,1,371,0
157,888,368,0,80,16,0,0,0,1,801,0
157,872,448,0,48,64,0,0,0,1,730,0
157,920,320,0,16,48,0,0,0,1,735,0
157,976,376,0,16,16,0,0,0,1,731,0
157,976,344,0,16,16,0,0,0,1,732,0
157,976,312,0,16,16,0,0,0,1,733,0
157,976,408,0,16,16,0,0,0,1,840,0
157,976,440,0,16,16,0,0,0,1,852,0
157,984,304,0,16,336,0,0,0,1,723,0
172,392,208,0,0,0,0,0,0,1,9,0
155,128,288,0,1,1,0,0,0,0,57,0
155,128,400,0,2,1,0,0,0,0,58,0
155,192,304,0,1,3,0,0,0,0,65,0
155,192,400,0,2,3,0,0,0,0,66,0
155,224,312,0,1,4,0,0,0,0,69,0
155,224,400,0,2,4,0,0,0,0,70,0
155,256,319,0,1,5,0,0,0,0,117,0
155,256,400,0,2,5,0,0,0,0,118,0
155,160,296,0,1,2,0,0,0,0,127,0
155,160,400,0,2,2,0,0,0,0,128,0
155,152,560,0,1,6,0,0,0,0,189,0
155,152,624,0,2,6,0,0,0,1,190,0
155,224,560,0,1,7,0,0,0,0,193,0
155,224,624,0,2,7,0,0,0,1,194,0
155,288,624,0,3,7,0,0,0,0,197,0
155,72,624,0,3,6,0,0,0,0,198,0
155,184,704,0,1,8,0,0,0,0,210,0
155,184,624,0,2,8,0,0,0,0,211,0
155,32,592,0,1,9,0,0,0,0,275,0
155,415,592,0,2,9,0,0,0,0,276,0
172,504,240,0,1,0,0,0,0,0,415,1
172,536,160,0,0,0,0,0,0,0,417,1
172,504,160,0,1,0,0,0,0,0,418,1
172,536,200,0,0,0,0,0,0,0,419,1
172,504,200,0,1,0,0,0,0,0,420,1
172,536,240,0,0,0,0,0,0,0,421,1
155,592,160,0,1,10,0,0,0,0,657,0
155,968,160,0,2,10,0,0,0,0,658,0
155,640,312,0,1,12,0,0,0,1,672,0
155,680,264,0,2,12,0,0,0,1,673,0
155,712,312,0,3,12,0,0,0,1,686,0
155,768,272,0,4,12,0,0,0,1,698,0
155,824,312,0,5,12,0,0,0,1,710,0
155,864,272,0,6,12,0,0,0,1,711,0
155,568,432,0,1,13,0,0,0,0,764,0
155,1064,432,0,2,13,0,0,0,0,765,0
155,744,368,0,1,14,0,0,0,0,802,0
155,744,464,0,2,14,0,0,0,0,803,0
155,680,536,0,1,15,0,0,0,0,946,0
155,680,616,0,2,15,0,0,0,0,947,0
155,520,536,0,1,16,0,0,0,0,954,0
155,832,536,0,2,16,0,0,0,1,955,0
155,832,520,0,3,16,0,0,0,1,958,0
155,880,520,0,4,16,0,0,0,1,959,0
155,880,536,0,5,16,0,0,0,1,960,0
155,1016,536,0,6,16,0,0,0,0,961,0
155,992,576,0,1,17,0,0,0,0,980,0
155,992,608,0,2,17,0,0,0,0,981,0
155,696,600,0,1,19,0,0,0,0,997,0
155,937,600,0,2,19,0,0,0,1,998,0
155,936,632,0,1,18,0,0,0,0,1005,0
155,696,632,0,2,18,0,0,0,1,1006,0
155,720,200,0,1,11,0,0,0,1,1084,0
155,832,208,0,2,11,0,0,0,1,1085,0
166,112,448,0,0,0,0,0,0,0,358,1
166,112,432,0,0,0,0,0,0,0,359,1
166,592,160,0,659,0,270,0,0,0,656,1
253,440,384,0,16777215,0,5,0,0,1,1214,0
253,440,416,0,16777215,0,5,0,0,1,1211,0
253,440,352,0,16777215,0,5,0,0,1,1212,0
253,392,352,0,16777215,0,4,0,0,1,1215,0
157,448,320,0,32,16,0,0,0,1,14,0
157,456,208,0,64,144,0,0,0,1,314,0
157,824,576,0,272,16,0,0,0,1,950,0
157,864,656,0,320,16,0,0,0,1,990,0
157,680,712,0,16,96,0,0,0,1,1009,0
157,760,744,0,144,16,0,0,0,1,1010,0
157,1032,576,0,16,176,0,0,0,1,963,0
157,952,624,0,16,48,0,0,0,1,1002,0
157,992,632,0,64,32,0,0,0,1,1186,0
157,840,704,0,16,96,0,0,0,1,1011,0
242,536,320,0,48,48,0,0,0,1,395,0
242,952,352,0,48,48,0,0,0,1,1103,0
242,984,568,0,48,64,0,0,0,1,1145,0
176,536,296,0,394,48,32,0,0,1,389,0
176,536,256,0,393,48,32,0,0,1,390,0
176,536,216,0,392,48,32,0,0,1,391,0
176,536,192,0,1163,80,32,0,0,1,1162,0
176,953,350,0,1166,64,224,1,0,1,1165,0
176,992,560,0,1169,64,80,1,0,1,1168,0
216,768,424,0,61,0,0,0,0,1,1273,0
253,432,320,0,16777215,0,5,0,0,1,1213,0
253,968,376,0,16777215,0,5,0,0,1,1220,0
253,968,344,0,16777215,0,5,0,0,1,1219,0
253,968,312,0,16777215,0,5,0,0,1,1221,0
253,968,408,0,16777215,0,5,0,0,1,1218,0
253,968,440,0,16777215,0,5,0,0,1,1217,0
1234567890
25,272,256,192,48,304,416,10002,0,0,0,0
25,272,256,192,48,304,368,10002,0,0,0,0
25,336,256,128,48,368,320,10002,0,0,0,0
25,336,256,128,48,336,128,10002,0,0,0,0
25,288,256,80,48,368,176,10002,0,0,0,0
25,288,256,80,48,368,224,10002,0,0,0,0
25,288,256,80,48,384,272,10002,0,0,0,0
24,112,320,48,32,384,384,10000,0,0,0,0
24,464,256,32,32,448,416,10000,0,0,0,0
24,192,16,64,64,112,400,10000,0,0,0,0
24,192,16,64,64,112,336,10000,0,0,0,0
24,192,16,64,64,176,400,10000,0,0,0,0
24,192,16,64,64,176,336,10000,0,0,0,0
24,368,256,48,32,208,528,10000,0,0,0,0
24,64,0,128,32,192,592,10000,0,0,0,0
24,64,0,128,32,192,560,10000,0,0,0,0
24,64,0,128,32,64,560,10000,0,0,0,0
24,64,0,128,32,64,592,10000,0,0,0,0
24,256,112,64,32,240,416,10000,0,0,0,0
24,256,112,64,32,240,448,10000,0,0,0,0
24,256,112,64,32,240,384,10000,0,0,0,0
24,256,112,64,32,240,352,10000,0,0,0,0
24,240,320,64,32,192,496,10000,0,0,0,0
24,240,320,64,32,128,496,10000,0,0,0,0
24,64,32,16,64,112,496,10000,0,0,0,0
24,528,64,32,32,384,560,10000,0,0,0,0
24,496,128,32,32,416,592,10000,0,0,0,0
24,496,64,32,32,416,560,10000,0,0,0,0
24,496,160,32,32,384,592,10000,0,0,0,0
24,0,0,64,160,624,192,10000,0,0,0,0
24,0,0,64,160,688,192,10000,0,0,0,0
24,0,0,64,160,752,192,10000,0,0,0,0
24,0,0,64,160,816,192,10000,0,0,0,0
24,0,0,64,32,624,160,10000,0,0,0,0
24,0,0,64,32,688,160,10000,0,0,0,0
24,0,0,64,32,752,160,10000,0,0,0,0
24,0,0,64,32,816,160,10000,0,0,0,0
24,0,0,64,32,880,160,10000,0,0,0,0
24,0,0,64,32,944,160,10000,0,0,0,0
24,0,0,64,16,608,144,10000,0,0,0,0
24,0,0,64,16,544,144,10000,0,0,0,0
24,0,0,64,16,672,144,10000,0,0,0,0
24,0,0,64,16,736,144,10000,0,0,0,0
24,0,0,64,16,800,144,10000,0,0,0,0
24,0,0,64,16,864,144,10000,0,0,0,0
24,0,0,64,16,928,144,10000,0,0,0,0
24,512,224,32,64,512,160,10000,0,0,0,0
24,496,304,64,32,512,224,10000,0,0,0,0
24,0,160,32,32,528,320,10000,0,0,0,0
25,496,224,32,128,512,224,10002,0,0,0,0
25,496,224,32,128,544,224,10002,0,0,0,0
25,496,224,32,128,544,96,10002,0,0,0,0
25,496,224,32,128,512,96,10002,0,0,0,0
24,16,0,48,160,576,192,10000,0,0,0,0
24,0,0,64,32,560,160,10000,0,0,0,0
25,448,176,48,48,928,304,10002,0,0,0,0
24,0,0,32,32,576,112,10000,0,0,0,0
24,0,0,64,160,880,192,10000,0,0,0,0
24,0,0,64,128,944,192,10000,0,0,0,0
24,256,112,64,32,944,320,10000,0,0,0,0
24,256,112,64,32,944,352,10000,0,0,0,0
24,256,112,64,32,880,352,10000,0,0,0,0
24,256,112,64,32,880,384,10000,0,0,0,0
24,256,112,64,32,944,384,10000,0,0,0,0
24,256,112,64,32,880,416,10000,0,0,0,0
24,256,112,64,32,944,416,10000,0,0,0,0
24,256,112,64,32,880,448,10000,0,0,0,0
24,256,112,64,32,944,448,10000,0,0,0,0
25,272,176,224,80,656,400,10002,0,0,0,0
25,272,176,160,80,496,400,10002,0,0,0,0
25,272,224,224,32,656,368,10002,0,0,0,0
25,272,224,32,32,512,368,10002,0,0,0,0
25,272,224,32,32,544,368,10002,0,0,0,0
25,272,224,32,32,576,368,10002,0,0,0,0
25,272,224,32,32,608,368,10002,0,0,0,0
25,272,256,192,96,528,480,10002,0,0,0,0
25,272,256,192,96,720,480,10002,0,0,0,0
25,272,256,192,96,912,480,10002,0,0,0,0
25,272,48,192,96,672,576,10002,0,0,0,0
25,272,48,192,96,864,576,10002,0,0,0,0
25,272,48,192,96,672,672,10002,0,0,0,0
24,64,320,48,32,336,576,10000,0,0,0,0
25,336,304,128,48,112,512,10002,0,0,0,0
25,336,304,128,48,112,464,10002,0,0,0,0
25,336,304,128,48,240,464,10002,0,0,0,0
25,336,304,128,48,240,512,10002,0,0,0,0
987654321

