UFt8TlN0AGU9Z0FLEFlCMUdgb0pXUmAOSSknVA59PFliZmk=
160,263,330,0,0,16777215,0,0,0,1,56,0
195,544,272,0,0,128,231,0,0,1,163,0
123,160,88,0,128,0,0,0,0,1,160,0
224,305,325,0,150,65280,0,0,0,1,200,0
123,368,296,0,128,0,0,0,0,1,100,0
123,24,216,0,128,0,0,0,0,1,3,0
100,432,288,0,256,0,0,0,0,1,164,0
197,256,112,0,3,40,0,0,0,1,38,0
197,575,248,0,1,135,0,0,0,1,136,0
197,600,192,0,2,0,0,0,0,1,173,0
174,360,208,0,1,109,0,0,0,1,75,0
174,488,192,0,1,93,0,0,0,0,92,1
189,168,328,0,0,128,90,0,0,1,51,0
189,184,328,0,0,128,90,0,0,1,52,0
205,535.40,336,0,-1,0,0.60,0,0,1,99,0
205,223.60,112,0,1,0,0.40,0,0,1,27,0
205,104.50,240,0,1,0,0.50,0,0,1,36,0
186,552,112,0,32,32,0,0,0,1,77,0
186,496,336,0,32,32,0,0,0,1,159,0
186,120,112,0,32,32,0,0,0,1,23,0
188,576,112,0,0,113,0,0,0,1,125,0
188,528,112,0,0,121,0,123,0,1,79,0
188,632,336,0,0,181,0,0,0,1,182,0
188,96,112,0,0,13,0,0,0,1,16,0
188,560,336,0,0,114,116,0,0,1,97,0
188,304,176,0,0,13,0,0,0,1,24,0
242,360,120,0,32,32,0,0,0,1,85,0
179,376,312,0,1,32,32,0,0,1,194,0
154,659.50,128,0,1,0.50,32,32,1,1,151,1
210,80,312,0,53,0,0,0,0,1,104,0
210,368,136,0,0,0,0,0,0,1,53,0
158,32,112,0,0,16711680,0,1,0,1,15,0
157,240,128,0,32,32,0,0,0,1,5,0
157,272,128,0,32,32,0,0,0,1,6,0
157,304,192,0,32,32,0,0,0,1,7,0
157,336,120,0,32,248,0,0,0,1,8,0
157,361,152,0,32,32,0,0,0,1,57,0
157,368,216,0,32,16,0,0,0,1,71,0
157,400,216,0,32,16,0,0,0,1,70,0
157,448,216,0,32,16,0,0,0,1,81,0
157,480,208,0,32,32,0,0,0,1,82,0
157,512,208,0,32,32,0,0,0,1,133,0
157,544,208,0,32,32,0,0,0,1,134,0
157,432,152,0,32,32,0,0,0,1,69,0
157,576,160,0,32,32,0,0,0,1,129,0
157,576,184,0,32,32,0,0,0,1,130,0
157,576,128,0,32,32,0,0,0,1,64,0
157,544,128,0,32,32,0,0,0,1,74,0
157,432,88,0,32,32,0,0,0,1,61,0
157,496,48,0,32,32,0,0,0,1,62,0
157,528,48,0,32,32,0,0,0,1,63,0
157,432,120,0,32,32,0,0,0,1,68,0
157,512,128,0,32,32,0,0,0,1,76,0
157,272,256,0,160,32,1,0,0,1,32,0
157,208,192,0,160,32,1,0,0,1,9,0
157,208,128,0,32,32,0,0,0,1,2,0
157,79,128,0,160,32,1,0,0,1,21,0
157,224,288,0,32,32,0,0,0,1,54,0
157,136,256,0,160,32,1,0,0,1,35,0
157,65,88,0,32,48,0,0,0,1,10,0
157,432,352,0,160,32,1,0,0,1,96,0
157,344,336,0,32,32,0,0,0,1,117,0
157,568,352,0,160,32,1,0,0,1,98,0
157,512,144,0,160,32,1,0,0,1,80,0
157,576,264,0,160,32,1,0,0,1,86,0
157,480,264,0,160,32,1,0,0,1,87,0
157,272,352,0,160,32,1,0,0,1,48,0
157,240,352,0,160,32,1,0,0,1,47,0
157,80,328,0,160,32,1,0,0,1,46,0
157,80,344,0,160,32,1,0,0,1,45,0
157,0,216,0,32,248,0,0,0,1,184,0
157,0,16,0,32,248,0,0,0,1,183,0
172,160,112,0,1,0,0,0,0,1,13,1
172,592,192,0,1,0,0,0,0,0,93,0
169,415,168,0,0,0,0,0,0,1,121,1
169,416,208,0,0,0,0,0,0,0,123,1
172,656,185,0,0,0,0,0,0,1,140,1
172,630,216,0,0,0,0,0,0,1,142,1
172,680,152,0,0,0,0,0,0,1,144,1
172,704,120,0,0,0,0,0,0,1,146,1
155,608,128,0,1,1,0,0,0,1,149,0
155,688,128,0,2,1,0,0,0,1,150,0
166,312,216,0,0,0,180,0,0,1,33,1
166,16,160,0,0,0,0,0,0,1,40,1
166,472,128,0,0,0,90,0,0,1,109,1
166,312,336,0,0,0,90,0,0,1,113,1
166,328,336,0,0,0,90,0,0,1,114,1
166,248,280,0,0,0,0,0,0,1,116,1
166,552,184,0,0,0,180,0,0,1,135,1
166,456,280,0,0,0,270,0,0,1,181,1
237,320,0,0,255,268,0,0,0,1,65,0
196,456.50,280.50,0,0,0,0,0,0,0,0,0
1234567890
25,272,256,192,48,16,0,10002,0,0,0,0
25,272,256,192,48,16,48,10002,0,0,0,0
25,272,256,192,48,16,96,10002,0,0,0,0
25,272,256,192,48,16,144,10002,0,0,0,0
25,272,256,192,48,16,192,10002,0,0,0,0
25,272,256,192,48,16,240,10002,0,0,0,0
25,272,256,192,48,16,288,10002,0,0,0,0
25,272,256,192,48,336,288,10002,0,0,0,0
25,272,256,192,48,336,240,10002,0,0,0,0
25,272,304,192,48,208,192,10002,0,0,0,0
25,272,304,192,48,208,144,10002,0,0,0,0
25,272,304,192,48,208,96,10002,0,0,0,0
25,272,304,192,48,208,48,10002,0,0,0,0
25,272,304,192,48,208,0,10002,0,0,0,0
25,272,304,192,48,400,192,10002,0,0,0,0
25,272,304,192,48,400,144,10002,0,0,0,0
25,272,304,192,48,400,96,10002,0,0,0,0
25,272,304,192,48,400,48,10002,0,0,0,0
25,272,304,192,48,400,0,10002,0,0,0,0
25,400,256,64,48,528,240,10002,0,0,0,0
25,400,256,64,48,592,0,10002,0,0,0,0
25,400,256,64,48,592,48,10002,0,0,0,0
25,400,256,64,48,592,96,10002,0,0,0,0
25,400,256,64,48,592,144,10002,0,0,0,0
25,400,256,64,48,592,192,10002,0,0,0,0
25,400,256,64,48,592,240,10002,0,0,0,0
25,400,256,64,48,592,288,10002,0,0,0,0
25,400,256,64,48,528,288,10002,0,0,0,0
25,448,176,48,48,640,336,10002,0,0,0,0
25,448,176,48,48,688,336,10002,0,0,0,0
25,448,176,48,48,656,288,10002,0,0,0,0
25,448,176,48,48,656,240,10002,0,0,0,0
25,448,176,48,48,656,192,10002,0,0,0,0
25,448,176,48,48,656,144,10002,0,0,0,0
25,448,176,48,48,656,96,10002,0,0,0,0
25,448,176,48,48,656,48,10002,0,0,0,0
25,448,176,48,48,656,0,10002,0,0,0,0
25,448,176,48,48,704,0,10002,0,0,0,0
25,448,176,48,48,704,48,10002,0,0,0,0
25,448,176,48,48,704,96,10002,0,0,0,0
25,448,176,48,48,704,144,10002,0,0,0,0
25,448,176,48,48,704,192,10002,0,0,0,0
25,448,176,48,48,704,240,10002,0,0,0,0
25,448,176,48,48,704,288,10002,0,0,0,0
987654321
DR05FkAjECtgJ2pHMkUcYxQ1fllcDXBNFWE3GlEoIlUfM3kyd3V4OGggLAA5HDd7DCg=
DR05FkA2QjA=

