XlF4TlN0AGU9Z3lHNl5AIxgZdUxHCjxHHTQ7SBJhIEV+enVgKSQ9Zg==
178,128,240,0,16,64,0,0,0,1,225,0
123,642,6,0,128,8421440,0,0,0,1,103,0
100,583,0,0,256,16744448,0,270,0,1,180,0
123,112,176,0,300,8421440,0,0,0,1,231,0
100,286,4,0,256,255,0,309,0,1,234,0
100,216,96,0,256,4194368,0,309,0,1,14,0
100,728,1,0,256,255,0,270,0,1,236,0
100,616,256,0,256,255,0,270,0,1,161,0
100,736,224,0,256,255,0,270,0,1,238,0
100,376,208,0,256,16744448,0,270,0,1,244,0
100,368,85,0,256,65535,0,270,0,1,240,0
100,357,1,0,256,16744448,0,270,0,1,235,0
123,465,314,0,128,8421440,0,0,0,1,87,0
100,152,256,0,256,65535,0,0,0,1,241,0
123,528,8,0,300,8421440,0,0,0,1,179,0
100,728,64,0,256,255,0,270,0,1,239,0
100,600,149,0,256,16744448,0,180,0,1,245,0
100,243,4,0,256,255,0,248,0,1,233,0
100,312,328,0,256,16744448,0,180,0,1,257,0
123,210,324,0,128,4227072,0,0,0,1,232,0
123,172,204,0,128,8421440,0,0,0,1,242,0
100,776,320,0,256,65535,0,90,0,1,229,0
224,976,240,0,128,65535,0,0,0,1,160,0
100,984,336,0,256,16744448,0,180,0,1,88,0
224,792,136,0,150,8421440,0,0,0,1,230,0
197,232,64,0,2,0,0,0,0,1,221,0
197,584,96,0,2,0,0,0,0,1,85,0
197,304,40,0,1,0,0,0,0,1,63,0
197,730,96,0,2,0,0,0,0,1,101,0
174,728,48,0,1,103,98,0,0,0,100,1
174,616,328,0,1,128,0,0,0,0,155,1
174,736,288,0,1,95,246,0,0,0,163,1
205,162.50,271,0,1,0,0.50,0,0,1,228,0
205,841.50,232,0,1,0,0.50,0,0,1,252,0
205,360.50,176,0,1,0,0.50,0,0,1,43,0
186,751,48,0,32,32,0,0,0,1,94,0
188,368,176,0,0,89,0,0,0,1,90,0
188,384,176,0,0,53,0,0,0,1,44,0
188,776,328,0,0,112,0,0,0,1,110,0
188,216,272,0,0,214,0,0,0,1,227,0
188,184,272,0,0,225,264,0,0,1,224,0
185,704,336,0,0,32,1,0,0,1,141,0
242,584,80,0,32,32,0,0,0,1,92,0
242,88,328,0,32,32,0,0,0,1,256,0
179,424,304,0,0,32,32,0,0,1,91,0
154,648,104,0,1,2,32,16,1,0,128,1
210,536,144,0,86,270,0,0,0,1,81,0
210,360,48,0,55,0,0,0,0,1,54,0
210,376,208,0,0,180,0,0,0,1,55,0
210,985,337,0,190,90,0,0,0,1,188,0
210,312,312,0,188,90,0,0,0,1,190,0
210,584,0,0,0,180,0,0,0,1,86,0
158,232,160,0,0,16777215,0,1,0,1,32,0
157,328,176,0,32,32,0,0,0,1,4,0
157,392,192,0,32,32,0,0,0,1,6,0
157,424,176,0,32,32,0,0,0,1,7,0
157,456,176,0,32,32,0,0,0,1,9,0
157,552,80,0,32,32,0,0,0,1,10,0
157,488,144,0,32,32,0,0,0,1,11,0
157,360,192,0,32,32,0,0,0,1,12,0
157,488,176,0,32,32,0,0,0,1,13,0
157,552,112,0,32,32,0,0,0,1,17,0
157,552,48,0,32,32,0,0,0,1,23,0
157,424,240,0,32,32,0,0,0,1,24,0
157,424,56,0,32,32,0,0,0,1,25,0
157,456,56,0,32,32,0,0,0,1,26,0
157,520,112,0,32,32,0,0,0,1,27,0
157,520,144,0,32,32,0,0,0,1,28,0
157,520,176,0,32,32,0,0,0,1,29,0
157,552,16,0,32,32,0,0,0,1,30,0
157,424,208,0,32,32,0,0,0,1,42,0
157,328,208,0,32,32,0,0,0,1,45,0
157,328,240,0,32,32,0,0,0,1,46,0
157,328,272,0,32,32,0,0,0,1,47,0
157,424,272,0,32,32,0,0,0,1,48,0
157,392,56,0,32,32,0,0,0,1,49,0
157,360,64,0,32,32,0,0,0,1,50,0
157,328,56,0,32,32,0,0,0,1,51,0
157,328,304,0,32,32,0,0,0,1,56,0
157,328,336,0,32,32,0,0,0,1,57,0
157,360,336,0,32,32,0,0,0,1,58,0
157,392,336,0,32,32,0,0,0,1,59,0
157,424,336,0,32,32,0,0,0,1,60,0
157,456,336,0,32,32,0,0,0,1,61,0
157,488,336,0,32,32,0,0,0,1,62,0
157,488,304,0,32,32,0,0,0,1,69,0
157,488,272,0,32,32,0,0,0,1,70,0
157,520,272,0,32,32,0,0,0,1,71,0
157,552,240,0,96,32,0,0,0,1,72,0
157,488,248,0,32,16,0,0,0,1,73,0
157,584,112,0,32,32,0,0,0,1,76,0
157,584,216,0,32,16,0,0,0,1,80,0
157,584,344,0,32,32,0,0,0,1,147,0
157,584,264,0,32,16,0,0,0,1,148,0
157,584,280,0,32,32,0,0,0,1,149,0
157,584,312,0,32,32,0,0,0,1,150,0
157,552,312,0,32,112,0,0,0,1,151,0
157,520,336,0,32,32,0,0,0,1,152,0
157,520,304,0,32,32,0,0,0,1,154,0
157,424,360,0,224,16,0,0,0,1,189,0
157,616,112,0,32,32,0,0,0,1,77,0
157,616,48,0,32,32,0,0,0,1,83,0
157,616,16,0,32,32,0,0,0,1,84,0
157,616,144,0,32,32,0,0,0,1,75,0
157,616,176,0,32,32,0,0,0,1,74,0
157,616,208,0,32,32,0,0,0,1,78,0
157,616,240,0,32,32,0,0,0,1,79,0
157,616,344,0,32,32,0,0,0,1,133,0
157,648,352,0,32,16,0,0,0,1,162,0
157,296,176,0,32,32,0,0,0,1,3,0
157,296,56,0,32,32,0,0,0,1,52,0
157,296,256,0,32,32,0,0,0,1,66,0
157,208,287,0,208,32,0,0,0,1,68,0
157,184,352,0,256,16,0,0,0,1,205,0
157,264,176,0,32,32,0,0,0,1,2,0
157,264,80,0,32,32,0,0,0,1,5,0
157,264,16,0,32,32,0,0,0,1,18,0
157,264,48,0,32,32,0,0,0,1,41,0
157,264,256,0,32,32,0,0,0,1,67,0
157,208,232,0,112,16,0,0,0,1,223,0
157,232,176,0,32,32,0,0,0,1,39,0
157,232,80,0,32,32,0,0,0,1,16,0
157,200,80,0,32,32,0,0,0,1,19,0
157,200,112,0,32,32,0,0,0,1,20,0
157,200,144,0,32,32,0,0,0,1,31,0
157,200,176,0,32,32,0,0,0,1,222,0
157,144,240,0,16,64,0,0,0,1,210,0
157,144,192,0,16,32,0,0,0,1,211,0
157,144,160,0,16,32,0,0,0,1,212,0
157,144,64,0,16,32,0,0,0,1,215,0
157,144,112,0,16,64,0,0,0,1,226,0
157,64,312,0,16,64,0,0,0,1,207,0
157,64,240,0,16,48,0,0,0,1,208,0
157,64,168,0,16,64,0,0,0,1,213,0
157,16,176,0,80,368,0,0,0,1,206,0
157,128,112,0,16,64,0,0,0,1,214,0
157,680,208,0,32,32,0,0,0,1,145,0
157,680,112,0,32,32,0,0,0,1,119,0
157,680,144,0,32,32,0,0,0,1,109,0
157,680,176,0,32,32,0,0,0,1,130,0
157,712,112,0,32,32,0,0,0,1,120,0
157,712,56,0,32,16,0,0,0,1,82,0
157,744,208,0,32,32,0,0,0,1,135,0
157,744,112,0,32,32,0,0,0,1,121,0
157,744,56,0,32,16,0,0,0,1,97,0
157,744,176,0,32,32,0,0,0,1,134,0
157,808,264,0,32,208,0,0,0,1,107,0
157,880,41,0,144,16,0,0,0,1,195,0
157,680,232,0,32,16,0,0,0,1,146,0
157,680,344,0,32,32,0,0,0,1,131,0
157,712,344,0,32,32,0,0,0,1,132,0
157,728,296,0,32,16,0,0,0,1,138,0
157,744,344,0,32,32,0,0,0,1,106,0
157,744,304,0,32,32,0,0,0,1,139,0
157,744,328,0,32,16,0,0,0,1,140,0
157,752,272,0,16,32,0,0,0,1,137,0
157,752,240,0,16,32,0,0,0,1,136,0
157,776,344,0,32,32,0,0,0,1,105,0
157,880,240,0,112,16,0,0,0,1,117,0
157,912,360,0,176,16,0,0,0,1,200,0
157,992,176,0,16,368,0,0,0,1,187,0
169,696,64,0,0,0,0,0,0,1,95,1
169,744,64,0,0,0,0,0,0,1,98,1
155,648,104,0,1,1,0,0,0,1,126,1
155,648,336,0,2,1,0,0,0,1,127,0
169,936,0,0,0,0,0,0,0,1,246,1
169,184,192,0,0,0,0,0,0,1,264,1
166,344,280,0,0,0,0,0,0,1,53,1
166,536,176,0,0,0,0,0,0,1,89,1
166,912,80,0,0,0,180,0,0,0,112,1
253,272,88,0,16777215,0,0,0,0,1,64,0
253,128,208,0,16777215,0,0,0,0,1,216,0
253,128,80,0,16777215,0,0,0,0,1,218,0
253,112,272,0,16777215,0,0,0,0,1,220,0
253,64,280,0,16777215,0,0,0,0,1,209,0
253,64,136,0,16777215,0,0,0,0,1,217,0
253,64,216,0,16777215,0,0,0,0,1,219,0
196,344.50,279.50,0,0,0,0,0,0,0,0,0
196,536.50,175.50,0,0,0,0,0,0,0,0,0
196,344.50,279.50,0,0,0,0,0,0,0,0,0
196,536.50,175.50,0,0,0,0,0,0,0,0,0
196,191.50,207.50,0,0,0,0,0,0,0,0,0
196,536.50,175.50,0,0,0,0,0,0,0,0,0
160,288,240,0,0,16777215,0,0,0,1,65,0
157,840,176,0,32,32,0,0,0,1,104,0
157,840,144,0,32,32,0,0,0,1,108,0
157,840,112,0,32,32,0,0,0,1,115,0
157,872,112,0,32,32,0,0,0,1,116,0
157,904,112,0,32,32,0,0,0,1,253,0
157,936,80,0,32,32,0,0,0,1,111,0
157,936,112,0,32,32,0,0,0,1,118,0
157,936,56,0,32,16,0,0,0,1,164,0
219,944,184,0,80,16,0,0,0,1,182,1
219,936,312,0,96,16,0,0,0,1,185,1
219,952,296,0,64,16,0,0,0,1,184,1
242,728,80,0,32,32,0,0,0,1,254,0
1234567890
24,416,160,16,32,736,160,10000,0,0,0,0
24,416,160,16,32,688,272,10000,0,0,0,0
24,400,160,16,16,720,160,10000,0,0,0,0
24,160,320,48,32,656,240,10000,0,0,0,0
24,400,192,16,32,704,128,10000,0,0,0,0
24,400,192,16,32,704,160,10000,0,0,0,0
24,400,192,16,32,704,192,10000,0,0,0,0
24,400,192,16,32,704,224,10000,0,0,0,0
24,400,192,16,32,704,256,10000,0,0,0,0
24,496,0,64,32,656,304,10000,0,0,0,0
24,160,288,128,32,400,192,10000,0,0,0,0
24,464,176,32,16,336,304,10000,0,0,0,0
24,464,208,32,16,368,304,10000,0,0,0,0
24,432,192,16,16,352,272,10000,0,0,0,0
24,0,256,64,32,272,80,10000,0,0,0,0
24,336,80,48,16,384,0,10000,0,0,0,0
24,336,48,32,16,416,16,10000,0,0,0,0
24,384,80,48,16,432,0,10000,0,0,0,0
24,368,64,32,16,480,0,10000,0,0,0,0
24,368,64,32,16,512,0,10000,0,0,0,0
24,368,64,32,16,352,0,10000,0,0,0,0
24,368,64,32,16,320,0,10000,0,0,0,0
24,368,64,32,16,288,0,10000,0,0,0,0
24,288,160,16,16,288,160,10000,0,0,0,0
24,288,144,32,32,224,96,10000,0,0,0,0
24,256,288,16,16,288,144,10000,0,0,0,0
24,320,240,48,16,64,16,10000,0,0,0,0
24,320,240,48,16,192,16,10000,0,0,0,0
24,336,48,32,16,672,0,10000,0,0,0,0
24,336,48,32,16,864,0,10000,0,0,0,0
24,464,256,32,32,928,0,10000,0,0,0,0
24,464,256,32,32,688,64,10000,0,0,0,0
24,464,256,32,32,736,64,10000,0,0,0,0
24,464,256,32,32,176,192,10000,0,0,0,0
24,160,288,192,32,112,304,10000,0,0,0,0
24,112,320,48,32,928,288,10000,0,0,0,0
24,320,240,48,16,832,256,10000,0,0,0,0
24,320,240,48,16,864,128,10000,0,0,0,0
987654321

