UVx6TlN0AGU9Z1pDakB3CwlxN3RPDTVQLWB6CFI0PER+enVgKSQ9ZmRjbV9+SQ==
160,608,224,0,0,16777215,0,0,0,1,15,0
158,184,176,0,1,16777215,0,1,0,1,5,0
123,608,288,0,40,16777215,0,0,0,1,2,0
195,264,88,0,0,140,255,0,61,1,59,0
100,240,96,0,312,16777215,0,270,0,1,63,0
197,304,224,0,3,55,0,0,0,1,65,0
197,608,320,0,2,67,0,0,0,1,16,0
197,432,224,0,3,56,0,0,0,1,54,0
174,328,144,0,1,66,0,0,0,1,25,1
174,304,328,0,1,68,0,0,0,0,74,1
189,496,88,0,0,128,271,0,0,1,49,0
186,496,224,0,32,32,0,0,0,1,32,0
219,280,200,0,16,48,0,0,0,1,66,1
219,328,200,0,16,48,0,0,0,1,67,1
188,528,320,0,0,57,0,0,0,1,58,0
157,256,240,0,32,32,0,0,0,1,9,0
157,288,240,0,32,32,0,0,0,1,3,0
157,224,240,0,32,32,0,0,0,1,4,0
157,320,240,0,32,32,0,0,0,1,10,0
157,352,240,0,32,32,0,0,0,1,11,0
157,384,240,0,32,32,0,0,0,1,12,0
157,416,240,0,32,32,0,0,0,1,13,0
157,448,240,0,32,32,0,0,0,1,14,0
157,480,240,0,32,32,0,0,0,1,17,0
157,528,240,0,32,32,0,0,0,1,18,0
157,624,240,0,32,32,0,0,0,1,19,0
157,592,240,0,32,32,0,0,0,1,20,0
157,624,336,0,32,32,0,0,0,1,21,0
157,592,336,0,32,32,0,0,0,1,22,0
157,560,336,0,32,32,0,0,0,1,23,0
157,528,336,0,32,32,0,0,0,1,24,0
157,224,64,0,32,32,0,0,0,1,26,0
157,256,64,0,32,32,0,0,0,1,27,0
157,286,64,0,32,32,0,0,0,1,28,0
157,312,64,0,32,32,0,0,0,1,29,0
157,344,64,0,32,32,0,0,0,1,30,0
157,376,64,0,32,32,0,0,0,1,31,0
157,624,64,0,32,32,0,0,0,1,33,0
157,592,64,0,32,32,0,0,0,1,34,0
157,560,64,0,32,32,0,0,0,1,35,0
157,528,64,0,32,32,0,0,0,1,36,0
157,496,64,0,32,32,0,0,0,1,37,0
157,464,64,0,32,32,0,0,0,1,38,0
157,432,64,0,32,32,0,0,0,1,39,0
157,192,240,0,32,32,0,0,0,1,41,0
157,192,208,0,32,32,0,0,0,1,42,0
157,192,192,0,32,32,0,0,0,1,43,0
157,192,64,0,32,32,0,0,0,1,44,0
157,192,272,0,32,32,0,0,0,1,45,0
157,192,304,0,32,32,0,0,0,1,46,0
157,192,336,0,32,32,0,0,0,1,47,0
157,192,360,0,32,32,0,0,0,1,48,0
157,176,64,0,32,32,0,0,0,1,50,0
157,176,192,0,32,32,0,0,0,1,51,0
157,144,192,0,32,32,0,0,0,1,52,0
157,144,64,0,32,32,0,0,0,1,53,0
157,288,160,0,32,32,0,0,0,1,60,0
157,320,160,0,32,32,0,0,0,1,64,0
157,464,336,0,32,32,0,0,0,1,71,0
157,392,352,0,32,32,0,0,0,1,72,0
157,304,344,0,32,32,0,0,0,1,73,0
169,552,288,0,1,0,0,0,0,0,68,1
237,320,0,0,16777215,300,0,0,0,1,40,0
253,240,88,0,16777215,0,1,0,0,1,62,0
166,536,88,0,0,0,219,0,0,1,55,1
166,552,88,0,0,0,232,0,0,1,56,1
166,568,88,0,0,0,247,0,0,1,57,1
166,328,96,0,0,0,220,0,0,1,61,1
1234567890
34,272,96,64,48,208,176,10002,0,0,0,0
34,272,96,64,48,336,176,10002,0,0,0,0
34,336,48,64,48,272,176,10002,0,0,0,0
34,272,48,64,48,272,128,10002,0,0,0,0
34,336,0,64,48,336,128,10002,0,0,0,0
34,336,96,64,48,208,128,10002,0,0,0,0
34,336,0,64,48,464,128,10002,0,0,0,0
34,336,0,64,48,272,80,10002,0,0,0,0
34,336,0,64,48,400,80,10002,0,0,0,0
34,272,48,64,48,336,80,10002,0,0,0,0
34,272,48,64,48,208,80,10002,0,0,0,0
34,400,0,192,144,208,224,10002,0,0,0,0
34,592,0,48,96,592,224,10002,0,0,0,0
34,592,0,48,96,592,320,10002,0,0,0,0
37,288,192,32,64,208,128,9998,0,0,0,0
37,368,144,64,16,352,208,9998,0,0,0,0
37,96,96,256,32,240,256,9998,0,0,0,0
37,272,32,64,32,272,192,9998,0,0,0,0
37,464,96,64,32,336,176,9998,0,0,0,0
37,464,64,64,32,464,192,9998,0,0,0,0
37,464,96,64,32,400,128,9998,0,0,0,0
37,368,144,64,16,576,208,9998,0,0,0,0
34,272,48,128,48,464,80,10002,0,0,0,0
34,272,48,128,48,464,176,10002,0,0,0,0
34,272,48,128,48,528,128,10002,0,0,0,0
34,272,48,128,48,592,80,10002,0,0,0,0
34,272,48,128,48,592,176,10002,0,0,0,0
37,368,144,64,16,176,32,9998,0,0,0,0
37,368,144,64,16,240,32,9998,0,0,0,0
37,368,144,64,16,304,32,9998,0,0,0,0
37,368,144,64,16,416,32,9998,0,0,0,0
37,368,144,64,16,496,32,9998,0,0,0,0
37,368,144,64,16,560,32,9998,0,0,0,0
37,368,144,64,16,624,32,9998,0,0,0,0
37,368,160,64,64,320,80,9998,0,0,0,0
37,144,176,96,96,304,288,9998,0,0,0,0
34,576,288,48,48,160,128,10002,0,0,0,0
34,112,96,16,48,128,80,10002,0,0,0,0
34,0,240,48,48,160,80,10002,0,0,0,0
34,176,112,16,16,144,80,10002,0,0,0,0
34,144,112,16,16,144,96,10002,0,0,0,0
34,144,112,16,16,144,112,10002,0,0,0,0
34,144,112,16,16,144,128,10002,0,0,0,0
34,160,128,16,16,144,160,10002,0,0,0,0
34,112,112,16,16,144,144,10002,0,0,0,0
34,160,112,16,16,128,160,10002,0,0,0,0
34,144,112,16,16,128,144,10002,0,0,0,0
34,112,112,16,16,128,128,10002,0,0,0,0
34,400,0,96,144,32,48,10002,0,0,0,0
34,496,0,96,96,80,192,10002,0,0,0,0
34,496,0,96,96,80,288,10002,0,0,0,0
34,480,0,64,144,16,192,10002,0,0,0,0
34,480,0,64,144,16,336,10002,0,0,0,0
34,400,0,16,144,0,192,10002,0,0,0,0
34,400,0,16,144,0,336,10002,0,0,0,0
34,416,0,32,144,0,48,10002,0,0,0,0
34,400,0,192,144,400,224,10002,0,0,0,0
34,336,48,64,48,400,176,10002,0,0,0,0
34,272,96,64,48,400,128,10002,0,0,0,0
34,128,304,16,16,400,48,10002,0,0,0,0
34,112,304,16,16,384,48,10002,0,0,0,0
34,96,304,16,16,400,64,10002,0,0,0,0
34,128,304,16,16,384,64,10002,0,0,0,0
987654321
Kwk5BxIxEG8lO2FPJ01CKFk/NRhrHyNbVSVlEVk5eEo=

