UVx6TlN0AGU9Z24cP150CwlxN2taHyJWFWBhHVJ9PFliZml8NTghenh/cQ==
337,224,112,0,16,0,0,120,0,1,44,0
330,296,112,0,10,0,0,120,0,1,41,0
336,408,136,0,15,0,0,120,0,1,40,0
333,136,128,0,9,0,0,120,0,1,43,0
332,264,136,0,12,0,0,120,0,1,45,0
367,208,144,0,27,0,0,120,0,1,46,0
367,232,143,0,27,0,0,120,0,1,47,0
367,168,128,0,27,0,0,120,0,1,48,0
160,384,176,0,0,16777215,0,0,0,1,26,0
158,136,184,0,1,16777215,0,1,0,1,9,0
123,72,152,0,128,65280,0,0,0,0,36,0
321,136,120,0,0,0,0,120,0,1,42,0
123,224,120,0,128,16777215,0,0,0,1,16,0
197,80,184,0,2,36,0,0,0,1,25,0
197,320,184,0,2,21,0,0,0,1,20,0
174,344,184,0,1,16,28,0,0,0,27,1
181,224,112,0,0,128,273,0,0,1,5,0
216,64,224,0,-1,0,0,96,U0NIQUxURVIgRlJFSQ==,0,28,0
157,208,296,0,416,32,0,0,0,1,13,0
157,192,200,0,448,32,0,0,0,1,2,0
157,520,272,0,208,176,0,0,0,1,3,0
157,520,104,0,208,160,0,0,0,1,4,0
157,56,152,0,16,64,0,0,0,1,7,0
157,200,112,0,32,48,0,0,0,1,14,0
157,248,112,0,32,48,0,0,0,1,15,0
157,224,88,0,160,32,0,0,0,1,17,0
157,88,88,0,112,32,0,0,0,1,18,0
157,48,136,0,32,96,0,0,0,1,19,0
157,96,136,0,32,32,0,0,0,1,23,0
157,96,104,0,32,32,0,0,0,1,24,0
157,384,88,0,160,32,0,0,0,1,31,0
157,360,296,0,480,192,0,0,0,1,32,0
157,56,336,0,144,96,0,0,0,1,33,0
157,0,256,0,32,96,0,0,0,1,34,0
157,72,264,0,128,64,0,0,0,1,35,0
157,520,8,0,208,32,0,0,0,1,38,0
169,96,152,0,0,0,0,0,0,1,21,1
253,200,136,0,16777215,0,7,0,0,1,29,0
253,248,136,0,16777215,0,7,0,0,1,30,0
1234567890
37,32,160,16,16,112,96,9998,0,0,0,0
37,32,160,16,16,128,96,9998,0,0,0,0
37,32,160,16,16,144,96,9998,0,0,0,0
37,32,160,16,16,160,96,9998,0,0,0,0
37,32,160,16,16,176,96,9998,0,0,0,0
37,32,160,16,16,160,112,9998,0,0,0,0
37,32,160,16,16,144,112,9998,0,0,0,0
37,32,160,16,16,128,112,9998,0,0,0,0
37,32,160,16,16,208,112,9998,0,0,0,0
37,32,160,16,16,240,112,9998,0,0,0,0
37,32,160,16,16,224,112,9998,0,0,0,0
37,32,160,16,16,208,128,9998,0,0,0,0
37,32,160,16,16,192,128,9998,0,0,0,0
37,32,160,16,16,240,128,9998,0,0,0,0
37,32,160,16,16,224,128,9998,0,0,0,0
37,32,160,16,16,176,128,9998,0,0,0,0
37,32,160,16,16,96,128,9998,0,0,0,0
37,32,160,16,16,80,128,9998,0,0,0,0
37,32,160,16,16,112,128,9998,0,0,0,0
37,32,160,16,16,192,112,9998,0,0,0,0
37,32,160,16,16,176,112,9998,0,0,0,0
37,32,160,16,16,112,112,9998,0,0,0,0
37,32,160,16,16,48,128,9998,0,0,0,0
37,32,160,16,16,80,112,9998,0,0,0,0
37,32,160,16,16,80,96,9998,0,0,0,0
37,32,160,16,16,64,96,9998,0,0,0,0
37,32,160,16,16,64,112,9998,0,0,0,0
37,32,160,16,16,48,112,9998,0,0,0,0
37,32,160,16,16,64,128,9998,0,0,0,0
37,32,160,16,16,64,144,9998,0,0,0,0
37,32,160,16,16,48,176,9998,0,0,0,0
37,32,160,16,16,48,160,9998,0,0,0,0
37,32,160,16,16,64,176,9998,0,0,0,0
37,32,160,16,16,64,160,9998,0,0,0,0
37,32,160,16,16,80,144,9998,0,0,0,0
37,32,160,16,16,112,160,9998,0,0,0,0
37,32,160,16,16,80,160,9998,0,0,0,0
37,32,160,16,16,96,144,9998,0,0,0,0
37,32,160,16,16,128,144,9998,0,0,0,0
37,32,160,16,16,112,176,9998,0,0,0,0
37,32,160,16,16,96,176,9998,0,0,0,0
37,32,160,16,16,80,192,9998,0,0,0,0
37,32,160,16,16,80,176,9998,0,0,0,0
37,32,160,16,16,96,160,9998,0,0,0,0
37,32,160,16,16,112,144,9998,0,0,0,0
37,32,160,16,16,128,128,9998,0,0,0,0
37,32,160,16,16,144,128,9998,0,0,0,0
37,32,160,16,16,160,128,9998,0,0,0,0
37,32,160,16,16,160,160,9998,0,0,0,0
37,32,160,16,16,144,144,9998,0,0,0,0
37,32,160,16,16,160,144,9998,0,0,0,0
37,32,160,16,16,128,160,9998,0,0,0,0
37,32,160,16,16,144,160,9998,0,0,0,0
37,32,160,16,16,176,144,9998,0,0,0,0
37,32,160,16,16,144,176,9998,0,0,0,0
37,32,160,16,16,160,176,9998,0,0,0,0
37,32,160,16,16,176,160,9998,0,0,0,0
37,32,160,16,16,176,176,9998,0,0,0,0
37,32,160,16,16,208,176,9998,0,0,0,0
37,32,160,16,16,192,144,9998,0,0,0,0
37,32,160,16,16,208,144,9998,0,0,0,0
37,32,160,16,16,192,160,9998,0,0,0,0
37,32,160,16,16,240,144,9998,0,0,0,0
37,32,160,16,16,192,176,9998,0,0,0,0
37,32,160,16,16,208,160,9998,0,0,0,0
37,32,160,16,16,224,144,9998,0,0,0,0
37,32,160,16,16,224,160,9998,0,0,0,0
37,32,160,16,16,224,176,9998,0,0,0,0
37,32,160,16,16,240,176,9998,0,0,0,0
37,32,160,16,16,240,160,9998,0,0,0,0
37,32,160,16,16,256,112,9998,0,0,0,0
37,32,160,16,16,272,112,9998,0,0,0,0
37,32,160,16,16,256,144,9998,0,0,0,0
37,32,160,16,16,256,128,9998,0,0,0,0
37,32,160,16,16,272,128,9998,0,0,0,0
37,32,160,16,16,304,112,9998,0,0,0,0
37,32,160,16,16,256,176,9998,0,0,0,0
37,32,160,16,16,256,160,9998,0,0,0,0
37,32,160,16,16,272,144,9998,0,0,0,0
37,32,160,16,16,336,144,9998,0,0,0,0
37,32,160,16,16,304,128,9998,0,0,0,0
37,32,160,16,16,320,112,9998,0,0,0,0
37,32,160,16,16,304,144,9998,0,0,0,0
37,32,160,16,16,400,128,9998,0,0,0,0
37,32,160,16,16,400,96,9998,0,0,0,0
37,32,160,16,16,400,112,9998,0,0,0,0
37,32,160,16,16,384,176,9998,0,0,0,0
37,32,160,16,16,384,192,9998,0,0,0,0
37,32,160,16,16,400,192,9998,0,0,0,0
37,32,160,16,16,400,144,9998,0,0,0,0
37,32,160,16,16,400,176,9998,0,0,0,0
37,32,160,16,16,400,160,9998,0,0,0,0
37,32,160,16,16,384,160,9998,0,0,0,0
37,32,160,16,16,384,144,9998,0,0,0,0
37,32,160,16,16,384,128,9998,0,0,0,0
37,32,160,16,16,368,160,9998,0,0,0,0
37,32,160,16,16,352,192,9998,0,0,0,0
37,32,160,16,16,368,128,9998,0,0,0,0
37,32,160,16,16,368,144,9998,0,0,0,0
37,32,160,16,16,352,176,9998,0,0,0,0
37,32,160,16,16,352,160,9998,0,0,0,0
37,32,160,16,16,352,112,9998,0,0,0,0
37,32,160,16,16,352,144,9998,0,0,0,0
37,32,160,16,16,336,176,9998,0,0,0,0
37,32,160,16,16,304,208,9998,0,0,0,0
37,32,160,16,16,336,128,9998,0,0,0,0
37,32,160,16,16,288,208,9998,0,0,0,0
37,32,160,16,16,288,224,9998,0,0,0,0
37,32,160,16,16,352,80,9998,0,0,0,0
37,32,160,16,16,368,80,9998,0,0,0,0
37,32,160,16,16,352,128,9998,0,0,0,0
37,32,160,16,16,304,192,9998,0,0,0,0
37,32,160,16,16,288,192,9998,0,0,0,0
37,32,160,16,16,336,112,9998,0,0,0,0
37,32,160,16,16,352,96,9998,0,0,0,0
37,32,160,16,16,368,96,9998,0,0,0,0
37,32,160,16,16,384,96,9998,0,0,0,0
37,32,160,16,16,384,112,9998,0,0,0,0
37,32,160,16,16,368,112,9998,0,0,0,0
37,32,160,16,16,336,96,9998,0,0,0,0
37,32,160,16,16,320,96,9998,0,0,0,0
37,32,160,16,16,304,96,9998,0,0,0,0
37,32,160,16,16,288,96,9998,0,0,0,0
37,32,160,16,16,256,96,9998,0,0,0,0
37,32,160,16,16,272,96,9998,0,0,0,0
37,32,160,16,16,288,112,9998,0,0,0,0
37,32,160,16,16,288,128,9998,0,0,0,0
37,32,160,16,16,288,144,9998,0,0,0,0
37,32,160,16,16,272,160,9998,0,0,0,0
37,32,160,16,16,288,160,9998,0,0,0,0
37,32,160,16,16,272,176,9998,0,0,0,0
37,32,160,16,16,288,176,9998,0,0,0,0
37,32,160,16,16,304,176,9998,0,0,0,0
37,32,160,16,16,320,176,9998,0,0,0,0
37,32,160,16,16,320,160,9998,0,0,0,0
37,32,160,16,16,304,160,9998,0,0,0,0
37,32,160,16,16,320,144,9998,0,0,0,0
37,32,160,16,16,320,128,9998,0,0,0,0
37,288,304,16,16,416,64,9998,0,0,0,0
37,288,304,16,16,368,64,9998,0,0,0,0
37,288,304,16,16,400,64,9998,0,0,0,0
37,288,304,16,16,384,64,9998,0,0,0,0
37,288,304,16,16,352,64,9998,0,0,0,0
37,288,304,16,16,336,64,9998,0,0,0,0
37,288,304,16,16,320,64,9998,0,0,0,0
37,288,304,16,16,304,64,9998,0,0,0,0
37,288,304,16,16,288,64,9998,0,0,0,0
37,288,304,16,16,272,64,9998,0,0,0,0
37,288,304,16,16,112,64,9998,0,0,0,0
37,288,304,16,16,64,64,9998,0,0,0,0
37,288,304,16,16,48,64,9998,0,0,0,0
37,288,304,16,16,32,64,9998,0,0,0,0
37,288,304,16,16,448,16,9998,0,0,0,0
37,288,304,16,16,448,32,9998,0,0,0,0
37,288,304,16,16,432,32,9998,0,0,0,0
37,288,304,16,16,320,32,9998,0,0,0,0
37,288,304,16,16,336,32,9998,0,0,0,0
37,288,304,16,16,128,80,9998,0,0,0,0
37,288,304,16,16,80,80,9998,0,0,0,0
37,288,304,16,16,64,80,9998,0,0,0,0
37,288,304,16,16,80,64,9998,0,0,0,0
37,288,304,16,16,144,64,9998,0,0,0,0
37,288,304,16,16,176,48,9998,0,0,0,0
37,288,304,16,16,288,32,9998,0,0,0,0
37,288,304,16,16,272,32,9998,0,0,0,0
37,288,304,16,16,256,32,9998,0,0,0,0
37,288,304,16,16,240,48,9998,0,0,0,0
37,288,304,16,16,224,48,9998,0,0,0,0
37,288,304,16,16,208,48,9998,0,0,0,0
37,288,304,16,16,192,48,9998,0,0,0,0
37,288,304,16,16,128,64,9998,0,0,0,0
37,288,304,16,16,96,80,9998,0,0,0,0
37,288,304,16,16,96,64,9998,0,0,0,0
37,288,304,16,16,112,48,9998,0,0,0,0
37,288,304,16,16,96,48,9998,0,0,0,0
37,288,304,16,16,64,48,9998,0,0,0,0
37,288,304,16,16,112,32,9998,0,0,0,0
37,288,304,16,16,80,48,9998,0,0,0,0
37,288,304,16,16,48,48,9998,0,0,0,0
37,288,304,16,16,48,32,9998,0,0,0,0
37,288,304,16,16,96,32,9998,0,0,0,0
37,288,304,16,16,80,32,9998,0,0,0,0
37,288,304,16,16,32,48,9998,0,0,0,0
37,288,304,16,16,64,32,9998,0,0,0,0
37,288,304,16,16,32,32,9998,0,0,0,0
37,288,304,16,16,0,32,9998,0,0,0,0
37,288,304,16,16,16,32,9998,0,0,0,0
37,288,304,16,16,16,48,9998,0,0,0,0
37,288,304,16,16,16,64,9998,0,0,0,0
37,288,304,16,16,16,80,9998,0,0,0,0
37,288,304,16,16,16,96,9998,0,0,0,0
37,288,304,16,16,16,112,9998,0,0,0,0
37,288,304,16,16,16,128,9998,0,0,0,0
37,288,304,16,16,16,144,9998,0,0,0,0
37,288,304,16,16,16,160,9998,0,0,0,0
37,288,304,16,16,16,176,9998,0,0,0,0
37,288,304,16,16,0,176,9998,0,0,0,0
37,288,304,16,16,0,160,9998,0,0,0,0
37,288,304,16,16,0,144,9998,0,0,0,0
37,288,304,16,16,0,128,9998,0,0,0,0
37,288,304,16,16,0,112,9998,0,0,0,0
37,288,304,16,16,0,96,9998,0,0,0,0
37,288,304,16,16,0,80,9998,0,0,0,0
37,288,304,16,16,0,64,9998,0,0,0,0
37,288,304,16,16,0,48,9998,0,0,0,0
37,288,272,32,16,0,16,9998,0,0,0,0
37,288,272,32,16,32,16,9998,0,0,0,0
37,288,272,32,16,64,16,9998,0,0,0,0
37,176,256,16,16,80,0,9998,0,0,0,0
37,176,256,16,16,64,0,9998,0,0,0,0
37,176,256,16,16,48,0,9998,0,0,0,0
37,176,256,16,16,144,0,9998,0,0,0,0
37,176,256,16,16,160,0,9998,0,0,0,0
37,176,256,16,16,208,0,9998,0,0,0,0
37,176,256,16,16,224,0,9998,0,0,0,0
37,176,256,16,16,240,0,9998,0,0,0,0
37,176,256,16,16,256,0,9998,0,0,0,0
37,176,256,16,16,272,0,9998,0,0,0,0
37,176,256,16,16,288,0,9998,0,0,0,0
37,176,256,16,16,304,0,9998,0,0,0,0
37,176,256,16,16,320,0,9998,0,0,0,0
37,176,256,16,16,336,0,9998,0,0,0,0
37,176,256,16,16,352,0,9998,0,0,0,0
37,176,256,16,16,384,0,9998,0,0,0,0
37,304,272,16,16,96,16,9998,0,0,0,0
37,304,272,16,16,112,16,9998,0,0,0,0
37,304,272,16,16,160,16,9998,0,0,0,0
37,304,272,16,16,144,16,9998,0,0,0,0
37,304,272,16,16,128,16,9998,0,0,0,0
37,304,272,16,16,176,16,9998,0,0,0,0
37,304,272,16,16,192,16,9998,0,0,0,0
37,304,272,16,16,208,16,9998,0,0,0,0
37,304,272,16,16,224,16,9998,0,0,0,0
37,304,272,16,16,240,16,9998,0,0,0,0
37,304,272,16,16,256,16,9998,0,0,0,0
37,304,272,16,16,272,16,9998,0,0,0,0
37,304,272,16,16,288,16,9998,0,0,0,0
37,304,272,16,16,304,16,9998,0,0,0,0
37,304,272,16,16,320,16,9998,0,0,0,0
37,304,272,16,16,336,16,9998,0,0,0,0
37,304,272,16,16,352,16,9998,0,0,0,0
37,304,272,16,16,368,16,9998,0,0,0,0
37,304,272,16,16,384,16,9998,0,0,0,0
37,304,272,16,16,400,16,9998,0,0,0,0
37,304,272,16,16,432,16,9998,0,0,0,0
37,304,304,16,16,240,32,9998,0,0,0,0
37,304,304,16,16,224,32,9998,0,0,0,0
37,304,304,16,16,208,32,9998,0,0,0,0
37,304,304,16,16,192,32,9998,0,0,0,0
37,304,304,16,16,176,32,9998,0,0,0,0
37,304,304,16,16,160,32,9998,0,0,0,0
37,304,304,16,16,144,32,9998,0,0,0,0
37,304,304,16,16,128,32,9998,0,0,0,0
37,304,304,16,16,128,48,9998,0,0,0,0
37,304,304,16,16,144,48,9998,0,0,0,0
37,304,304,16,16,160,48,9998,0,0,0,0
37,304,304,16,16,160,64,9998,0,0,0,0
37,304,304,16,16,176,64,9998,0,0,0,0
37,304,304,16,16,192,64,9998,0,0,0,0
37,304,304,16,16,208,64,9998,0,0,0,0
37,304,304,16,16,224,64,9998,0,0,0,0
37,304,304,16,16,240,64,9998,0,0,0,0
37,304,304,16,16,256,64,9998,0,0,0,0
37,304,304,16,16,256,48,9998,0,0,0,0
37,304,304,16,16,272,48,9998,0,0,0,0
37,304,304,16,16,288,48,9998,0,0,0,0
37,304,304,16,16,304,32,9998,0,0,0,0
37,304,304,16,16,304,48,9998,0,0,0,0
37,304,304,16,16,320,48,9998,0,0,0,0
37,304,304,16,16,336,48,9998,0,0,0,0
37,304,304,16,16,368,48,9998,0,0,0,0
37,304,304,16,16,384,48,9998,0,0,0,0
37,304,304,16,16,400,48,9998,0,0,0,0
37,304,304,16,16,400,32,9998,0,0,0,0
37,304,304,16,16,384,32,9998,0,0,0,0
37,304,304,16,16,368,32,9998,0,0,0,0
37,304,304,16,16,352,32,9998,0,0,0,0
37,304,304,16,16,352,48,9998,0,0,0,0
37,192,256,16,16,128,0,9998,0,0,0,0
37,192,256,16,16,112,0,9998,0,0,0,0
37,160,256,16,16,96,0,9998,0,0,0,0
37,160,256,16,16,192,0,9998,0,0,0,0
37,160,256,16,16,368,0,9998,0,0,0,0
37,160,256,16,16,400,0,9998,0,0,0,0
37,160,256,16,16,176,0,9998,0,0,0,0
37,160,256,16,16,32,0,9998,0,0,0,0
37,0,112,32,16,0,0,9998,0,0,0,0
37,288,192,16,64,416,0,9998,0,0,0,0
24,416,160,16,16,192,144,10000,0,0,0,0
24,416,160,16,16,240,144,10000,0,0,0,0
24,416,160,16,16,256,144,10000,0,0,0,0
24,416,160,16,16,208,144,10000,0,0,0,0
987654321
NAsiAwYkVSclOGRLc2dILFEgOwkOQXBHCiVgEUwlLA==
LAYrEhBiHmcrazIOGEVMKkRzOw==
IA0oB0AmVSBra09LIF9IKRo=

