UVx6TlN0AGU9Z24cP150CwlxN3BBDCJNC0J2FVt9PFliZml8NTghenh/cQ==
259,504,248,0,272,112,0,0,0,1,5,0
259,424,256,0,48,64,0,0,0,1,66,0
259,616,256,0,48,64,0,0,0,1,67,0
259,216,208,0,32,32,0,0,0,1,87,0
332,512,232,0,12,0,0,120,0,1,47,0
337,328,280,0,16,0,0,120,0,1,30,0
337,200,248,0,16,0,0,120,0,1,82,0
337,224,248,0,16,0,0,120,0,1,83,0
367,296,240,0,27,0,0,120,0,1,32,0
367,48,240,0,27,0,0,120,0,1,34,0
367,128,240,0,27,0,0,120,0,1,35,0
367,200,240,0,27,0,0,120,0,1,36,0
367,232,240,0,27,0,0,120,0,1,31,0
367,192,232,0,27,0,0,120,0,1,37,0
367,504,232,0,27,0,0,120,0,1,38,0
367,592,232,0,27,0,0,120,0,1,39,0
367,344,216,0,27,0,0,120,0,1,40,0
369,216,240,0,29,0,0,120,0,1,44,0
370,520,304,0,30,0,0,120,0,1,43,0
370,296,304,0,30,0,0,120,0,1,41,0
370,192,240,0,30,203,0,120,1,1,60,0
370,120,240,0,30,203,0,120,1,1,59,0
370,312,240,0,30,203,0,120,1,1,62,0
370,592,240,0,30,203,0,120,1,1,63,0
370,264,232,0,30,203,0,120,1,1,61,0
370,496,232,0,30,203,0,120,1,1,68,0
370,520,232,0,30,203,0,120,1,1,74,0
370,352,256,0,30,0,0,120,0,1,42,0
370,560,232,0,30,203,0,120,1,1,73,0
370,608,320,0,30,203,0,120,1,1,92,0
367,152,256,0,27,0,0,120,0,1,102,0
367,280,256,0,27,0,0,120,0,1,103,0
367,536,240,0,27,0,0,120,0,1,104,0
367,584,248,0,27,0,0,120,0,1,105,0
367,240,248,0,27,0,0,120,0,1,106,0
367,145,240,0,27,0,0,120,0,1,33,0
367,8,256,0,27,0,0,120,0,1,107,0
160,624,288,0,0,16777215,0,0,0,1,65,0
158,24,288,0,1,16777215,0,1,0,1,6,0
100,600,224,0,256,16512,0,271,0,1,52,0
100,208,224,0,111,4194304,0,271,0,1,8,0
321,352,232,0,0,203,0,120,1,1,46,0
321,72,304,0,0,203,0,120,1,1,57,0
321,216,249,0,0,203,0,120,1,1,45,0
328,352,272,0,7,0,0,120,0,1,29,0
321,136,296,0,0,203,0,120,1,1,58,0
321,112,296,0,0,203,0,120,1,1,96,0
321,248,296,0,0,203,0,120,1,1,97,0
321,272,296,0,0,203,0,120,1,1,98,0
322,456,296,0,1,203,0,120,1,1,99,0
321,480,296,0,0,203,0,120,1,1,91,0
321,608,256,0,0,203,0,120,1,1,100,0
321,624,256,0,0,203,0,120,1,1,101,0
197,424,288,0,2,0,0,0,0,1,64,0
174,624,360,0,1,50,0,52,0,0,49,1
174,352,288,0,1,22,24,26,0,0,28,1
175,629,315,0,49,20,0,0,0,1,50,0
216,544,248,0,-1,1,0,96,RXhpdA==,1,72,0
157,280,296,0,864,16,0,0,0,1,18,0
157,272,216,0,96,16,0,0,0,1,7,0
157,96,216,0,208,16,0,0,0,1,11,0
157,168,64,0,432,288,0,0,0,1,19,0
157,512,88,0,400,208,0,0,0,1,20,0
157,600,208,0,240,32,0,0,0,1,21,0
157,280,336,0,640,64,0,0,0,1,48,0
169,400,256,0,0,0,0,0,0,1,22,1
169,416,256,0,0,0,0,0,0,1,24,1
169,432,256,0,0,0,0,0,0,1,26,1
253,216,224,0,16711680,0,0,0,0,1,9,0
253,352,280,0,16512,0,0,0,0,1,78,0
1234567890
24,320,256,32,32,112,224,10000,0,0,0,0
24,304,320,64,32,144,208,10000,0,0,0,0
24,304,320,64,32,192,272,10000,0,0,0,0
24,304,320,64,32,64,272,10000,0,0,0,0
24,208,256,32,32,64,240,10000,0,0,0,0
24,208,336,32,16,80,224,10000,0,0,0,0
24,208,336,32,16,224,224,10000,0,0,0,0
24,304,336,64,16,256,224,10000,0,0,0,0
24,368,320,32,32,176,240,10000,0,0,0,0
24,240,256,16,16,144,256,10000,0,0,0,0
24,240,256,16,16,256,240,10000,0,0,0,0
24,240,256,16,16,160,240,10000,0,0,0,0
24,288,256,16,32,48,224,10000,0,0,0,0
24,288,256,16,32,320,224,10000,0,0,0,0
24,320,240,48,16,336,224,10000,0,0,0,0
24,128,48,16,16,208,144,9998,0,0,0,0
24,128,64,16,16,208,160,9998,0,0,0,0
24,128,64,16,16,208,176,9998,0,0,0,0
24,128,64,16,16,208,192,9998,0,0,0,0
24,16,0,16,16,16,176,9998,0,0,0,0
24,16,0,16,16,16,192,9998,0,0,0,0
24,16,0,16,16,0,240,9998,0,0,0,0
24,16,0,16,16,0,256,9998,0,0,0,0
24,16,0,16,16,0,272,9998,0,0,0,0
24,16,0,16,16,16,272,9998,0,0,0,0
24,16,0,16,16,16,256,9998,0,0,0,0
24,16,0,16,16,16,240,9998,0,0,0,0
24,16,0,16,16,0,176,9998,0,0,0,0
24,16,0,16,16,0,192,9998,0,0,0,0
24,16,0,16,16,0,208,9998,0,0,0,0
24,16,0,16,16,16,208,9998,0,0,0,0
24,16,0,16,16,48,208,9998,0,0,0,0
24,16,0,16,16,48,192,9998,0,0,0,0
24,16,0,16,16,48,176,9998,0,0,0,0
24,16,0,16,16,32,176,9998,0,0,0,0
24,16,0,16,16,32,192,9998,0,0,0,0
24,16,0,16,16,32,208,9998,0,0,0,0
24,16,0,16,16,32,240,9998,0,0,0,0
24,16,0,16,16,32,256,9998,0,0,0,0
24,16,0,16,16,32,272,9998,0,0,0,0
24,16,0,16,16,48,272,9998,0,0,0,0
24,16,0,16,16,48,256,9998,0,0,0,0
24,16,0,16,16,48,240,9998,0,0,0,0
24,16,0,16,16,384,272,9998,0,0,0,0
24,16,0,16,16,384,256,9998,0,0,0,0
24,16,0,16,16,384,240,9998,0,0,0,0
24,16,0,16,16,384,224,9998,0,0,0,0
24,16,0,16,16,384,208,9998,0,0,0,0
24,16,0,16,16,400,208,9998,0,0,0,0
24,16,0,16,16,416,208,9998,0,0,0,0
24,16,0,16,16,432,208,9998,0,0,0,0
24,16,0,16,16,448,208,9998,0,0,0,0
24,16,0,16,16,448,224,9998,0,0,0,0
24,16,0,16,16,448,240,9998,0,0,0,0
24,16,0,16,16,448,256,9998,0,0,0,0
24,16,0,16,16,448,272,9998,0,0,0,0
24,16,0,16,16,464,272,9998,0,0,0,0
24,16,0,16,16,464,256,9998,0,0,0,0
24,16,0,16,16,464,240,9998,0,0,0,0
24,16,0,16,16,464,224,9998,0,0,0,0
24,16,0,16,16,464,208,9998,0,0,0,0
24,16,0,16,16,368,208,9998,0,0,0,0
24,16,0,16,16,368,224,9998,0,0,0,0
24,16,0,16,16,368,256,9998,0,0,0,0
24,16,0,16,16,368,272,9998,0,0,0,0
24,16,0,16,16,352,208,9998,0,0,0,0
24,16,0,16,16,336,208,9998,0,0,0,0
24,16,0,16,16,320,208,9998,0,0,0,0
24,16,0,16,16,320,224,9998,0,0,0,0
24,16,0,16,16,368,240,9998,0,0,0,0
24,464,288,32,32,336,224,9998,0,0,0,0
24,464,160,32,16,288,272,9998,0,0,0,0
24,304,256,16,32,352,256,9998,0,0,0,0
24,336,48,32,16,480,224,9998,0,0,0,0
24,32,160,16,16,320,272,9998,0,0,0,0
24,240,320,48,16,144,272,9998,0,0,0,0
24,256,320,16,16,192,272,9998,0,0,0,0
24,256,320,16,16,256,272,9998,0,0,0,0
24,368,256,32,32,400,224,9998,0,0,0,0
24,448,256,16,16,432,224,9998,0,0,0,0
24,336,144,48,16,480,208,9998,0,0,0,0
24,160,256,32,16,512,224,9998,0,0,0,0
24,288,272,16,16,64,224,9998,0,0,0,0
24,288,272,16,16,128,272,9998,0,0,0,0
24,224,256,16,16,272,272,9998,0,0,0,0
24,208,336,32,16,544,224,9998,0,0,0,0
24,240,320,32,16,416,272,9998,0,0,0,0
24,240,320,32,16,480,272,9998,0,0,0,0
24,128,64,16,16,208,208,9998,0,0,0,0
24,544,336,16,16,336,272,9998,0,0,0,0
24,144,240,16,16,336,256,9998,0,0,0,0
24,0,256,64,32,272,240,9998,0,0,0,0
24,496,320,64,16,0,224,9998,0,0,0,0
24,32,176,16,16,512,272,9998,0,0,0,0
24,240,320,64,16,528,272,9998,0,0,0,0
24,304,320,48,16,592,272,9998,0,0,0,0
24,240,320,64,32,480,240,9998,0,0,0,0
24,240,320,32,32,608,224,9998,0,0,0,0
24,400,336,32,16,576,224,9998,0,0,0,0
24,400,336,32,16,224,256,9998,0,0,0,0
24,400,320,32,16,224,240,9998,0,0,0,0
24,304,240,16,16,208,240,9998,0,0,0,0
24,288,272,16,16,208,256,9998,0,0,0,0
24,592,96,16,16,608,304,9998,0,0,0,0
24,592,96,16,16,592,304,9998,0,0,0,0
24,592,96,16,16,608,336,9998,0,0,0,0
24,592,96,16,16,608,352,9998,0,0,0,0
24,592,96,16,16,592,352,9998,0,0,0,0
24,592,96,16,16,592,336,9998,0,0,0,0
24,592,96,16,16,592,320,9998,0,0,0,0
24,592,96,16,16,608,320,9998,0,0,0,0
24,592,96,16,16,624,304,9998,0,0,0,0
24,592,96,16,16,624,320,9998,0,0,0,0
24,592,96,16,16,624,336,9998,0,0,0,0
24,592,96,16,16,624,352,9998,0,0,0,0
24,592,256,16,16,416,192,9998,0,0,0,0
24,592,256,16,16,400,192,9998,0,0,0,0
24,592,256,16,16,432,192,9998,0,0,0,0
24,592,256,16,16,448,192,9998,0,0,0,0
24,560,256,16,16,368,192,9998,0,0,0,0
24,560,256,16,16,384,192,9998,0,0,0,0
24,624,256,16,16,464,192,9998,0,0,0,0
987654321
NAsiAwYkVSclOGRLc2dILFEgOwkOQXBHCiVgEUwlLA==
LAYrEhBiHmcrazIOGEVMKkRzOw==
IA0oB0AmVSBra09LIF9IKRo=

