X1t4TlV0AGU9Z1pDBV5MAmYjSU8TQ3xxDmxjG1YFZRg3Zml8NTghenh/cUNiVSc=
259,200,160,0,16,16,0,0,0,1,113,0
259,304,128,0,64,48,0,0,0,1,152,0
259,304,64,0,64,48,0,0,0,1,153,0
259,144,136,0,96,192,0,0,0,0,219,0
259,224,136,0,64,192,0,0,0,0,220,0
259,48,144,0,96,304,0,0,0,1,226,0
259,224,16,0,256,32,0,0,0,1,227,0
259,144,200,0,64,64,0,0,0,1,231,0
259,232,256,0,240,48,0,0,0,1,235,0
259,176,328,0,352,64,0,0,0,1,248,0
259,424,328,0,160,64,0,0,0,1,395,0
259,552,120,0,64,16,0,0,0,1,406,0
259,480,312,0,64,64,0,0,0,1,409,0
259,544,232,0,80,272,0,0,0,1,410,0
259,400,160,0,96,304,0,0,0,1,461,0
259,480,216,0,48,304,0,0,0,1,463,0
259,584,32,0,288,32,0,0,0,1,465,0
259,568,80,0,128,32,0,0,0,1,468,0
259,688,272,0,80,448,0,0,0,1,470,0
259,608,224,0,64,256,0,0,0,1,471,0
259,208,152,0,288,288,0,0,0,0,482,0
259,376,176,0,720,384,0,0,0,0,490,0
259,208,128,0,304,256,0,0,0,0,505,0
259,352,256,0,32,48,0,0,0,0,513,0
259,688,400,0,96,160,0,0,0,0,536,0
259,800,288,0,112,544,0,0,0,1,544,0
259,536,208,0,208,304,0,0,0,0,1033,0
160,48,544,0,0,16777215,0,0,0,1,10,0
158,144,152,0,1,16777215,0,1,0,1,8,0
178,688,480,0,80,32,0,0,0,0,474,0
100,208,104,0,112,255,0,270,0,0,102,0
100,240,104,0,112,255,0,270,0,0,103,0
218,144,104,0,128,16777215,0,270,0,1,1047,0
123,472,408,0,56,255,0,0,0,1,680,0
123,344,408,0,56,255,0,0,0,1,660,0
100,160,40,0,112,255,0,270,0,0,105,0
100,128,40,0,112,255,0,270,0,0,104,0
123,472,32,0,44,255,0,0,0,0,427,0
224,304,128,0,40,65280,0,0,0,0,185,0
218,224,40,0,128,16777215,0,270,0,1,1048,0
224,304,64,0,40,65280,0,0,0,0,186,0
197,184,544,0,2,710,0,0,0,1,621,0
193,64,88,0,0,89,85,86,0,1,90,0
174,208,152,1,1,49,79,80,190,0,50,0
174,160,88,1,1,20,0,0,0,0,22,0
174,240,152,1,1,49,57,160,190,0,51,0
174,568,544,0,1,693,0,0,0,0,691,0
174,120,544,0,1,706,0,0,0,0,810,0
174,120,464,0,1,647,711,837,0,0,710,0
174,304,88,0,1,131,153,186,0,0,128,0
174,304,152,0,1,131,152,185,0,0,124,0
193,544,104,0,1,427,0,0,0,1,411,0
174,128,88,1,1,20,0,0,0,0,21,0
316,208,88,0,0,1,0,0,0,1,41,0
316,480,280,0,0,1,0,0,0,1,462,0
316,592,464,0,0,-1,0,0,0,1,527,0
316,184,464,0,0,-1,0,0,0,1,707,0
219,696,200,0,64,16,0,0,0,1,871,1
219,696,104,0,64,16,0,0,0,1,912,1
219,680,152,0,64,16,0,0,0,1,913,1
219,680,56,0,64,16,0,0,0,1,915,1
219,344,512,0,224,64,0,0,0,1,553,0
188,256,72,0,90,52,103,0,0,1,48,0
188,191,110,0,270,109,0,0,0,1,108,0
188,383,136,0,270,327,0,0,0,1,389,0
188,383,72,0,270,0,0,0,0,1,394,0
188,191,72,0,270,53,102,0,0,1,47,0
188,383,200,0,270,318,0,0,0,1,393,0
188,256,136,0,90,90,0,0,0,1,83,0
188,424,104,0,90,328,0,0,0,1,391,0
188,488,544,0,0,634,0,0,0,1,569,0
188,24,464,0,0,523,0,0,0,1,545,0
188,248,464,0,0,553,733,781,0,1,649,0
188,656,0,0,180,907,0,0,0,1,910,0
188,720,0,0,180,907,0,0,0,1,911,0
188,424,232,0,90,317,747,0,0,1,288,0
188,424,56,0,90,411,329,0,0,1,392,0
188,111,136,0,270,19,105,0,0,1,7,0
188,191,160,0,270,112,0,0,0,1,114,0
188,424,168,0,90,326,0,0,0,1,390,0
188,176,136,0,90,18,104,0,0,1,17,0
185,404,324,0,749,16,-1,0,0,1,765,0
185,407.50,400,0,654,16,1,0,0,1,681,0
242,600,512,0,16,64,0,0,0,1,670,0
242,144,184,0,64,32,0,0,0,1,823,0
176,144,168,0,85,64,16,0,0,1,177,0
176,160,272,0,167,96,16,0,0,1,173,0
176,160,272,0,220,96,16,0,0,1,222,0
176,160,272,0,219,96,16,0,0,1,221,0
176,680,528,0,474,80,32,0,0,1,473,0
176,680,528,0,490,80,32,0,0,1,489,0
176,512,32,0,429,32,32,0,0,1,436,0
176,560,32,0,388,32,32,0,0,1,497,0
176,576,32,0,428,32,32,0,0,1,437,0
176,408,56,0,465,64,32,0,0,1,464,0
176,408,56,0,468,64,32,0,0,1,467,0
176,192,256,0,782,32,48,0,0,1,783,0
176,224,256,0,463,32,48,0,0,1,466,0
176,224,256,0,461,32,48,0,0,1,460,0
176,408,248,0,513,32,32,0,0,1,512,0
176,608,32,0,418,32,32,0,0,1,1018,0
176,656,32,0,470,80,32,0,0,1,469,0
176,656,32,0,471,80,32,0,0,1,472,0
176,632,32,0,1033,32,32,0,0,1,1032,0
176,680,512,0,536,80,32,0,0,1,535,0
176,680,520,0,556,80,48,0,0,1,554,0
176,400,256,0,505,64,48,0,0,1,504,0
176,400,256,0,482,64,48,0,0,1,481,0
176,304,256,0,796,32,48,0,0,1,797,0
176,144,128,0,40,64,48,0,0,0,99,0
175,24,104,0,21,60,0,0,0,0,18,0
175,64,104,0,22,120,0,0,0,0,19,0
273,120,16,0,125,2,0,0,0,1,20,0
317,176,24,0,41,1,1,0,0,1,40,0
273,152,16,0,60,2,0,0,0,1,49,0
175,64,192,0,51,120,0,0,0,0,52,0
175,24,192,0,50,60,0,0,0,0,53,0
317,200,24,0,41,1,-1,0,0,1,57,0
317,224,24,0,41,1,1,0,0,1,79,0
289,40,48,0,81,0,0,0,0,1,80,0
175,40,80,0,82,120,0,0,0,0,81,0
317,248,24,0,41,1,1,0,0,1,82,0
317,272,24,0,41,0,1,0,0,1,109,0
317,296,24,0,41,1,1,0,0,1,112,0
289,56,16,0,124,0,0,0,0,1,125,0
273,16,48,0,163,2,0,0,0,1,131,0
175,16,16,0,99,210,0,0,0,1,148,0
289,328,8,0,0,0,0,0,0,1,160,0
175,16,80,0,24,120,0,0,0,0,163,0
273,88,16,0,194,2,0,0,0,1,190,0
289,72,48,0,128,0,0,0,0,1,194,0
289,24,128,0,21,0,0,0,0,1,212,0
289,64,128,0,22,0,0,0,0,1,213,0
289,64,160,0,51,0,0,0,0,1,214,0
289,24,160,0,50,0,0,0,0,1,215,0
317,528,424,0,527,1,-1,1,0,1,634,0
317,184,416,0,707,1,-1,0,0,1,706,0
175,256,416,0,729,20,0,0,0,0,733,0
154,144,160,0,2,3,64,16,1,1,26,1
154,216,96,0,1,0.50,64,16,1,1,62,1
154,112,96,0,3,0.50,16,16,-1,1,87,0
154,64,256,0,4,2,96,48,1,1,169,0
154,288,312,0,5,0.13,160,64,1,1,243,1
154,288,200,0,6,0.13,160,64,1,1,256,1
154,480,288,0,7,4,48,16,1,1,319,1
154,784,520,0,8,2,112,48,1,1,558,1
154,407.50,400,0,9,0.50,16,16,-1,1,654,1
154,544,472,0,10,5,176,16,1,1,695,1
154,248,376,0,11,0.50,32,16,1,1,731,1
154,404,324,0,12,1,32,32,-1,1,749,1
154,717,16,0,13,0.50,16,16,-1,1,905,1
216,248,256,0,-1,1,0,96,cnVuLT4=,0,782,0
216,360,256,0,-1,0,0,132,a2VlcCBnb2luZyEh,0,796,0
216,576,488,0,-1,0,0,100,VW5sZXNzIHlvdQ==,1,779,0
216,384,512,0,-1,0,0,136,PC1SVU4=,0,781,0
216,581,504,0,-1,0,0,108,a2lsbGVkIHRoZSBjbG9uZQ==,1,780,0
216,576,528,0,-1,0,0,100,RE9OVA==,1,778,0
157,272,200,0,160,64,0,0,1,1,29,0
157,360,104,0,16,176,0,0,1,1,269,0
157,184,136,0,16,192,0,0,1,1,32,0
157,448,176,0,16,256,0,0,1,1,277,0
157,432,272,0,16,96,0,0,1,1,268,0
157,376,208,0,16,32,0,0,1,1,336,0
157,432,176,0,16,32,0,0,1,1,337,0
157,376,224,0,16,16,0,0,1,1,345,0
157,432,200,0,16,16,0,0,1,1,360,0
157,224,288,0,256,16,0,0,1,1,9,0
157,400,288,0,64,16,0,0,1,1,37,0
157,320,368,0,640,32,0,0,1,1,453,0
157,640,216,0,16,336,0,0,1,1,399,0
157,512,232,0,16,240,0,0,1,1,396,0
157,576,248,0,16,240,0,0,1,1,407,0
157,512,352,0,16,16,0,0,0,1,397,0
157,608,368,0,48,16,0,0,1,1,408,0
157,216,424,0,32,80,0,0,0,1,645,0
157,640,440,0,16,112,0,0,1,1,522,0
157,344,448,0,32,32,0,0,0,1,623,0
157,280,448,0,32,32,0,0,0,1,624,0
157,472,448,0,32,32,0,0,0,1,650,0
157,536,448,0,32,32,0,0,0,1,573,0
157,408,448,0,32,32,0,0,0,1,622,0
157,320,472,0,640,16,0,0,1,1,521,0
157,368,552,0,736,16,0,0,1,1,452,0
157,144,408,0,16,48,0,0,0,1,646,0
157,144,496,0,16,32,0,0,0,1,709,0
157,104,192,0,16,176,0,0,1,1,33,0
157,96,408,0,16,48,0,0,0,1,836,0
157,96,496,0,16,32,0,0,0,1,525,0
157,8,464,0,16,160,0,0,1,1,520,0
157,736,280,0,16,528,0,0,1,1,420,0
157,344,136,0,16,64,0,0,0,1,145,0
157,264,136,0,16,64,0,0,0,1,65,0
157,376,144,0,16,32,0,0,1,1,344,0
157,376,160,0,16,32,0,0,1,1,361,0
157,232,160,0,48,16,0,0,1,1,64,0
157,304,160,0,96,16,0,0,0,1,141,0
157,376,96,0,16,32,0,0,1,1,371,0
157,144,96,0,96,16,0,0,1,1,59,0
157,312,96,0,80,16,0,0,1,1,56,0
157,264,72,0,16,64,0,0,0,1,44,0
157,248,96,0,16,16,0,0,1,1,93,0
157,376,80,0,16,32,0,0,1,1,347,0
157,344,56,0,16,64,0,0,0,1,138,0
155,144,160,0,1,2,0,0,0,0,24,0
155,144,224,0,2,2,0,0,0,1,25,0
155,216,96,0,1,1,0,0,0,0,60,0
155,216,160,0,2,1,0,0,0,0,61,0
155,112,96,0,1,3,0,0,0,0,85,0
155,112,160,0,2,3,0,0,0,0,86,0
155,64,256,0,1,4,0,0,0,0,167,0
155,160,256,0,2,4,0,0,0,0,168,0
155,80,224,0,3,2,0,0,0,0,208,0
155,288,312,0,1,5,0,0,0,0,241,0
155,288,288,0,2,5,0,0,0,0,242,0
155,288,200,0,1,6,0,0,0,0,254,0
155,288,224,0,2,6,0,0,0,0,255,0
155,480,288,0,1,7,0,0,0,0,317,0
155,480,232,0,2,7,0,0,0,0,318,0
155,480,200,0,3,7,0,0,0,0,326,0
155,480,168,0,4,7,0,0,0,0,327,0
155,480,136,0,5,7,0,0,0,0,328,0
155,480,104,0,6,7,0,0,0,0,329,0
155,544,104,0,7,7,0,0,0,0,388,0
155,608,104,0,8,7,0,0,0,0,418,0
155,608,368,0,9,7,0,0,0,0,444,0
169,88,512,0,0,0,0,0,0,1,523,0
155,784,520,0,1,8,0,0,0,0,556,0
155,688,520,0,2,8,0,0,0,0,557,0
169,136,432,0,0,0,0,0,0,1,647,0
155,280,400,0,1,9,0,0,0,1,652,0
155,536,400,0,2,9,0,0,0,1,653,0
155,544,472,0,1,10,0,0,0,0,693,0
155,544,552,0,2,10,0,0,0,0,694,0
169,136,512,0,0,0,0,0,0,1,711,0
155,248,376,0,1,11,0,0,0,0,729,0
155,248,448,0,2,11,0,0,0,0,730,0
155,404,324,0,1,12,0,0,0,0,747,0
155,404,32,0,2,12,0,0,0,1,748,0
169,88,432,0,0,0,0,0,0,1,837,0
155,632,32,0,3,12,0,0,0,1,851,0
155,656,16,0,1,13,60,0,0,1,903,0
155,720,16,0,2,13,60,0,0,1,904,0
301,216,232,0,0,0,270,241,0,1,239,0
301,216,280,0,0,0,90,254,0,1,262,1
301,16,528,0,0,0,0,714,0,1,713,0
301,659,16,0,0,0,270,907,0,1,972,1
301,717,16,0,0,0,270,907,0,1,973,1
253,432,224,0,16777215,0,0,0,0,1,278,0
253,376,192,0,16777215,0,0,0,0,1,353,0
253,376,128,0,16777215,0,0,0,0,1,351,0
253,376,64,0,16777215,0,0,0,0,1,350,0
166,112,96,0,87,0,0,0,0,0,89,0
166,16,536,0,0,0,0,0,0,0,714,0
166,717.50,16,0,905,0,270,0,0,1,907,0
157,432,136,0,16,16,0,0,1,1,362,0
157,432,112,0,16,32,0,0,1,1,346,0
157,432,64,0,16,32,0,0,1,1,379,0
157,536,56,0,192,16,0,0,1,1,275,0
157,432,56,0,16,16,0,0,1,1,372,0
157,376,32,0,16,32,0,0,1,1,380,0
157,224,32,0,96,16,0,0,0,1,43,0
157,144,32,0,96,16,0,0,0,1,134,0
157,304,32,0,96,16,0,0,0,1,140,0
157,504,0,0,304,32,0,0,1,1,276,0
157,744,0,0,176,32,0,0,1,1,419,0
157,104,64,0,16,48,0,0,0,1,135,0
242,512,32,0,32,32,0,0,0,1,1004,0
253,432,160,0,16777215,0,0,0,0,1,352,0
253,432,96,0,16777215,0,0,0,0,1,370,0
253,432,48,0,16777215,0,0,0,0,1,381,0
123,536,32,0,44,255,0,0,0,0,429,0
123,600,32,0,44,255,0,0,0,0,428,0
1234567890
36,496,0,48,48,96,96,10002,0,0,0,0
36,496,0,48,48,144,96,10002,0,0,0,0
36,496,0,48,48,96,144,10002,0,0,0,0
36,496,0,48,48,144,144,10002,0,0,0,0
36,496,0,48,48,144,48,10002,0,0,0,0
36,496,0,48,48,96,48,10002,0,0,0,0
36,496,0,48,48,96,0,10002,0,0,0,0
36,496,0,48,48,144,0,10002,0,0,0,0
36,496,0,48,48,192,0,10002,0,0,0,0
36,496,0,48,48,240,0,10002,0,0,0,0
36,496,0,48,48,288,0,10002,0,0,0,0
36,496,0,48,48,288,48,10002,0,0,0,0
36,496,0,48,48,240,48,10002,0,0,0,0
36,496,0,48,48,192,48,10002,0,0,0,0
36,496,0,48,48,192,96,10002,0,0,0,0
36,496,0,48,48,240,96,10002,0,0,0,0
36,496,0,48,48,288,96,10002,0,0,0,0
36,496,0,48,48,288,144,10002,0,0,0,0
36,496,0,48,48,240,144,10002,0,0,0,0
36,496,0,48,48,192,144,10002,0,0,0,0
36,496,0,48,48,96,192,10002,0,0,0,0
36,496,0,48,48,96,240,10002,0,0,0,0
36,496,0,48,48,144,192,10002,0,0,0,0
36,496,0,48,48,144,240,10002,0,0,0,0
35,288,144,48,48,192,240,10002,0,0,0,0
35,288,144,48,48,192,192,10002,0,0,0,0
35,288,144,48,48,240,240,10002,0,0,0,0
35,288,144,48,48,240,192,10002,0,0,0,0
35,288,144,48,48,288,240,10002,0,0,0,0
35,288,144,48,48,288,192,10002,0,0,0,0
35,288,144,48,48,336,192,10002,0,0,0,0
35,288,144,48,48,336,240,10002,0,0,0,0
35,288,192,48,48,384,240,10002,0,0,0,0
35,288,192,48,48,384,192,10002,0,0,0,0
35,288,192,48,48,336,144,10002,0,0,0,0
35,288,192,48,48,384,144,10002,0,0,0,0
35,288,192,48,48,384,96,10002,0,0,0,0
35,288,192,48,48,384,48,10002,0,0,0,0
35,288,192,48,48,384,0,10002,0,0,0,0
35,288,192,48,48,336,0,10002,0,0,0,0
35,288,192,48,48,336,48,10002,0,0,0,0
35,288,192,48,48,336,96,10002,0,0,0,0
35,288,192,48,48,432,240,10002,0,0,0,0
35,288,192,48,48,432,192,10002,0,0,0,0
35,288,192,48,48,432,144,10002,0,0,0,0
35,288,192,48,48,432,96,10002,0,0,0,0
35,288,192,48,48,432,48,10002,0,0,0,0
35,288,192,48,48,480,240,10002,0,0,0,0
35,288,192,48,48,480,192,10002,0,0,0,0
35,288,192,48,48,480,144,10002,0,0,0,0
35,288,192,48,48,480,96,10002,0,0,0,0
35,288,192,48,48,480,48,10002,0,0,0,0
35,336,192,32,48,608,64,10002,0,0,0,0
35,336,192,32,48,608,112,10002,0,0,0,0
35,336,192,32,48,608,160,10002,0,0,0,0
35,336,192,32,48,608,208,10002,0,0,0,0
35,336,192,32,48,608,256,10002,0,0,0,0
35,336,192,32,48,608,304,10002,0,0,0,0
35,336,192,48,48,560,304,10002,0,0,0,0
35,336,192,48,48,560,256,10002,0,0,0,0
35,336,192,48,48,560,208,10002,0,0,0,0
35,336,192,48,48,560,160,10002,0,0,0,0
35,336,192,48,48,560,112,10002,0,0,0,0
35,336,192,48,48,560,64,10002,0,0,0,0
35,336,144,32,48,528,64,10002,0,0,0,0
35,336,144,32,48,528,112,10002,0,0,0,0
35,336,144,32,48,528,160,10002,0,0,0,0
35,336,144,32,48,528,208,10002,0,0,0,0
35,336,144,32,48,528,256,10002,0,0,0,0
35,336,144,32,48,528,304,10002,0,0,0,0
35,288,144,48,48,432,0,10002,0,0,0,0
35,288,144,48,48,480,0,10002,0,0,0,0
35,288,144,48,48,528,0,10002,0,0,0,0
35,288,144,48,48,576,0,10002,0,0,0,0
35,432,32,48,48,640,0,10002,0,0,0,0
35,432,32,48,48,688,0,10002,0,0,0,0
35,432,32,48,48,688,48,10002,0,0,0,0
35,432,32,48,48,640,48,10002,0,0,0,0
35,432,32,48,48,640,96,10002,0,0,0,0
35,432,32,48,48,688,96,10002,0,0,0,0
35,432,32,48,48,640,144,10002,0,0,0,0
35,432,32,48,48,688,144,10002,0,0,0,0
35,432,32,48,48,640,192,10002,0,0,0,0
35,432,32,48,48,688,192,10002,0,0,0,0
35,432,32,48,48,640,240,10002,0,0,0,0
35,432,32,48,48,688,240,10002,0,0,0,0
35,432,32,48,48,640,288,10002,0,0,0,0
35,432,32,48,48,688,288,10002,0,0,0,0
35,432,32,48,48,640,336,10002,0,0,0,0
35,432,32,48,48,688,336,10002,0,0,0,0
35,432,32,48,48,640,384,10002,0,0,0,0
35,432,32,48,48,688,384,10002,0,0,0,0
35,432,32,48,48,640,432,10002,0,0,0,0
35,432,32,48,48,688,432,10002,0,0,0,0
35,432,32,48,48,640,480,10002,0,0,0,0
35,432,32,48,48,640,528,10002,0,0,0,0
35,432,32,48,48,688,528,10002,0,0,0,0
35,432,32,48,48,688,480,10002,0,0,0,0
35,0,0,144,48,496,496,10002,0,0,0,0
35,0,0,144,48,496,448,10002,0,0,0,0
35,0,0,144,48,496,400,10002,0,0,0,0
35,0,0,144,48,496,352,10002,0,0,0,0
35,0,0,144,48,352,352,10002,0,0,0,0
35,0,0,144,48,352,400,10002,0,0,0,0
35,0,0,144,48,352,448,10002,0,0,0,0
35,0,0,144,48,352,496,10002,0,0,0,0
35,0,0,144,48,208,352,10002,0,0,0,0
35,0,0,144,48,208,400,10002,0,0,0,0
35,0,0,144,48,208,448,10002,0,0,0,0
35,0,0,144,48,208,496,10002,0,0,0,0
35,0,0,144,48,64,352,10002,0,0,0,0
35,0,0,144,48,64,400,10002,0,0,0,0
35,0,0,144,48,64,448,10002,0,0,0,0
35,0,0,144,48,64,496,10002,0,0,0,0
35,80,0,64,48,0,352,10002,0,0,0,0
35,80,0,64,48,0,400,10002,0,0,0,0
35,80,0,64,48,0,448,10002,0,0,0,0
35,80,0,64,48,0,496,10002,0,0,0,0
987654321
NB8jFgMqEQ==

