VVh6UkxxBnkpcyFiPlxYdnMjXFdpEXwSVTU7SBJhIEV+enVg
160,1400,40,0,0,16777215,0,0,0,1,318,0
158,168,232,0,1,16777215,0,1,0,1,6,0
195,1360,88,0,0,128,270,0,233,1,249,0
195,1400,88,0,0,128,270,0,259,1,255,0
195,1480,88,0,0,128,270,0,261,1,257,0
195,1520,88,0,0,128,270,0,263,1,258,0
195,1600,88,0,0,128,270,0,280,1,274,0
195,1640,88,0,0,128,270,0,281,1,275,0
195,1440,88,0,0,128,270,0,260,1,256,0
195,1560,88,0,0,128,270,0,264,1,273,0
100,1344,80,0,256,255,0,270,0,1,285,0
100,1432,0,0,256,255,0,247,0,1,313,0
100,1392,80,0,256,255,0,270,0,1,245,0
100,1440,80,0,256,255,0,270,0,1,246,0
100,1480,0,0,256,255,0,247,0,1,312,0
100,1528,0,0,256,255,0,247,0,1,311,0
100,1488,80,0,256,255,0,270,0,1,247,0
100,1576,0,0,256,255,0,247,0,1,310,0
100,1616,0,0,256,255,0,247,0,1,309,0
100,1584,80,0,256,255,0,270,0,1,282,0
100,1664,8,0,256,255,0,247,0,1,308,0
100,1624,80,0,256,255,0,270,0,1,283,0
100,1720,8,0,256,255,0,247,0,1,307,0
100,1664,80,0,256,255,0,270,0,1,284,0
100,1536,80,0,256,255,0,270,0,1,248,0
100,968,80,0,256,16777215,0,270,0,1,103,0
100,896,80,0,256,16777215,0,270,0,1,102,0
174,336,104,0,1,25,0,0,0,0,54,1
174,736,232,0,1,77,205,190,0,0,76,1
174,1128,48,0,1,185,0,0,0,0,154,1
174,1336,48,0,1,129,0,0,0,0,155,1
205,1144.50,64,0,1,0,0.50,0,0,1,153,0
205,951.50,168,0,1,0,0.50,0,0,1,98,0
186,704,168,0,32,32,0,0,0,1,88,0
188,792,296,0,0,78,0,0,0,1,87,0
185,358.50,184,0,5,64,1,0,0,1,7,0
242,728,216,0,32,32,0,0,0,1,205,0
313,552,128,0,0,32,32,0,0,1,89,0
313,520,216,0,0,32,32,0,0,1,55,0
313,1272,56,0,0,32,32,0,0,1,181,0
313,1248,152,0,0,32,32,0,0,1,224,0
313,546,156,0,0,32,32,0,0,1,80,0
313,616,136,0,0,32,32,0,0,1,210,0
154,358.50,184,0,1,0.50,32,32,-1,1,5,1
154,416,144,0,2,0.50,32,32,1,1,37,1
157,1360,184,0,32,32,0,0,0,1,254,0
157,1360,64,0,32,32,0,0,0,1,170,0
157,1360,40,0,32,32,0,0,0,1,151,0
157,1360,8,0,32,32,0,0,0,1,152,0
157,1392,184,0,32,32,0,0,0,1,233,0
157,1392,64,0,32,32,0,0,0,1,299,0
157,1424,184,0,32,32,0,0,0,1,259,0
157,1424,64,0,32,32,0,0,0,1,300,0
157,1456,184,0,32,32,0,0,0,1,260,0
157,1488,184,0,32,32,0,0,0,1,261,0
157,1456,64,0,32,32,0,0,0,1,301,0
157,1488,64,0,32,32,0,0,0,1,302,0
157,1520,184,0,32,32,0,0,0,1,263,0
157,1520,64,0,32,32,0,0,0,1,303,0
157,1552,184,0,32,32,0,0,0,1,262,0
157,1552,64,0,32,32,0,0,0,1,304,0
157,1568,64,0,32,32,0,0,0,1,305,0
157,1584,184,0,32,32,0,0,0,1,264,0
157,1592,64,0,32,32,0,0,0,1,297,0
157,1616,184,0,32,32,0,0,0,1,280,0
157,1624,64,0,32,32,0,0,0,1,296,0
157,1648,184,0,32,32,0,0,0,1,281,0
157,1656,64,0,32,32,0,0,0,1,293,0
157,1680,184,0,32,32,0,0,0,1,286,0
157,1712,184,0,32,32,0,0,0,1,288,0
157,1712,152,0,32,32,0,0,0,1,289,0
157,1712,120,0,32,32,0,0,0,1,290,0
157,1744,120,0,32,32,0,0,0,1,291,0
157,1744,88,0,32,32,0,0,0,1,292,0
157,1744,56,0,32,32,0,0,0,1,294,0
157,1744,24,0,32,32,0,0,0,1,295,0
157,1744,8,0,32,32,0,0,0,1,306,0
157,1328,184,0,32,32,0,0,0,1,231,0
157,1296,184,0,32,32,0,0,0,1,230,0
157,1272,184,0,32,32,0,0,0,1,229,0
157,1240,184,0,32,32,0,0,0,1,114,0
157,1304,120,0,32,32,0,0,0,1,178,0
157,1272,120,0,32,32,0,0,0,1,149,0
157,1240,120,0,32,32,0,0,0,1,125,0
157,1240,64,0,32,32,0,0,0,1,124,0
157,1328,64,0,32,32,0,0,0,1,172,0
157,1304,96,0,32,32,0,0,0,1,179,0
157,1304,64,0,32,32,0,0,0,1,171,0
157,1240,96,0,32,32,0,0,0,1,150,0
157,1240,80,0,32,32,0,0,0,1,148,0
157,1224,64,0,32,32,0,0,0,1,132,0
157,1208,184,0,32,32,0,0,0,1,119,0
157,1200,64,0,32,32,0,0,0,1,131,0
157,824,216,0,32,32,0,0,0,1,84,0
157,760,216,0,32,32,0,0,0,1,75,0
157,1176,184,0,32,32,0,0,0,1,118,0
157,1144,184,0,32,32,0,0,0,1,113,0
157,1112,184,0,32,32,0,0,0,1,112,0
157,1080,184,0,32,32,0,0,0,1,115,0
157,1048,184,0,32,32,0,0,0,1,111,0
157,1016,184,0,32,32,0,0,0,1,164,0
157,984,184,0,32,32,0,0,0,1,97,0
157,952,184,0,32,32,0,0,0,1,96,0
157,920,184,0,32,32,0,0,0,1,95,0
157,888,184,0,32,32,0,0,0,1,94,0
157,856,184,0,32,32,0,0,0,1,92,0
157,824,184,0,32,32,0,0,0,1,86,0
157,760,184,0,32,32,0,0,0,1,74,0
157,728,184,0,32,32,0,0,0,1,73,0
157,696,184,0,32,32,0,0,0,1,72,0
157,664,184,0,32,32,0,0,0,1,71,0
157,520,184,0,32,32,0,0,0,1,23,0
157,1176,136,0,32,32,0,0,0,1,123,0
157,1144,136,0,32,32,0,0,0,1,122,0
157,1112,136,0,32,32,0,0,0,1,121,0
157,1080,136,0,32,32,0,0,0,1,120,0
157,1064,136,0,32,32,0,0,0,1,144,0
157,1040,136,0,32,32,0,0,0,1,165,0
157,520,152,0,32,32,0,0,0,1,31,0
155,8,184,0,1,1,0,0,0,1,3,0
155,616,184,0,2,1,0,0,0,1,4,0
169,512,200,0,0,0,0,0,0,1,25,1
155,416,216,0,1,2,0,0,0,1,35,0
155,416,120,0,2,2,0,0,0,1,36,0
169,1240,136,0,0,0,0,0,0,1,129,1
172,1256,48,0,0,0,0,0,0,1,185,1
155,616,136,0,3,1,10,0,0,0,190,0
155,848,136,0,4,1,0,0,0,1,195,0
155,816,88,0,5,1,0,0,0,1,215,0
155,864,64,0,6,1,0,0,0,1,216,0
155,912,88,0,7,1,0,0,0,1,217,0
155,880,136,0,8,1,0,0,0,1,218,0
155,1496,136,0,9,1,0,0,0,1,219,0
155,1496,40,0,10,1,0,0,0,1,323,0
166,0,224,0,0,0,0,0,0,1,58,1
166,0,200,0,0,0,0,0,0,1,59,1
166,0,144,0,0,0,0,0,0,1,60,1
166,0,176,0,0,0,0,0,0,1,61,1
166,544,160,0,0,0,0,0,0,1,77,1
166,544,128,0,0,0,0,0,0,1,78,1
166,776,176,0,0,0,0,0,0,1,200,1
157,1168,64,0,32,32,0,0,0,1,147,0
157,1136,64,0,32,32,0,0,0,1,146,0
157,1168,88,0,32,32,0,0,0,1,126,0
157,1136,88,0,32,32,0,0,0,1,133,0
157,1080,72,0,32,32,0,0,0,1,134,0
157,1080,104,0,32,32,0,0,0,1,135,0
157,1056,104,0,32,32,0,0,0,1,162,0
157,1056,72,0,32,32,0,0,0,1,163,0
157,1040,104,0,32,32,0,0,0,1,142,0
157,1040,72,0,32,32,0,0,0,1,143,0
157,1040,40,0,32,32,0,0,0,1,140,0
157,1040,8,0,32,32,0,0,0,1,141,0
157,824,248,0,32,32,0,0,0,1,85,0
157,824,280,0,32,32,0,0,0,1,106,0
157,824,312,0,32,32,0,0,0,1,108,0
157,792,312,0,32,32,0,0,0,1,83,0
157,760,248,0,32,32,0,0,0,1,70,0
157,760,280,0,32,32,0,0,0,1,93,0
157,760,312,0,32,32,0,0,0,1,107,0
157,736,248,0,32,32,0,0,0,1,69,0
157,704,248,0,32,32,0,0,0,1,67,0
157,672,248,0,32,32,0,0,0,1,68,0
157,640,248,0,32,32,0,0,0,1,65,0
157,608,248,0,32,32,0,0,0,1,66,0
157,576,248,0,32,32,0,0,0,1,64,0
157,552,248,0,32,32,0,0,0,1,21,0
157,520,248,0,32,32,0,0,0,1,24,0
157,520,120,0,32,32,0,0,0,1,40,0
157,520,88,0,32,32,0,0,0,1,41,0
157,520,56,0,32,32,0,0,0,1,42,0
157,496,56,0,32,32,0,0,0,1,53,0
157,488,248,0,32,32,0,0,0,1,20,0
157,472,56,0,32,32,0,0,0,1,52,0
157,456,248,0,32,32,0,0,0,1,27,0
157,440,56,0,32,32,0,0,0,1,51,0
157,432,248,0,32,32,0,0,0,1,34,0
157,408,56,0,32,32,0,0,0,1,50,0
157,400,248,0,32,32,0,0,0,1,33,0
157,376,120,0,32,32,0,0,0,1,44,0
157,376,56,0,32,32,0,0,0,1,49,0
157,368,248,0,32,32,0,0,0,1,12,0
157,344,120,0,32,32,0,0,0,1,43,0
157,344,56,0,32,32,0,0,0,1,48,0
157,336,248,0,32,32,0,0,0,1,13,0
157,312,120,0,32,32,0,0,0,1,45,0
157,312,88,0,32,32,0,0,0,1,46,0
157,312,56,0,32,32,0,0,0,1,47,0
157,304,248,0,32,32,0,0,0,1,14,0
157,272,248,0,32,32,0,0,0,1,11,0
157,240,248,0,32,32,0,0,0,1,19,0
157,208,248,0,32,32,0,0,0,1,15,0
157,176,248,0,32,32,0,0,0,1,18,0
157,144,248,0,32,32,0,0,0,1,17,0
157,112,248,0,32,32,0,0,0,1,16,0
157,80,248,0,32,32,0,0,0,1,10,0
157,48,248,0,32,32,0,0,0,1,9,0
157,16,248,0,32,32,0,0,0,1,8,0
1234567890
25,352,192,16,16,1456,224,10002,0,0,0,0
25,352,192,16,16,304,240,10002,0,0,0,0
25,352,192,16,16,304,256,10002,0,0,0,0
25,352,192,16,16,320,272,10002,0,0,0,0
25,352,192,16,16,320,288,10002,0,0,0,0
25,352,192,16,16,320,256,10002,0,0,0,0
25,352,192,16,16,336,192,10002,0,0,0,0
25,352,192,16,16,352,208,10002,0,0,0,0
25,352,192,16,16,368,208,10002,0,0,0,0
25,352,192,16,16,384,208,10002,0,0,0,0
25,352,192,16,16,400,192,10002,0,0,0,0
25,352,192,16,16,416,192,10002,0,0,0,0
25,352,192,16,16,432,192,10002,0,0,0,0
25,352,192,16,16,448,192,10002,0,0,0,0
25,352,192,16,16,448,176,10002,0,0,0,0
25,352,192,16,16,464,176,10002,0,0,0,0
25,352,192,16,16,480,176,10002,0,0,0,0
25,352,192,16,16,512,176,10002,0,0,0,0
25,352,192,16,16,496,176,10002,0,0,0,0
25,352,192,16,16,480,192,10002,0,0,0,0
25,352,192,16,16,464,192,10002,0,0,0,0
25,352,192,16,16,400,208,10002,0,0,0,0
25,352,192,16,16,416,208,10002,0,0,0,0
25,352,192,16,16,432,208,10002,0,0,0,0
25,352,192,16,16,160,208,10002,0,0,0,0
25,352,192,16,16,176,224,10002,0,0,0,0
25,352,192,16,16,208,208,10002,0,0,0,0
25,352,192,16,16,224,208,10002,0,0,0,0
25,352,192,16,16,240,208,10002,0,0,0,0
25,352,192,16,16,176,208,10002,0,0,0,0
25,352,192,16,16,192,208,10002,0,0,0,0
25,352,192,16,16,192,192,10002,0,0,0,0
25,352,192,16,16,208,192,10002,0,0,0,0
25,352,192,16,16,224,192,10002,0,0,0,0
25,352,192,16,16,240,192,10002,0,0,0,0
25,352,192,16,16,256,176,10002,0,0,0,0
25,352,192,16,16,272,176,10002,0,0,0,0
25,352,192,16,16,288,176,10002,0,0,0,0
25,352,192,16,16,304,176,10002,0,0,0,0
25,352,192,16,16,320,176,10002,0,0,0,0
25,352,192,16,16,336,176,10002,0,0,0,0
25,352,192,16,16,352,176,10002,0,0,0,0
25,352,192,16,16,368,176,10002,0,0,0,0
25,352,192,16,16,384,176,10002,0,0,0,0
25,352,192,16,16,384,160,10002,0,0,0,0
25,352,192,16,16,400,160,10002,0,0,0,0
25,352,192,16,16,416,256,10002,0,0,0,0
25,352,192,16,16,448,272,10002,0,0,0,0
25,352,192,16,16,480,272,10002,0,0,0,0
25,352,192,16,16,496,272,10002,0,0,0,0
25,352,192,16,16,1008,272,10002,0,0,0,0
25,352,192,16,16,1840,224,10002,0,0,0,0
25,352,192,16,16,1840,192,10002,0,0,0,0
25,352,192,16,16,1472,192,10002,0,0,0,0
25,352,192,16,16,1440,192,10002,0,0,0,0
25,352,192,16,16,1424,192,10002,0,0,0,0
25,352,192,16,16,1408,208,10002,0,0,0,0
25,352,192,16,16,1296,224,10002,0,0,0,0
25,352,192,16,16,1216,256,10002,0,0,0,0
25,352,192,16,16,1184,256,10002,0,0,0,0
25,352,192,16,16,1424,224,10002,0,0,0,0
25,352,192,16,16,1376,208,10002,0,0,0,0
25,352,192,16,16,1264,192,10002,0,0,0,0
25,352,192,16,16,1232,192,10002,0,0,0,0
25,352,192,16,16,1136,176,10002,0,0,0,0
25,352,192,16,16,1104,176,10002,0,0,0,0
25,352,192,16,16,1536,208,10002,0,0,0,0
25,352,192,16,16,1536,224,10002,0,0,0,0
25,352,192,16,16,1520,224,10002,0,0,0,0
25,352,192,16,16,1504,224,10002,0,0,0,0
25,352,192,16,16,1488,224,10002,0,0,0,0
25,352,192,16,16,1472,224,10002,0,0,0,0
25,352,192,16,16,1456,240,10002,0,0,0,0
25,352,192,16,16,1392,224,10002,0,0,0,0
25,352,192,16,16,1312,208,10002,0,0,0,0
25,352,192,16,16,1280,208,10002,0,0,0,0
25,352,192,16,16,1264,208,10002,0,0,0,0
25,352,192,16,16,1184,192,10002,0,0,0,0
25,352,192,16,16,1088,176,10002,0,0,0,0
25,352,192,16,16,1056,176,10002,0,0,0,0
25,352,192,16,16,1088,192,10002,0,0,0,0
25,352,192,16,16,1632,192,10002,0,0,0,0
25,352,192,16,16,1616,192,10002,0,0,0,0
25,352,192,16,16,1408,176,10002,0,0,0,0
25,352,192,16,16,1824,176,10002,0,0,0,0
25,352,192,16,16,1360,144,10002,0,0,0,0
25,352,192,16,16,1888,144,10002,0,0,0,0
25,352,192,16,16,1872,144,10002,0,0,0,0
25,352,192,16,16,1872,160,10002,0,0,0,0
25,352,192,16,16,1856,160,10002,0,0,0,0
25,352,192,16,16,1920,176,10002,0,0,0,0
25,352,192,16,16,1392,176,10002,0,0,0,0
25,352,192,16,16,1552,272,10002,0,0,0,0
25,352,192,16,16,1568,208,10002,0,0,0,0
25,352,192,16,16,1568,192,10002,0,0,0,0
987654321
Bhsu

