UVx6TlN0AGU9Z19pPx1INFgKQWB0EgpzRDg7GV05ZRA6PzckYGZjenh/cUNiVSc2HGgkO18=
158,128,256,0,1,16777215,0,1,0,1,4,0
123,320,80,0,128,16777215,0,0,0,1,1,0
316,208,88,0,0,1,0,0,0,1,2,0
185,80,232,0,0,32,1,0,0,1,14,0
157,352,272,0,32,32,0,0,0,1,13,0
157,320,272,0,32,32,0,0,0,1,12,0
157,288,272,0,32,32,0,0,0,1,11,0
157,256,272,0,32,32,0,0,0,1,10,0
157,224,272,0,32,32,0,0,0,1,9,0
157,192,272,0,32,32,0,0,0,1,8,0
157,128,272,0,32,32,0,0,0,1,7,0
157,160,272,0,32,32,0,0,0,1,6,0
157,96,272,0,32,32,0,0,0,1,5,0
157,214,106,0,32,32,0,0,0,1,3,0
1234567890
38,416,64,32,32,208,224,9998,0,0,0,0
38,416,64,32,32,272,208,9998,0,0,0,0
38,416,64,32,32,320,208,9998,0,0,0,0
38,416,64,32,32,240,208,9998,0,0,0,0
38,416,64,32,32,160,224,9998,0,0,0,0
38,144,112,16,16,144,192,9998,0,0,0,0
38,144,112,16,16,160,192,9998,0,0,0,0
38,144,112,16,16,224,192,9998,0,0,0,0
38,144,112,16,16,240,160,9998,0,0,0,0
38,144,112,16,16,272,128,9998,0,0,0,0
38,144,112,16,16,288,128,9998,0,0,0,0
38,144,112,16,16,304,128,9998,0,0,0,0
38,144,112,16,16,320,128,9998,0,0,0,0
38,144,112,16,16,336,128,9998,0,0,0,0
38,144,112,16,16,352,128,9998,0,0,0,0
38,144,112,16,16,384,128,9998,0,0,0,0
38,144,112,16,16,432,144,9998,0,0,0,0
38,144,112,16,16,464,144,9998,0,0,0,0
38,144,112,16,16,560,176,9998,0,0,0,0
38,144,112,16,16,592,208,9998,0,0,0,0
38,144,112,16,16,608,224,9998,0,0,0,0
38,144,112,16,16,608,240,9998,0,0,0,0
38,144,112,16,16,608,256,9998,0,0,0,0
38,144,112,16,16,608,272,9998,0,0,0,0
38,144,112,16,16,592,288,9998,0,0,0,0
38,144,112,16,16,576,304,9998,0,0,0,0
38,144,112,16,16,560,304,9998,0,0,0,0
38,144,112,16,16,528,304,9998,0,0,0,0
38,144,112,16,16,496,288,9998,0,0,0,0
38,144,112,16,16,480,272,9998,0,0,0,0
38,144,112,16,16,448,256,9998,0,0,0,0
38,144,112,16,16,416,224,9998,0,0,0,0
38,144,112,16,16,384,176,9998,0,0,0,0
38,144,112,16,16,368,144,9998,0,0,0,0
38,144,112,16,16,368,128,9998,0,0,0,0
38,144,112,16,16,368,112,9998,0,0,0,0
38,144,112,16,16,368,96,9998,0,0,0,0
38,144,112,16,16,384,80,9998,0,0,0,0
38,144,112,16,16,400,80,9998,0,0,0,0
38,144,112,16,16,432,96,9998,0,0,0,0
38,144,112,16,16,448,112,9998,0,0,0,0
38,144,112,16,16,448,144,9998,0,0,0,0
38,144,112,16,16,384,160,9998,0,0,0,0
38,144,112,16,16,352,176,9998,0,0,0,0
38,144,112,16,16,336,176,9998,0,0,0,0
38,144,112,16,16,336,160,9998,0,0,0,0
38,144,112,16,16,352,144,9998,0,0,0,0
38,144,112,16,16,416,128,9998,0,0,0,0
38,144,112,16,16,464,112,9998,0,0,0,0
38,144,112,16,16,544,112,9998,0,0,0,0
38,144,112,16,16,608,128,9998,0,0,0,0
38,144,112,16,16,624,144,9998,0,0,0,0
38,144,112,16,16,608,160,9998,0,0,0,0
38,144,112,16,16,576,160,9998,0,0,0,0
38,144,112,16,16,560,160,9998,0,0,0,0
38,144,112,16,16,544,160,9998,0,0,0,0
38,144,112,16,16,528,176,9998,0,0,0,0
38,144,112,16,16,464,160,9998,0,0,0,0
38,144,112,16,16,400,160,9998,0,0,0,0
38,144,112,16,16,400,144,9998,0,0,0,0
38,144,112,16,16,448,128,9998,0,0,0,0
38,144,112,16,16,512,112,9998,0,0,0,0
38,144,112,16,16,528,112,9998,0,0,0,0
38,144,112,16,16,528,128,9998,0,0,0,0
38,144,112,16,16,496,160,9998,0,0,0,0
38,144,112,16,16,400,208,9998,0,0,0,0
38,144,112,16,16,384,208,9998,0,0,0,0
38,144,112,16,16,368,208,9998,0,0,0,0
38,144,112,16,16,368,160,9998,0,0,0,0
38,144,112,16,16,400,96,9998,0,0,0,0
38,144,112,16,16,416,80,9998,0,0,0,0
38,144,112,16,16,448,80,9998,0,0,0,0
38,144,112,16,16,480,80,9998,0,0,0,0
38,144,112,16,16,528,96,9998,0,0,0,0
38,144,112,16,16,560,128,9998,0,0,0,0
38,144,112,16,16,592,160,9998,0,0,0,0
38,144,112,16,16,608,176,9998,0,0,0,0
38,144,112,16,16,608,192,9998,0,0,0,0
38,144,112,16,16,592,192,9998,0,0,0,0
38,144,112,16,16,560,208,9998,0,0,0,0
38,144,112,16,16,528,208,9998,0,0,0,0
38,144,112,16,16,512,208,9998,0,0,0,0
38,144,112,16,16,480,160,9998,0,0,0,0
38,144,112,16,16,480,144,9998,0,0,0,0
38,144,112,16,16,480,128,9998,0,0,0,0
38,144,112,16,16,496,128,9998,0,0,0,0
38,144,112,16,16,496,144,9998,0,0,0,0
38,144,112,16,16,512,160,9998,0,0,0,0
38,144,112,16,16,480,176,9998,0,0,0,0
38,144,112,16,16,448,176,9998,0,0,0,0
38,144,112,16,16,400,176,9998,0,0,0,0
38,144,112,16,16,352,160,9998,0,0,0,0
38,144,112,16,16,224,128,9998,0,0,0,0
38,144,112,16,16,208,128,9998,0,0,0,0
38,144,112,16,16,208,112,9998,0,0,0,0
38,144,112,16,16,224,112,9998,0,0,0,0
38,144,112,16,16,240,96,9998,0,0,0,0
38,144,112,16,16,288,96,9998,0,0,0,0
38,144,112,16,16,352,112,9998,0,0,0,0
38,144,112,16,16,384,112,9998,0,0,0,0
38,144,112,16,16,400,128,9998,0,0,0,0
38,144,112,16,16,416,144,9998,0,0,0,0
38,144,112,16,16,416,160,9998,0,0,0,0
38,144,112,16,16,416,176,9998,0,0,0,0
38,144,112,16,16,368,224,9998,0,0,0,0
38,144,112,16,16,304,256,9998,0,0,0,0
38,144,112,16,16,256,256,9998,0,0,0,0
38,144,112,16,16,176,256,9998,0,0,0,0
38,144,112,16,16,112,256,9998,0,0,0,0
38,144,112,16,16,80,240,9998,0,0,0,0
38,144,112,16,16,64,240,9998,0,0,0,0
38,144,112,16,16,80,224,9998,0,0,0,0
38,144,112,16,16,112,208,9998,0,0,0,0
38,144,112,16,16,176,192,9998,0,0,0,0
38,144,112,16,16,240,176,9998,0,0,0,0
38,144,112,16,16,288,160,9998,0,0,0,0
38,144,112,16,16,384,144,9998,0,0,0,0
38,144,112,16,16,448,160,9998,0,0,0,0
38,144,112,16,16,496,176,9998,0,0,0,0
38,144,112,16,16,512,176,9998,0,0,0,0
38,144,112,16,16,512,192,9998,0,0,0,0
38,144,112,16,16,496,192,9998,0,0,0,0
38,144,112,16,16,464,192,9998,0,0,0,0
38,144,112,16,16,416,192,9998,0,0,0,0
38,144,112,16,16,368,192,9998,0,0,0,0
38,144,112,16,16,336,192,9998,0,0,0,0
38,144,112,16,16,304,192,9998,0,0,0,0
38,144,112,16,16,288,192,9998,0,0,0,0
38,144,112,16,16,208,192,9998,0,0,0,0
38,144,112,16,16,192,176,9998,0,0,0,0
38,144,112,16,16,208,176,9998,0,0,0,0
38,144,112,16,16,224,176,9998,0,0,0,0
38,144,112,16,16,240,192,9998,0,0,0,0
38,144,112,16,16,256,192,9998,0,0,0,0
38,144,112,16,16,272,192,9998,0,0,0,0
38,144,112,16,16,272,176,9998,0,0,0,0
38,144,112,16,16,272,160,9998,0,0,0,0
38,144,112,16,16,256,160,9998,0,0,0,0
38,144,112,16,16,256,144,9998,0,0,0,0
38,144,112,16,16,240,144,9998,0,0,0,0
987654321
EBwoQgMqWT9g

