UVx6TlN0AGU9Z1ccakBPaG44eQoXEDJlL387LFsieDk3PDw8KSQ9ZmRjbV9+STsqAHQ=
160,56,232,0,0,16777215,0,0,0,1,26,0
158,56,96,0,1,16777215,0,1,0,1,15,0
197,424,96,0,5,0,0,0,0,1,16,0
205,413.83,240,0,1,0,0.50,0,0,1,10,0
185,400,32,0,0,32,1,0,0,1,25,0
185,520,40,0,0,32,1,0,0,1,24,0
185,328,96,0,0,32,1,0,0,1,23,0
185,192,240,0,0,32,1,0,0,1,19,0
185,216,96,0,0,32,1,0,0,1,18,0
185,136,48,0,0,32,1,0,0,1,17,0
185,296,240,0,0,32,1,0,0,1,12,0
157,336,224,0,32,32,0,0,0,1,11,0
157,16,192,0,24,160,0,0,0,1,8,0
157,40,256,0,32,32,0,0,0,1,7,0
157,304,256,0,496,32,0,0,0,1,6,0
157,544,200,0,32,400,0,0,0,1,5,0
157,280,16,0,496,32,0,0,0,1,4,0
157,480,176,0,32,96,0,0,0,1,3,0
157,16,48,0,32,96,0,0,0,1,2,0
157,248,112,0,496,32,0,0,0,1,69,0
166,32,152,0,0,0,0,0,0,1,13,1
197,336,208,0,2,0,0,0,0,1,27,0
1234567890
34,336,160,176,64,176,192,10002,0,0,0,0
34,336,160,176,64,0,192,10002,0,0,0,0
34,336,160,176,64,352,192,10002,0,0,0,0
34,336,160,176,64,528,192,10002,0,0,0,0
34,336,160,176,64,528,128,10002,0,0,0,0
34,336,160,176,64,352,128,10002,0,0,0,0
34,336,160,176,64,176,128,10002,0,0,0,0
34,336,160,176,64,0,128,10002,0,0,0,0
34,336,160,176,64,0,256,10002,0,0,0,0
34,336,160,176,64,0,320,10002,0,0,0,0
34,336,160,176,64,176,256,10002,0,0,0,0
34,336,160,176,64,352,256,10002,0,0,0,0
34,336,160,176,64,528,256,10002,0,0,0,0
34,336,160,176,64,528,320,10002,0,0,0,0
34,336,160,176,64,352,320,10002,0,0,0,0
34,336,160,176,64,176,320,10002,0,0,0,0
34,336,160,176,64,176,64,10002,0,0,0,0
34,336,160,176,64,352,0,10002,0,0,0,0
34,336,160,176,64,352,64,10002,0,0,0,0
34,336,160,176,64,528,64,10002,0,0,0,0
34,336,160,176,64,528,0,10002,0,0,0,0
34,336,160,176,64,0,0,10002,0,0,0,0
34,336,160,176,64,176,0,10002,0,0,0,0
34,336,160,176,64,0,64,10002,0,0,0,0
24,0,160,32,32,96,208,10000,0,0,0,0
24,0,160,32,32,224,208,10000,0,0,0,0
24,0,160,32,32,256,64,10000,0,0,0,0
24,528,240,16,16,496,80,9998,0,0,0,0
24,528,240,16,16,512,80,9998,0,0,0,0
24,528,240,16,16,512,96,9998,0,0,0,0
24,528,240,16,16,496,96,9998,0,0,0,0
24,528,240,16,16,496,112,9998,0,0,0,0
24,528,240,16,16,496,128,9998,0,0,0,0
24,528,240,16,16,496,144,9998,0,0,0,0
24,528,240,16,16,512,144,9998,0,0,0,0
24,528,240,16,16,512,128,9998,0,0,0,0
24,528,240,16,16,512,112,9998,0,0,0,0
24,528,240,16,16,528,112,9998,0,0,0,0
24,528,240,16,16,528,96,9998,0,0,0,0
24,528,240,16,16,480,80,9998,0,0,0,0
24,528,240,16,16,480,64,9998,0,0,0,0
24,528,240,16,16,480,48,9998,0,0,0,0
24,528,240,16,16,464,32,9998,0,0,0,0
24,528,240,16,16,448,32,9998,0,0,0,0
24,528,240,16,16,432,32,9998,0,0,0,0
24,528,240,16,16,416,32,9998,0,0,0,0
24,528,240,16,16,400,32,9998,0,0,0,0
24,528,240,16,16,384,48,9998,0,0,0,0
24,528,240,16,16,368,48,9998,0,0,0,0
24,528,240,16,16,352,48,9998,0,0,0,0
24,528,240,16,16,336,48,9998,0,0,0,0
24,528,240,16,16,288,64,9998,0,0,0,0
24,528,240,16,16,272,80,9998,0,0,0,0
24,528,240,16,16,288,80,9998,0,0,0,0
24,528,240,16,16,320,64,9998,0,0,0,0
24,528,240,16,16,320,48,9998,0,0,0,0
24,528,240,16,16,272,48,9998,0,0,0,0
24,528,240,16,16,240,32,9998,0,0,0,0
24,528,240,16,16,224,32,9998,0,0,0,0
24,528,240,16,16,224,48,9998,0,0,0,0
24,528,240,16,16,208,48,9998,0,0,0,0
24,528,240,16,16,224,64,9998,0,0,0,0
24,528,240,16,16,240,64,9998,0,0,0,0
24,528,240,16,16,304,64,9998,0,0,0,0
24,528,240,16,16,352,64,9998,0,0,0,0
24,528,240,16,16,400,64,9998,0,0,0,0
24,528,240,16,16,448,64,9998,0,0,0,0
24,528,240,16,16,464,64,9998,0,0,0,0
24,528,240,16,16,448,80,9998,0,0,0,0
24,528,240,16,16,432,96,9998,0,0,0,0
24,528,240,16,16,320,112,9998,0,0,0,0
24,528,240,16,16,272,128,9998,0,0,0,0
24,528,240,16,16,208,144,9998,0,0,0,0
24,528,240,16,16,192,144,9998,0,0,0,0
24,528,240,16,16,160,160,9998,0,0,0,0
24,528,240,16,16,128,160,9998,0,0,0,0
24,528,240,16,16,112,176,9998,0,0,0,0
24,528,240,16,16,96,192,9998,0,0,0,0
24,528,240,16,16,80,192,9998,0,0,0,0
24,528,240,16,16,80,208,9998,0,0,0,0
24,528,240,16,16,96,208,9998,0,0,0,0
24,528,240,16,16,160,208,9998,0,0,0,0
24,528,240,16,16,192,192,9998,0,0,0,0
24,528,240,16,16,224,192,9998,0,0,0,0
24,528,240,16,16,160,192,9998,0,0,0,0
24,528,240,16,16,112,192,9998,0,0,0,0
24,528,240,16,16,64,192,9998,0,0,0,0
24,528,240,16,16,16,208,9998,0,0,0,0
24,528,240,16,16,0,208,9998,0,0,0,0
24,528,240,16,16,0,224,9998,0,0,0,0
24,528,240,16,16,16,224,9998,0,0,0,0
24,528,240,16,16,48,224,9998,0,0,0,0
24,528,240,16,16,128,208,9998,0,0,0,0
24,528,240,16,16,208,192,9998,0,0,0,0
24,528,240,16,16,384,112,9998,0,0,0,0
24,528,240,16,16,368,112,9998,0,0,0,0
24,528,240,16,16,336,128,9998,0,0,0,0
24,528,240,16,16,288,160,9998,0,0,0,0
24,528,240,16,16,288,176,9998,0,0,0,0
24,528,240,16,16,272,208,9998,0,0,0,0
24,528,240,16,16,272,224,9998,0,0,0,0
24,528,240,16,16,288,208,9998,0,0,0,0
24,528,240,16,16,320,208,9998,0,0,0,0
24,528,240,16,16,336,192,9998,0,0,0,0
24,528,240,16,16,352,192,9998,0,0,0,0
24,528,240,16,16,368,176,9998,0,0,0,0
24,528,240,16,16,352,176,9998,0,0,0,0
24,528,240,16,16,336,160,9998,0,0,0,0
24,528,240,16,16,304,144,9998,0,0,0,0
24,528,240,16,16,256,128,9998,0,0,0,0
24,528,240,16,16,240,128,9998,0,0,0,0
24,528,240,16,16,224,128,9998,0,0,0,0
24,528,240,16,16,224,144,9998,0,0,0,0
24,528,240,16,16,240,160,9998,0,0,0,0
24,528,240,16,16,272,176,9998,0,0,0,0
24,528,240,16,16,304,176,9998,0,0,0,0
24,528,240,16,16,336,176,9998,0,0,0,0
24,528,240,16,16,384,192,9998,0,0,0,0
24,528,240,16,16,416,192,9998,0,0,0,0
24,528,240,16,16,432,192,9998,0,0,0,0
987654321
Mw05FkAOVT9gJy0Dc29CNBM4O3pBCjhHCyVHFF8oZRs1

