UVx6TlN0AGU9Z2tZbhYBFHsGTnV+Nx5lMUJfVA59PFliZml8NTgheng=
158,408,224,0,1,16777215,0,1,0,1,15,0
160,528,224,0,0,16777215,0,0,0,1,21,0
123,352,160,0,128,16777215,0,0,0,1,24,0
197,456,224,0,2,0,0,0,0,1,14,0
381,240,160,0,0,0,0,0,0,1,13,1
210,312,200,0,0,0,0,0,0,1,11,0
216,424,80,0,0,0,0,96,PFRFWFQ+,1,20,0
210,272,200,0,0,0,0,0,0,1,12,0
157,512,240,0,32,32,0,0,0,1,19,0
157,544,240,0,32,32,0,0,0,1,18,0
157,480,240,0,32,32,0,0,0,1,17,0
157,448,240,0,32,32,0,0,0,1,16,0
157,208,160,0,32,32,0,0,0,1,10,0
157,208,192,0,32,32,0,0,0,1,9,0
157,240,208,0,32,32,0,0,0,1,8,0
157,432,240,0,32,32,0,0,0,1,7,0
157,400,240,0,32,32,0,0,0,1,6,0
157,368,232,0,32,32,0,0,0,1,5,0
157,336,224,0,32,32,0,0,0,1,4,0
157,304,216,0,32,32,0,0,0,1,3,0
157,272,216,0,32,32,0,0,0,1,2,0
1234567890
38,0,0,640,352,0,16,10000,0,0,0,0
38,0,0,640,16,0,0,10000,0,0,0,0
35,288,144,96,32,464,224,10002,0,0,0,0
35,288,144,96,32,368,224,10002,0,0,0,0
35,288,144,96,32,320,96,10002,0,0,0,0
35,288,144,96,32,320,64,10002,0,0,0,0
35,288,144,96,32,288,128,10002,0,0,0,0
35,288,144,96,32,384,128,10002,0,0,0,0
35,368,256,32,48,320,160,10002,0,0,0,0
35,240,272,16,16,240,208,9998,0,0,0,0
37,576,288,32,32,528,224,9998,0,0,0,0
37,576,288,32,32,304,64,9998,0,0,0,0
37,576,288,32,32,240,256,9998,0,0,0,0
37,576,288,32,32,224,176,9998,0,0,0,0
37,576,288,32,32,320,192,9998,0,0,0,0
37,576,288,32,32,480,240,9998,0,0,0,0
37,576,288,32,32,560,240,9998,0,0,0,0
37,576,288,32,32,592,240,9998,0,0,0,0
37,576,288,32,32,272,128,9998,0,0,0,0
37,576,288,32,32,256,96,9998,0,0,0,0
37,576,288,32,32,352,80,9998,0,0,0,0
37,576,288,32,32,400,96,9998,0,0,0,0
37,576,288,32,32,448,128,9998,0,0,0,0
37,576,288,32,32,432,208,9998,0,0,0,0
37,576,288,32,32,368,256,9998,0,0,0,0
37,576,288,32,32,304,240,9998,0,0,0,0
37,576,288,32,32,176,192,9998,0,0,0,0
37,576,288,32,32,144,192,9998,0,0,0,0
987654321
CQdqCBUvQCBrLC1PMENEP0Ipdl1ACm8=

