UVx6TlN0AGU9Z1gdAUdPEmYjSlVoBDRlP3xNOQNsID0zKTIjTXVyPTsbIAw5CjsqAHQ4J0MqcicrGjVq
160,272,176,0,0,16777215,0,0,0,1,51,0
158,320,180,0,1,16777215,0,1,0,1,2,0
197,240,184,0,2,0,0,0,0,1,44,0
197,536,288,0,2,0,0,0,0,1,43,0
197,512,304,0,2,0,0,0,0,1,47,0
197,368,184,0,2,0,0,0,0,1,41,0
197,208,304,0,2,0,0,0,0,1,48,0
197,360,304,0,2,0,0,0,0,1,50,0
197,352,184,0,2,0,0,0,0,1,42,0
197,264,304,0,2,0,0,0,0,1,45,0
197,56,304,0,2,0,0,0,0,1,46,0
304,368,320,0,0,0,0,0,0,1,58,0
304,448,320,0,0,0,0,0,0,1,57,0
304,264,320,0,0,0,0,0,0,1,52,0
304,144,320,0,0,0,0,0,0,1,24,0
185,576,320,0,0,32,-1,0,0,1,60,0
185,632,120,0,0,32,1,0,0,1,39,0
185,592,119,0,0,32,1,0,0,1,38,0
185,544,120,0,0,32,1,0,0,1,37,0
185,448,120,0,0,32,1,0,0,1,36,0
185,496,120,0,0,32,1,0,0,1,35,0
185,400,120,0,0,32,1,0,0,1,34,0
185,352,120,0,0,32,1,0,0,1,33,0
185,208,120,0,0,32,1,0,0,1,30,0
185,256,120,0,0,32,1,0,0,1,29,0
185,304,120,0,0,32,1,0,0,1,28,0
157,544,320,0,32,32,0,0,0,1,59,0
157,536,304,0,32,32,0,0,0,1,56,0
157,416,304,0,32,32,0,0,0,1,55,0
157,296,304,0,32,32,0,0,0,1,54,0
157,176,304,0,32,32,0,0,0,1,53,0
157,184,336,0,3288,32,0,0,0,1,40,0
157,88,216,0,32,32,0,0,0,1,27,0
157,16,304,0,32,32,0,0,0,1,26,0
157,32,272,0,32,32,0,0,0,1,25,0
157,480,200,0,32,32,0,0,0,1,23,0
157,448,200,0,32,32,0,0,0,1,22,0
157,616,304,0,32,32,0,0,0,1,21,0
157,560,264,0,32,32,0,0,0,1,20,0
157,592,264,0,32,32,0,0,0,1,19,0
157,624,264,0,32,32,0,0,0,1,18,0
157,608,200,0,32,32,0,0,0,1,17,0
157,576,200,0,32,32,0,0,0,1,16,0
157,512,200,0,32,32,0,0,0,1,15,0
157,544,200,0,32,32,0,0,0,1,14,0
157,416,200,0,32,32,0,0,0,1,13,0
157,352,200,0,32,32,0,0,0,1,12,0
157,384,200,0,32,32,0,0,0,1,11,0
157,96,200,0,32,32,0,0,0,1,10,0
157,128,200,0,32,32,0,0,0,1,9,0
157,160,200,0,32,32,0,0,0,1,8,0
157,192,200,0,32,32,0,0,0,1,7,0
157,224,200,0,32,32,0,0,0,1,6,0
157,256,200,0,32,32,0,0,0,1,5,0
157,288,200,0,32,32,0,0,0,1,4,0
157,320,200,0,32,32,0,0,0,1,3,0
1234567890
25,560,304,32,32,160,96,10002,0,0,0,0
25,560,304,32,32,224,96,10002,0,0,0,0
25,560,304,32,32,192,96,10002,0,0,0,0
25,560,304,32,32,304,96,10002,0,0,0,0
25,560,304,32,32,256,96,10002,0,0,0,0
25,560,304,32,32,352,96,10002,0,0,0,0
25,560,304,32,32,528,96,10002,0,0,0,0
25,560,304,32,32,496,96,10002,0,0,0,0
25,560,304,32,32,464,96,10002,0,0,0,0
25,560,304,32,32,432,96,10002,0,0,0,0
25,560,304,32,32,400,96,10002,0,0,0,0
25,560,304,32,32,560,96,10002,0,0,0,0
25,560,304,32,32,592,96,10002,0,0,0,0
25,560,304,32,32,624,96,10002,0,0,0,0
25,560,304,32,32,464,128,10002,0,0,0,0
25,560,304,32,32,496,128,10002,0,0,0,0
25,560,304,32,32,528,128,10002,0,0,0,0
25,560,304,32,32,560,128,10002,0,0,0,0
25,560,304,32,32,592,128,10002,0,0,0,0
25,560,304,32,32,624,128,10002,0,0,0,0
25,560,304,32,32,432,128,10002,0,0,0,0
25,560,304,32,32,400,128,10002,0,0,0,0
25,560,304,32,32,368,128,10002,0,0,0,0
25,560,304,32,32,336,128,10002,0,0,0,0
25,560,304,32,32,304,128,10002,0,0,0,0
25,560,304,32,32,272,128,10002,0,0,0,0
25,560,304,32,32,224,128,10002,0,0,0,0
25,560,304,32,32,192,128,10002,0,0,0,0
25,560,304,32,32,160,128,10002,0,0,0,0
987654321
MwAvQgc3STolPGRCPwtJM1FtOhkPX3ED

