UVx6TlN0AGU9Z1gdAUdPEmYjSlVoBDRlP3xNOQNsICY7Ljwjcn1hMzp/cUNiVSc2HGgkO182bg==
158,128,280,0,1,16777215,0,1,0,1,6,0
160,24,304,0,0,16777215,0,0,0,1,49,0
195,64,224,0,0,128,270,0,61,1,62,0
123,24,160,0,128,16777215,0,0,0,1,63,0
123,264,192,0,128,16777215,0,0,0,1,79,0
123,56,248,0,128,16777215,0,0,0,1,95,0
197,424,216,0,2,23,0,0,0,1,22,0
197,72,280,0,2,86,0,0,0,1,85,0
197,432,312,0,2,52,0,0,0,1,48,0
197,464,216,0,2,17,0,0,0,1,19,0
197,344,88,0,2,39,0,0,0,1,42,0
197,392,88,0,2,38,0,0,0,1,44,0
197,408,88,0,2,35,0,0,0,1,43,0
197,424,88,0,2,37,0,0,0,1,46,0
197,440,88,0,2,36,0,0,0,1,47,0
189,240,160,0,0,128,271,0,0,1,76,0
186,64,56,0,0,0,0,0,0,1,64,0
186,288,88,0,0,0,0,0,0,1,34,0
154,496,258.67,0,2,0.50,32,32,1,1,17,1
154,388.51,239.80,0,1,0.50,32,32,1,1,10,1
157,0,168,0,32,32,0,0,0,1,92,0
157,56,96,0,32,32,0,0,0,1,91,0
157,104,104,0,32,32,0,0,0,1,88,0
157,176,160,0,32,32,0,0,0,1,87,0
157,8,328,0,32,32,0,0,0,1,60,0
157,24,328,0,32,32,0,0,0,1,59,0
157,56,328,0,32,32,0,0,0,1,58,0
157,88,72,0,32,32,0,0,0,1,57,0
157,88,104,0,32,32,0,0,0,1,56,0
157,88,136,0,32,32,0,0,0,1,55,0
157,88,168,0,32,32,0,0,0,1,54,0
157,88,200,0,32,32,0,0,0,1,53,0
157,88,232,0,32,32,0,0,0,1,51,0
157,88,296,0,32,32,0,0,0,1,50,0
157,320,8,0,32,32,0,0,0,1,41,0
157,320,40,0,32,32,0,0,0,1,40,0
157,264,104,0,32,32,0,0,0,1,33,0
157,280,104,0,32,32,0,0,0,1,32,0
157,312,104,0,32,32,0,0,0,1,31,0
157,344,104,0,32,32,0,0,0,1,30,0
157,376,104,0,32,32,0,0,0,1,29,0
157,408,104,0,32,32,0,0,0,1,28,0
157,512,168,0,32,32,0,0,0,1,27,0
157,440,104,0,32,32,0,0,0,1,26,0
157,440,136,0,32,32,0,0,0,1,25,0
157,440,168,0,32,32,0,0,0,1,24,0
157,424,328,0,32,32,0,0,0,1,21,0
157,456,328,0,32,32,0,0,0,1,20,0
157,464,232,0,32,32,0,0,0,1,13,0
157,432,232,0,32,32,0,0,0,1,12,0
157,120,296,0,32,32,0,0,0,1,5,0
157,152,296,0,32,32,0,0,0,1,4,0
157,184,296,0,32,32,0,0,0,1,3,0
157,216,296,0,32,32,0,0,0,1,2,0
169,104,200,0,0,0,0,0,0,0,86,1
169,80,248,0,0,0,0,0,0,1,52,1
169,312,56,0,0,0,0,0,0,1,39,1
169,352,24,0,0,0,0,0,0,1,38,1
169,368,24,0,0,0,0,0,0,1,37,1
169,368,56,0,0,0,0,0,0,1,36,1
169,352,56,0,0,0,0,0,0,1,35,1
169,432,184,0,0,0,0,0,0,1,23,1
166,32,72,0,0,0,271,0,0,0,61,1
155,496,232,0,2,2,0,0,0,1,16,0
155,496,336,0,1,2,0,0,0,1,15,0
155,408,232,0,2,1,0,0,0,1,9,0
155,248,296,0,1,1,0,0,0,1,8,0
1234567890
25,144,112,16,32,480,304,10002,0,0,0,0
25,144,112,16,32,496,304,10002,0,0,0,0
25,144,112,16,32,496,272,10002,0,0,0,0
25,144,112,16,32,480,272,10002,0,0,0,0
25,144,112,16,32,480,240,10002,0,0,0,0
25,144,112,16,32,496,240,10002,0,0,0,0
25,144,112,16,32,480,208,10002,0,0,0,0
25,144,112,16,32,496,208,10002,0,0,0,0
25,144,112,16,32,240,272,10002,0,0,0,0
25,144,112,16,32,256,272,10002,0,0,0,0
25,144,112,16,32,272,256,10002,0,0,0,0
25,144,112,16,32,288,256,10002,0,0,0,0
25,144,112,16,32,304,240,10002,0,0,0,0
25,144,112,16,32,320,240,10002,0,0,0,0
25,144,112,16,32,336,224,10002,0,0,0,0
25,144,112,16,32,352,224,10002,0,0,0,0
25,144,112,16,32,368,208,10002,0,0,0,0
25,144,112,16,32,384,208,10002,0,0,0,0
25,144,112,16,32,400,192,10002,0,0,0,0
25,144,112,16,32,416,192,10002,0,0,0,0
25,160,128,16,16,272,288,10002,0,0,0,0
25,160,128,16,16,304,272,10002,0,0,0,0
25,160,128,16,16,336,256,10002,0,0,0,0
25,160,128,16,16,368,240,10002,0,0,0,0
25,160,128,16,16,400,224,10002,0,0,0,0
25,160,112,16,16,288,288,10002,0,0,0,0
25,160,112,16,16,320,272,10002,0,0,0,0
25,160,112,16,16,352,256,10002,0,0,0,0
25,160,112,16,16,384,240,10002,0,0,0,0
987654321
MwAvQgc3STolPGRCPwtJM1FtOhkPX3ED

