UVx6TlN0AGU9Z1gdAUdPEmYjSlVoBDRlP3xNOQNsIDE3Ky04V3V/MS1hbV9+STsqAHQ4J0Mqcic=
160,64,272,0,0,16777215,0,0,0,1,10,0
158,136,280,0,1,16777215,0,1,0,1,9,0
100,384,336,0,256,16777215,0,0,0,1,73,0
123,398,109,0,128,16777215,0,0,0,1,84,0
218,272,64,0,256,16777215,0,0,0,1,70,0
197,480,216,0,2,0,0,0,0,1,75,0
197,296,56,0,2,177,0,0,0,1,67,0
174,448,336,0,1,71,0,0,0,0,72,1
174,360,88,0,1,69,0,0,0,0,68,1
174,368,287,0,1,94,0,0,0,0,74,1
316,224,256,0,0,1,0,0,0,1,3,0
205,455.89,336,0,1,0,0.50,0,0,1,71,0
205,381.62,184,0,1,0,0.50,0,0,1,94,0
308,192,136,0,0,128,0,0,0,1,33,0
205,330.35,56,0,1,0,0.50,0,0,1,69,0
308,32,72,0,0,128,0,0,0,1,49,0
186,272,240,0,0,0,0,0,0,1,89,0
188,248,240,0,0,87,86,0,0,1,88,0
188,224,272,0,0,13,58,57,56,1,8,0
185,288,296,0,0,32,-1,0,0,1,21,0
154,134.00,128,0,1,0.50,32,32,1,1,43,1
157,312,256,0,32,32,0,0,0,1,91,0
157,280,256,0,32,32,0,0,0,1,90,0
157,360,200,0,32,32,0,0,0,1,85,0
157,480,128,0,32,32,0,0,0,1,82,0
157,496,128,0,32,32,0,0,0,1,81,0
157,528,128,0,32,32,0,0,0,1,80,0
157,552,160,0,32,32,0,0,0,1,79,0
157,568,192,0,32,32,0,0,0,1,78,0
157,568,224,0,32,32,0,0,0,1,77,0
157,576,256,0,32,32,0,0,0,1,76,0
157,432,40,0,32,32,0,0,0,1,66,0
157,456,72,0,32,32,0,0,0,1,65,0
157,424,168,0,32,32,0,0,0,1,64,0
157,456,104,0,32,32,0,0,0,1,63,0
157,312,136,0,32,32,0,0,0,1,62,0
157,344,104,0,32,32,0,0,0,1,61,0
157,248,96,0,32,32,0,0,0,1,60,0
157,248,128,0,32,32,0,0,0,1,59,0
157,456,136,0,32,32,0,0,0,1,55,0
157,456,168,0,32,32,0,0,0,1,54,0
157,312,104,0,32,32,0,0,0,1,53,0
157,336,72,0,32,32,0,0,0,1,52,0
157,304,72,0,32,32,0,0,0,1,51,0
157,272,64,0,32,32,0,0,0,1,50,0
157,240,88,0,32,32,0,0,0,1,48,0
157,208,72,0,32,32,0,0,0,1,47,0
157,176,72,0,32,32,0,0,0,1,46,0
157,144,96,0,32,32,0,0,0,1,45,0
157,392,200,0,32,32,0,0,0,1,39,0
157,424,200,0,32,32,0,0,0,1,38,0
157,456,200,0,32,32,0,0,0,1,37,0
157,488,232,0,32,32,0,0,0,1,36,0
157,520,256,0,32,32,0,0,0,1,35,0
157,584,288,0,32,32,0,0,0,1,34,0
157,344,272,0,32,32,0,1,0,1,32,0
157,168,160,0,32,32,0,0,0,1,31,0
157,552,320,0,32,32,0,0,0,1,30,0
157,552,352,0,32,32,0,0,0,1,29,0
157,520,352,0,32,32,0,0,0,1,28,0
157,488,352,0,32,32,0,0,0,1,27,0
157,456,352,0,32,32,0,0,0,1,26,0
157,416,304,0,32,32,0,0,0,1,25,0
157,384,304,0,32,32,0,0,0,1,24,0
157,352,304,0,32,32,0,0,0,1,23,0
157,320,304,0,32,32,0,0,0,1,22,0
157,288,304,0,32,32,0,0,0,1,20,0
157,256,304,0,32,32,0,0,0,1,19,0
157,72,192,0,32,32,0,1,0,1,18,0
157,104,160,0,32,32,0,0,0,1,17,0
157,136,160,0,32,32,0,0,0,1,16,0
157,168,192,0,32,32,0,0,0,1,15,0
157,184,256,0,32,32,0,0,0,1,14,0
157,208,296,0,32,32,0,0,0,1,12,0
157,176,296,0,32,32,0,0,0,1,11,0
157,224,224,0,32,32,0,0,0,1,7,0
157,248,256,0,32,32,0,0,0,1,6,0
157,200,256,0,32,32,0,0,0,1,5,0
157,224,288,0,32,32,0,0,0,1,4,0
157,112,296,0,32,32,0,0,0,1,2,0
157,144,296,0,32,32,0,0,0,1,175,0
169,320,152,0,0,0,0,0,0,0,177,1
169,336,120,0,0,0,0,0,0,1,87,1
169,336,152,0,0,0,0,0,0,1,86,1
169,184,208,0,0,0,0,0,0,1,58,1
169,184,176,0,0,0,0,0,0,1,57,1
169,184,144,0,0,0,0,0,0,1,56,1
169,168,208,0,0,0,0,0,0,1,13,1
155,152,128,0,2,1,0,0,0,1,42,0
155,72,128,0,1,1,0,0,0,1,41,0
1234567890
24,464,112,32,16,352,160,10000,0,0,0,0
24,464,192,32,16,464,320,10000,0,0,0,0
24,432,208,16,16,448,272,10000,0,0,0,0
24,432,208,16,16,368,112,10000,0,0,0,0
24,432,208,16,16,352,32,10000,0,0,0,0
24,384,0,16,16,368,32,10000,0,0,0,0
24,368,0,16,16,368,128,10000,0,0,0,0
24,368,0,16,16,464,272,10000,0,0,0,0
24,0,256,64,32,384,224,10000,0,0,0,0
24,464,80,32,32,400,256,10000,0,0,0,0
24,464,112,32,16,368,272,10000,0,0,0,0
24,464,144,32,16,288,224,10000,0,0,0,0
24,496,0,64,32,288,32,10000,0,0,0,0
24,496,0,64,32,208,176,10000,0,0,0,0
24,0,160,96,32,464,80,10000,0,0,0,0
24,0,160,96,32,464,48,10000,0,0,0,0
24,0,160,96,32,448,16,10000,0,0,0,0
35,336,256,48,48,16,272,10002,0,0,0,0
35,384,256,16,48,64,272,10002,0,0,0,0
35,384,256,16,48,80,272,10002,0,0,0,0
35,432,304,32,48,0,224,10002,0,0,0,0
35,432,304,32,48,0,176,10002,0,0,0,0
35,432,304,32,48,0,128,10002,0,0,0,0
35,464,320,32,32,544,272,10002,0,0,0,0
36,0,208,16,16,528,288,10002,0,0,0,0
36,0,208,16,16,528,272,10002,0,0,0,0
36,0,208,16,16,512,272,10002,0,0,0,0
36,0,208,16,16,512,288,10002,0,0,0,0
987654321
MwAvQgc3STolPGRCPwtJM1FtOhkPX3ED

