VVh6UkxxBnkpcyF7YHlBOHwedGlDOCpGPkNuIn9sMVkWKz00fEN+JCMaLz8gFnBoSTdnO142bjs3Bil2JjlZMV4=
160,1048,352,0,0,16777215,0,0,0,1,137,0
158,64,56,0,1,16777215,0,1,0,1,21,0
123,1042,40,0,128,16777215,0,0,0,1,136,0
195,1312,72,0,0,128,271,0,198,1,135,0
195,1456,8,0,0,128,271,0,193,1,306,0
195,1424,8,0,0,128,270,0,193,1,305,0
123,1488,48,0,128,16777215,0,0,0,1,307,0
197,1041,112,0,1,312,0,0,0,1,298,0
197,1440,88,0,2,0,0,0,0,1,303,0
197,1576,288,0,10,198,0,0,0,1,190,0
197,1600,288,0,1,0,0,0,0,1,192,0
197,1696,256,0,10,193,0,0,0,1,191,0
174,352,344,0,1,287,0,0,0,0,288,1
174,1552,288,0,1,138,0,0,0,0,189,1
174,1344,304,0,1,210,207,208,0,0,213,1
174,1432,344,0,1,209,0,0,0,0,218,1
174,320,344,0,1,286,285,284,283,0,282,1
174,336,343,0,1,260,262,261,264,0,259,1
308,1408,128,0,0,128,271,0,0,1,167,0
205,224,288,0,1,0,0.50,0,0,1,2,0
205,384,232,0,-1,0,0.50,0,0,1,8,0
205,383.78,232,0,1,0,0.50,0,0,1,9,0
205,264,168,0,-1,0,0.50,0,0,1,4,0
205,368,232,0,1,0,0.50,0,0,1,5,0
205,408,232,0,1,0,0.50,0,0,1,7,0
308,1496,128,0,0,128,271,0,0,1,170,0
186,944,176,0,0,0,0,0,0,1,111,0
304,160,224,0,270,0,0,0,0,1,68,0
304,144,224,0,270,0,0,0,0,1,67,0
186,104,280,0,0,0,0,0,0,1,41,0
186,104,328,0,0,0,0,0,0,1,6,0
188,632,344,0,0,0,115,118,119,1,112,0
154,1040,128,0,3,1.90,32,32,1,1,314,1
154,777.76,192,0,2,0.90,32,32,1,1,230,1
154,1562.26,114.68,0,4,0.50,32,32,1,1,187,1
154,23.98,72,0,1,0.50,32,32,1,1,16,1
210,1080,360,0,325,0,0,0,0,1,324,0
210,1032,272,0,0,270,0,0,0,1,325,0
210,1008,80,0,0,0,0,0,0,1,130,0
210,264,128,0,0,180,0,0,0,1,37,0
210,136,0,0,251,180,0,0,0,1,24,0
210,224,0,0,0,180,0,0,0,1,29,0
210,264,360,0,37,0,0,0,0,1,36,0
210,416,328,0,59,0,0,0,0,1,58,0
210,752,272,0,236,0,0,0,0,1,235,0
210,616,344,0,0,0,0,0,0,1,236,0
210,568,344,0,100,0,0,0,0,1,101,0
210,928,344,0,130,0,0,0,0,1,129,0
210,104,0,0,0,180,0,0,0,1,27,0
210,160,0,0,0,180,0,0,0,1,28,0
210,512,328,0,0,0,0,0,0,1,59,0
210,224,360,0,29,0,0,0,0,1,25,0
210,104,360,0,27,0,0,0,0,1,23,0
210,696,264,0,101,0,0,0,0,1,100,0
210,344,248,0,24,90,0,0,0,1,251,0
157,1384,40,0,32,32,0,0,0,1,304,0
157,336,216,0,32,32,0,0,0,1,276,0
157,1336,120,0,32,32,0,0,0,1,270,0
157,384,248,0,32,32,0,0,0,1,258,0
157,384,248,0,32,32,0,0,0,1,257,0
157,384,248,0,32,32,0,0,0,1,256,0
157,336,360,0,32,32,0,0,0,1,255,0
157,336,288,0,32,32,0,0,0,1,254,0
157,1248,264,0,32,32,0,0,0,1,242,0
157,1368,8,0,32,32,0,0,0,1,241,0
157,880,112,0,32,32,0,0,0,1,223,0
157,1456,360,0,32,32,0,0,0,1,217,0
157,1440,360,0,32,32,0,0,0,1,216,0
157,1424,360,0,32,32,0,0,0,1,215,0
157,1408,360,0,32,32,0,0,0,1,214,0
157,1312,328,0,32,32,0,0,0,1,212,0
157,1320,336,0,32,32,0,0,0,1,211,0
157,1352,336,0,32,32,0,0,0,1,206,0
157,1360,320,0,32,32,0,0,0,1,205,0
157,1368,304,0,32,32,0,0,0,1,204,0
157,1384,304,0,32,32,0,0,0,1,203,0
157,1432,304,0,32,32,0,0,0,1,202,0
157,1464,304,0,32,32,0,0,0,1,201,0
157,1496,304,0,32,32,0,0,0,1,200,0
157,1528,304,0,32,32,0,0,0,1,199,0
157,1368,168,0,32,32,0,0,0,1,197,0
157,1368,152,0,32,32,0,0,0,1,196,0
157,1368,120,0,32,32,0,0,0,1,195,0
157,1728,48,0,32,32,0,0,0,1,183,0
157,1728,80,0,32,32,0,0,0,1,182,0
157,1728,112,0,32,32,0,0,0,1,181,0
157,1728,144,0,32,32,0,0,0,1,180,0
157,1728,176,0,32,32,0,0,0,1,179,0
157,1728,208,0,32,32,0,0,0,1,178,0
157,1728,240,0,32,32,0,0,0,1,177,0
157,1728,272,0,32,32,0,0,0,1,176,0
157,1696,272,0,32,32,0,0,0,1,175,0
157,1496,104,0,32,32,0,0,0,1,174,0
157,1464,104,0,32,32,0,0,0,1,173,0
157,1432,104,0,32,32,0,0,0,1,172,0
157,1400,104,0,32,32,0,0,0,1,171,0
157,1560,304,0,32,32,0,0,0,1,165,0
157,1584,304,0,32,32,0,0,0,1,164,0
157,1608,304,0,32,32,0,0,0,1,163,0
157,1640,304,0,32,32,0,0,0,1,162,0
157,1664,272,0,32,32,0,0,0,1,161,0
157,1664,176,0,32,32,0,0,0,1,160,0
157,1664,208,0,32,32,0,0,0,1,159,0
157,1664,208,0,32,32,0,0,0,1,158,0
157,1600,240,0,32,32,0,1,0,1,157,0
157,1568,240,0,32,32,0,1,0,1,156,0
157,1536,240,0,32,32,0,1,0,1,155,0
157,1504,240,0,32,32,0,1,0,1,154,0
157,1472,240,0,32,32,0,1,0,1,153,0
157,1440,240,0,32,32,0,1,0,1,152,0
157,1408,240,0,32,32,0,1,0,1,151,0
157,1376,240,0,32,32,0,1,0,1,150,0
157,1344,232,0,32,32,0,0,0,1,149,0
157,1312,232,0,32,32,0,0,0,1,148,0
157,1280,232,0,32,32,0,0,0,1,146,0
157,1280,328,0,32,32,0,0,0,1,145,0
157,1248,328,0,32,32,0,0,0,1,144,0
157,1080,8,0,32,32,0,0,0,1,134,0
157,1080,40,0,32,32,0,0,0,1,133,0
157,1080,64,0,32,32,0,0,0,1,132,0
157,1080,88,0,32,32,0,0,0,1,131,0
157,968,200,0,32,32,0,0,0,1,128,0
157,968,232,0,32,32,0,0,0,1,127,0
157,968,264,0,32,32,0,0,0,1,126,0
157,968,296,0,32,32,0,0,0,1,125,0
157,968,328,0,32,32,0,0,0,1,124,0
157,968,360,0,32,32,0,0,0,1,123,0
157,944,360,0,32,32,0,0,0,1,122,0
157,912,360,0,32,32,0,0,0,1,121,0
157,880,360,0,32,32,0,0,0,1,120,0
157,552,288,0,32,32,0,0,0,1,113,0
157,888,64,0,32,32,0,0,0,1,110,0
157,920,64,0,32,32,0,0,0,1,109,0
157,952,64,0,32,32,0,0,0,1,108,0
157,984,64,0,32,32,0,0,0,1,107,0
157,1008,96,0,32,32,0,0,0,1,106,0
157,1008,128,0,32,32,0,0,0,1,105,0
157,1008,160,0,32,32,0,0,0,1,104,0
157,976,192,0,32,32,0,0,0,1,103,0
157,944,192,0,32,32,0,0,0,1,102,0
157,672,360,0,32,32,0,0,0,1,99,0
157,576,360,0,32,32,0,0,0,1,98,0
157,608,360,0,32,32,0,0,0,1,97,0
157,640,360,0,32,32,0,0,0,1,96,0
157,880,96,0,32,32,0,0,0,1,95,0
157,912,192,0,32,32,0,0,0,1,93,0
157,880,192,0,32,32,0,0,0,1,92,0
157,696,280,0,32,32,0,0,0,1,91,0
157,720,288,0,32,32,0,0,0,1,90,0
157,752,288,0,32,32,0,0,0,1,89,0
157,784,288,0,32,32,0,0,0,1,88,0
157,816,288,0,32,32,0,0,0,1,87,0
157,848,288,0,32,32,0,0,0,1,86,0
157,880,288,0,32,32,0,0,0,1,85,0
157,880,256,0,32,32,0,0,0,1,84,0
157,880,224,0,32,32,0,0,0,1,82,0
157,672,256,0,32,32,0,0,0,1,76,0
157,592,248,0,32,32,0,0,0,1,75,0
157,672,264,0,32,32,0,0,0,1,74,0
157,624,248,0,32,32,0,0,0,1,73,0
157,112,96,0,32,32,0,0,0,1,71,0
157,16,0,0,32,32,0,0,0,1,69,0
157,512,40,0,32,32,0,0,0,1,65,0
157,512,72,0,32,32,0,0,0,1,64,0
157,512,104,0,32,32,0,0,0,1,63,0
157,560,272,0,32,32,0,0,0,1,62,0
157,544,320,0,32,32,0,0,0,1,61,0
157,480,328,0,32,32,0,0,0,1,57,0
157,512,344,0,32,32,0,0,0,1,56,0
157,416,344,0,32,32,0,0,0,1,55,0
157,448,328,0,32,32,0,0,0,1,54,0
157,472,296,0,32,32,0,0,0,1,53,0
157,496,264,0,32,32,0,0,0,1,52,0
157,504,232,0,32,32,0,0,0,1,50,0
157,512,136,0,32,32,0,0,0,1,49,0
157,512,168,0,32,32,0,0,0,1,48,0
157,512,200,0,32,32,0,0,0,1,47,0
157,456,200,0,32,32,0,0,0,1,46,0
157,424,216,0,32,32,0,0,0,1,45,0
157,424,248,0,32,32,0,0,0,1,44,0
157,360,240,0,32,32,0,0,0,1,43,0
157,392,248,0,32,32,0,0,0,1,42,0
157,288,144,0,32,32,0,0,0,1,40,0
157,288,176,0,32,32,0,0,0,1,39,0
157,288,208,0,32,32,0,0,0,1,38,0
157,312,184,0,16,200,0,0,0,1,34,0
157,256,112,0,32,32,0,0,0,1,33,0
157,256,56,0,32,32,0,0,0,1,32,0
157,248,144,0,16,200,0,0,0,1,31,0
157,200,168,0,16,200,0,0,0,1,30,0
157,184,168,0,16,200,0,0,0,1,20,0
157,136,176,0,16,200,0,0,0,1,19,0
157,56,72,0,32,32,0,0,0,1,18,0
157,72,72,0,32,32,0,0,0,1,10,0
157,0,72,0,32,32,0,0,0,1,11,0
169,1456,120,0,0,0,0,0,0,1,293,1
172,1472,136,0,0,0,0,0,0,0,264,1
172,368,328,0,0,0,0,0,0,1,287,1
169,368,264,0,0,0,0,0,0,1,286,1
169,384,264,0,0,0,0,0,0,1,285,1
169,368,296,0,0,0,0,0,0,1,284,1
169,384,296,0,0,0,0,0,0,1,283,1
169,1416,120,0,0,0,0,0,0,0,262,1
169,1504,120,0,0,0,0,0,0,0,261,1
172,1384,136,0,0,0,0,0,0,0,260,1
169,1264,280,0,0,0,0,0,0,1,210,1
169,1312,280,0,0,0,0,0,0,1,209,1
169,1296,280,0,0,0,0,0,0,1,208,1
169,1280,280,0,0,0,0,0,0,1,207,1
169,1352,184,0,0,0,0,0,0,0,198,1
169,1384,56,0,0,0,0,0,0,1,193,1
172,800,344,0,0,0,0,0,0,0,119,1
172,744,344,0,0,0,0,0,0,0,118,1
172,704,360,0,0,0,0,0,0,0,117,1
172,704,360,0,0,0,0,0,0,0,116,1
172,688,344,0,0,0,0,0,0,0,115,1
237,320,0,0,16777215,300,0,0,0,1,271,0
166,1032,176,0,0,0,312,0,0,1,138,1
155,1216,264,0,3,3,0,0,0,0,319,0
155,1120,232,0,2,3,0,0,0,1,313,0
155,1040,128,0,1,3,0,0,0,0,312,0
155,712,192,0,2,2,0,0,0,1,229,0
155,848,192,0,1,2,0,0,0,1,228,0
155,1616,144,0,2,4,0,0,0,1,186,0
155,1528,96,0,1,4,0,0,0,1,185,0
155,40,72,0,2,1,0,0,0,1,15,0
155,24,72,0,1,1,0,0,0,1,14,0
1234567890
24,320,192,32,32,528,208,10000,0,0,0,0
24,320,192,32,32,448,224,10000,0,0,0,0
24,64,256,32,32,432,144,10000,0,0,0,0
36,0,208,16,16,528,272,10002,0,0,0,0
36,0,208,16,16,512,272,10002,0,0,0,0
36,0,208,16,16,496,272,10002,0,0,0,0
36,0,208,16,16,480,272,10002,0,0,0,0
39,592,0,48,64,528,144,10000,0,0,0,0
36,0,208,16,16,544,272,10002,0,0,0,0
36,0,208,16,16,864,160,10002,0,0,0,0
36,0,208,16,16,880,160,10002,0,0,0,0
36,0,208,16,16,880,144,10002,0,0,0,0
36,0,208,16,16,864,144,10002,0,0,0,0
36,0,208,16,16,640,256,10002,0,0,0,0
36,0,208,16,16,640,272,10002,0,0,0,0
36,0,208,16,16,640,288,10002,0,0,0,0
24,464,64,32,16,640,224,10000,0,0,0,0
24,464,64,32,16,672,224,10000,0,0,0,0
24,464,64,32,16,624,240,10000,0,0,0,0
24,464,64,32,16,512,256,10000,0,0,0,0
24,464,64,32,16,544,240,10000,0,0,0,0
24,464,64,32,16,576,208,10000,0,0,0,0
24,464,64,32,16,608,192,10000,0,0,0,0
24,464,64,32,16,592,240,10000,0,0,0,0
36,0,208,16,16,1408,288,10002,0,0,0,0
36,0,208,16,16,1392,288,10002,0,0,0,0
36,0,208,16,16,1392,304,10002,0,0,0,0
36,0,208,16,16,1408,304,10002,0,0,0,0
36,0,208,16,16,864,128,10002,0,0,0,0
36,0,208,16,16,880,128,10002,0,0,0,0
987654321
MwAvQgc3STolPGRCPwtJM1FtOhkPX3ED

