UV18TldyBGU9Z1gfN218DGYKTlMfPARFRDg7K1YwaBolCTgjcXFjJWRjbV9+STsqAHQ4J0Mq
160,416,72,0,0,16777215,0,0,0,1,250,0
158,96,80,0,1,16777215,0,1,0,1,17,0
123,552,248,0,128,16777215,0,0,0,1,96,0
195,208,496,0,0,128,258,0,194,1,187,0
100,272,416,0,256,16777215,0,0,0,1,228,0
100,136,504,0,256,16777215,0,333,0,1,188,0
100,264,280,0,256,16777215,0,0,0,1,151,0
197,272,656,0,1,211,0,0,0,1,209,0
174,88,440,0,1,131,130,0,0,0,129,1
174,120,168,0,1,0,0,0,0,0,16,1
174,104,168,0,1,71,70,0,0,0,74,1
174,104,624,0,1,200,0,0,0,0,203,1
174,504,464,0,1,230,229,0,0,0,233,1
167,448,184,0,128,270,0,0,0,1,93,0
205,287.25,440,0,1,0,0.50,0,0,1,152,0
308,328,24,0,0,128,230,0,0,1,54,0
308,352,24,0,0,128,203,0,0,1,53,0
308,8.50,24,0,0,128,271,0,0,1,52,0
219,152,592,0,32,32,0,0,0,1,200,1
219,600,232,0,32,32,0,0,0,1,221,1
219,216,608,0,32,32,0,0,0,1,202,1
219,184,576,0,32,32,0,0,0,1,201,1
186,104,216,0,0,0,0,0,0,1,73,0
188,456,448,0,0,164,165,0,0,1,163,0
185,176,232,0,0,32,1,0,0,1,84,0
154,384,464,0,7,0.50,32,32,1,1,231,1
154,320,672,0,6,0.50,32,32,1,1,213,1
154,160.44,562.81,0,5,0.50,32,32,1,1,185,1
154,350.19,342.94,0,4,0.50,32,32,1,1,149,1
154,556.20,224,0,3,0.50,32,32,1,1,100,1
154,466.87,30.98,0,2,0.50,32,32,1,1,40,1
154,275.30,18.35,0,1,0.50,32,32,1,1,14,1
210,592,280,0,242,0,0,0,0,1,241,0
210,48,80,0,0,0,0,0,0,1,242,0
210,104,440,0,128,0,0,0,0,1,127,0
210,168,176,0,0,0,0,0,0,1,128,0
210,32,152,0,50,270,0,0,0,1,51,0
210,608,88,0,51,0,0,0,0,1,50,0
157,352,456,0,32,32,0,0,0,1,227,0
157,320,456,0,32,32,0,0,0,1,226,0
157,288,456,0,32,32,0,0,0,1,225,0
157,592,392,0,32,32,0,0,0,1,224,0
157,592,376,0,32,32,0,0,0,1,223,0
157,592,344,0,32,32,0,0,0,1,222,0
157,624,128,0,32,32,0,0,0,1,220,0
157,624,160,0,32,32,0,0,0,1,219,0
157,624,192,0,32,32,0,0,0,1,218,0
157,568,264,0,32,32,0,0,0,1,217,0
157,288,672,0,32,32,0,0,0,1,208,0
157,256,672,0,32,32,0,0,0,1,207,0
157,224,672,0,32,32,0,0,0,1,206,0
157,192,672,0,32,32,0,0,0,1,205,0
157,160,640,0,32,32,0,0,0,1,204,0
157,128,640,0,32,32,0,0,0,1,199,0
157,96,640,0,32,32,0,0,0,1,198,0
157,64,640,0,32,32,0,0,0,1,197,0
157,40,640,0,32,32,0,0,0,1,196,0
157,24,624,0,32,32,0,0,0,1,195,0
157,112,496,0,32,32,0,0,0,1,193,0
157,112,488,0,32,32,0,0,0,1,192,0
157,56,560,0,32,32,0,0,0,1,191,0
157,88,560,0,32,32,0,0,0,1,190,0
157,120,560,0,32,32,0,0,0,1,189,0
157,232,480,0,32,32,0,0,0,1,182,0
157,232,512,0,32,32,0,0,0,1,181,0
157,232,544,0,32,32,0,0,0,1,180,0
157,248,576,0,32,32,0,0,0,1,179,0
157,200,472,0,32,32,0,0,0,1,177,0
157,144,481,0,32,32,0,0,0,1,176,0
157,192,440,0,32,32,0,0,0,1,175,0
157,224,432,0,32,32,0,0,0,1,174,0
157,256,424,0,32,32,0,0,0,1,173,0
157,256,392,0,32,32,0,0,0,1,172,0
157,176,360,0,32,32,0,0,0,1,171,0
157,208,360,0,32,32,0,0,0,1,170,0
157,272,360,0,32,32,0,0,0,1,169,0
157,240,360,0,32,32,0,0,0,1,168,0
157,400,496,0,32,32,0,0,0,1,161,0
157,416,464,0,32,32,0,0,0,1,160,0
157,448,464,0,32,32,0,0,0,1,159,0
157,480,480,0,32,32,0,0,0,1,158,0
157,512,480,0,32,32,0,0,0,1,157,0
157,544,480,0,32,32,0,0,0,1,156,0
157,576,456,0,32,32,0,0,0,1,155,0
157,592,424,0,32,32,0,0,0,1,154,0
157,520,408,0,32,32,0,0,0,1,153,0
157,384,496,0,32,32,0,0,0,1,145,0
157,488,408,0,32,32,0,0,0,1,144,0
157,528,312,0,32,32,0,0,0,1,143,0
157,560,312,0,32,32,0,0,0,1,142,0
157,584,296,0,32,32,0,0,0,1,141,0
157,424,232,0,32,32,0,0,0,1,137,0
157,456,232,0,32,32,0,0,0,1,136,0
157,488,232,0,32,32,0,0,0,1,135,0
157,112,392,0,32,32,0,0,0,1,126,0
157,136,424,0,32,32,0,0,0,1,125,0
157,120,456,0,32,32,0,0,0,1,124,0
157,88,456,0,32,32,0,0,0,1,123,0
157,56,456,0,32,32,0,0,0,1,122,0
157,32,424,0,32,32,0,0,0,1,121,0
157,80,392,0,32,32,0,0,0,1,120,0
157,16,392,0,32,32,0,0,0,1,119,0
157,16,360,0,32,32,0,0,0,1,118,0
157,80,360,0,32,32,0,0,0,1,117,0
157,16,328,0,32,32,0,0,0,1,116,0
157,16,264,0,32,32,0,0,0,1,112,0
157,16,296,0,32,32,0,0,0,1,111,0
157,80,328,0,32,32,0,0,0,1,110,0
157,80,296,0,32,32,0,0,0,1,109,0
157,112,296,0,32,32,0,0,0,1,108,0
157,144,296,0,32,32,0,0,0,1,107,0
157,176,296,0,32,32,0,0,0,1,106,0
157,208,296,0,32,32,0,0,0,1,105,0
157,240,296,0,32,32,0,0,0,1,104,0
157,240,264,0,32,32,0,0,0,1,103,0
157,240,232,0,32,32,0,0,0,1,102,0
157,504,200,0,32,32,0,0,0,1,95,0
157,400,128,0,32,32,0,0,0,1,94,0
157,400,200,0,32,32,0,0,0,1,92,0
157,368,200,0,32,32,0,0,0,1,91,0
157,336,200,0,32,32,0,0,0,1,90,0
157,304,200,0,32,32,0,0,0,1,89,0
157,272,200,0,32,32,0,0,0,1,88,0
157,240,200,0,32,32,0,0,0,1,87,0
157,184,200,0,32,32,0,0,0,1,86,0
157,176,200,0,32,32,0,0,0,1,85,0
157,16,232,0,32,32,0,0,0,1,81,0
157,48,232,0,32,32,0,0,0,1,80,0
157,80,232,0,32,32,0,0,0,1,79,0
157,112,232,0,32,32,0,0,0,1,78,0
157,144,232,0,32,32,0,0,0,1,77,0
157,80,168,0,32,32,0,0,0,1,72,0
157,144,136,0,32,32,0,0,0,1,69,0
157,144,200,0,32,32,0,0,0,1,67,0
157,112,200,0,32,32,0,0,0,1,66,0
157,80,200,0,32,32,0,0,0,1,65,0
157,48,200,0,32,32,0,0,0,1,64,0
157,16,200,0,32,32,0,0,0,1,63,0
157,16,168,0,32,32,0,0,0,1,62,0
157,16,136,0,32,32,0,0,0,1,61,0
157,376,24,0,32,32,0,0,0,1,58,0
157,352,0,0,32,32,0,0,0,1,57,0
157,8,0,0,32,32,0,0,0,1,56,0
157,520,0,0,32,32,0,0,0,1,55,0
157,640,80,0,32,32,0,0,0,1,49,0
157,640,64,0,32,32,0,0,0,1,48,0
157,640,48,0,32,32,0,0,0,1,47,0
157,640,32,0,32,32,0,0,0,1,46,0
157,632,16,0,32,32,0,0,0,1,45,0
157,600,16,0,32,32,0,0,0,1,44,0
157,568,8,0,32,32,0,0,0,1,43,0
157,568,40,0,32,32,0,0,0,1,42,0
157,472,72,0,32,32,0,0,0,1,36,0
157,440,96,0,32,32,0,0,0,1,35,0
157,408,96,0,32,32,0,0,0,1,34,0
157,376,96,0,32,32,0,0,0,1,33,0
157,344,96,0,32,32,0,0,0,1,32,0
157,312,96,0,32,32,0,0,0,1,31,0
157,136,96,0,32,32,0,0,0,1,10,0
157,104,96,0,32,32,0,0,0,1,9,0
157,72,96,0,32,32,0,0,0,1,8,0
157,40,96,0,32,32,0,0,0,1,7,0
157,632,104,0,32,32,0,1,0,1,6,0
157,608,104,0,32,32,0,1,0,1,5,0
157,496,104,0,200,32,0,1,0,1,3,0
157,296,104,0,200,32,0,1,0,1,2,0
157,96,104,0,200,32,0,1,0,1,29,0
169,104,512,0,0,0,0,0,0,0,194,1
172,224,312,0,0,0,0,0,0,1,165,1
172,224,328,0,0,0,0,0,0,1,164,1
169,384,144,0,0,0,0,0,0,1,131,1
169,400,144,0,0,0,0,0,0,1,130,1
169,128,152,0,0,0,0,0,0,1,71,1
169,144,152,0,0,0,0,0,0,1,70,1
155,384,456,0,2,7,0,0,0,0,230,0
155,384,464,0,1,7,0,0,0,0,229,0
155,640,368,0,4,6,0,0,0,1,216,0
155,632,488,0,3,6,0,0,0,1,215,0
155,560,592,0,2,6,0,0,0,1,212,0
155,320,672,0,1,6,0,0,0,0,211,0
155,200,576,0,2,5,0,0,0,1,184,0
155,152,560,0,1,5,0,0,0,1,183,0
155,456,376,0,2,4,0,0,0,1,148,0
155,328,336,0,1,4,0,0,0,1,147,0
155,600,224,0,2,3,0,0,0,1,99,0
155,552,224,0,1,3,0,0,0,1,98,0
155,408,24,0,2,2,0,0,0,1,39,0
155,544,40,0,1,2,0,0,0,1,38,0
155,280,16,0,2,1,0,0,0,1,13,0
155,168,72,0,1,1,0,0,0,1,12,0
1234567890
36,0,208,16,16,48,176,10002,0,0,0,0
36,0,208,16,16,80,112,10002,0,0,0,0
36,0,208,16,16,64,112,10002,0,0,0,0
36,0,208,16,16,64,128,10002,0,0,0,0
36,0,208,16,16,80,128,10002,0,0,0,0
36,0,208,16,16,112,176,10002,0,0,0,0
36,0,208,16,16,96,176,10002,0,0,0,0
36,0,208,16,16,96,160,10002,0,0,0,0
36,0,208,16,16,112,160,10002,0,0,0,0
36,0,208,16,16,112,144,10002,0,0,0,0
36,0,208,16,16,96,144,10002,0,0,0,0
36,0,208,16,16,208,176,10002,0,0,0,0
36,0,208,16,16,192,176,10002,0,0,0,0
36,0,208,16,16,224,176,10002,0,0,0,0
36,0,208,16,16,176,176,10002,0,0,0,0
36,0,208,16,16,160,176,10002,0,0,0,0
36,0,208,16,16,240,176,10002,0,0,0,0
36,0,208,16,16,256,176,10002,0,0,0,0
36,0,208,16,16,272,176,10002,0,0,0,0
36,0,208,16,16,288,176,10002,0,0,0,0
36,0,208,16,16,304,176,10002,0,0,0,0
36,0,208,16,16,320,176,10002,0,0,0,0
36,0,208,16,16,336,176,10002,0,0,0,0
36,0,208,16,16,352,176,10002,0,0,0,0
36,0,208,16,16,368,176,10002,0,0,0,0
36,0,208,16,16,384,176,10002,0,0,0,0
36,0,208,16,16,400,176,10002,0,0,0,0
36,0,208,16,16,208,192,10002,0,0,0,0
36,0,208,16,16,192,192,10002,0,0,0,0
36,0,208,16,16,208,208,10002,0,0,0,0
36,0,208,16,16,192,208,10002,0,0,0,0
36,0,208,16,16,208,224,10002,0,0,0,0
36,0,208,16,16,192,224,10002,0,0,0,0
36,0,208,16,16,208,240,10002,0,0,0,0
36,0,208,16,16,192,240,10002,0,0,0,0
36,0,208,16,16,208,256,10002,0,0,0,0
36,0,208,16,16,192,256,10002,0,0,0,0
36,0,208,16,16,176,240,10002,0,0,0,0
36,0,208,16,16,176,256,10002,0,0,0,0
36,0,208,16,16,160,256,10002,0,0,0,0
36,0,208,16,16,160,240,10002,0,0,0,0
36,0,208,16,16,208,272,10002,0,0,0,0
36,0,208,16,16,192,272,10002,0,0,0,0
36,0,208,16,16,160,272,10002,0,0,0,0
36,0,208,16,16,176,272,10002,0,0,0,0
36,0,208,16,16,144,272,10002,0,0,0,0
36,0,208,16,16,112,272,10002,0,0,0,0
36,0,208,16,16,128,272,10002,0,0,0,0
36,0,208,16,16,144,240,10002,0,0,0,0
36,0,208,16,16,144,256,10002,0,0,0,0
36,0,208,16,16,128,240,10002,0,0,0,0
36,0,208,16,16,128,256,10002,0,0,0,0
36,0,208,16,16,112,256,10002,0,0,0,0
36,0,208,16,16,112,240,10002,0,0,0,0
36,0,208,16,16,96,240,10002,0,0,0,0
36,0,208,16,16,96,256,10002,0,0,0,0
36,0,208,16,16,96,272,10002,0,0,0,0
36,0,208,16,16,80,272,10002,0,0,0,0
36,0,208,16,16,64,272,10002,0,0,0,0
36,0,208,16,16,48,272,10002,0,0,0,0
36,0,208,16,16,32,272,10002,0,0,0,0
36,0,208,16,16,32,256,10002,0,0,0,0
36,0,208,16,16,32,240,10002,0,0,0,0
36,0,208,16,16,48,240,10002,0,0,0,0
36,0,208,16,16,48,256,10002,0,0,0,0
36,0,208,16,16,64,256,10002,0,0,0,0
36,0,208,16,16,64,240,10002,0,0,0,0
36,0,208,16,16,80,240,10002,0,0,0,0
36,0,208,16,16,80,256,10002,0,0,0,0
36,0,208,16,16,48,288,10002,0,0,0,0
36,0,208,16,16,32,288,10002,0,0,0,0
36,0,208,16,16,32,304,10002,0,0,0,0
36,0,208,16,16,48,304,10002,0,0,0,0
36,0,208,16,16,48,320,10002,0,0,0,0
36,0,208,16,16,32,320,10002,0,0,0,0
36,0,208,16,16,48,336,10002,0,0,0,0
36,0,208,16,16,32,336,10002,0,0,0,0
36,0,208,16,16,32,352,10002,0,0,0,0
36,0,208,16,16,48,352,10002,0,0,0,0
36,0,208,16,16,48,368,10002,0,0,0,0
36,0,208,16,16,32,368,10002,0,0,0,0
36,0,208,16,16,32,400,10002,0,0,0,0
36,0,208,16,16,32,384,10002,0,0,0,0
36,0,208,16,16,48,384,10002,0,0,0,0
36,0,208,16,16,48,400,10002,0,0,0,0
36,0,208,16,16,48,416,10002,0,0,0,0
36,0,208,16,16,48,432,10002,0,0,0,0
36,0,208,16,16,64,432,10002,0,0,0,0
36,0,208,16,16,64,416,10002,0,0,0,0
36,0,208,16,16,64,400,10002,0,0,0,0
36,0,208,16,16,80,400,10002,0,0,0,0
36,0,208,16,16,80,416,10002,0,0,0,0
36,0,208,16,16,96,432,10002,0,0,0,0
36,0,208,16,16,80,432,10002,0,0,0,0
36,0,208,16,16,112,432,10002,0,0,0,0
36,0,208,16,16,96,416,10002,0,0,0,0
36,0,208,16,16,112,416,10002,0,0,0,0
36,0,208,16,16,112,400,10002,0,0,0,0
36,0,208,16,16,96,400,10002,0,0,0,0
987654321
Lwk4BkAgRT0lJWJac0JAKls/clpCGw==

