UVx6TlN0AGU9Z1pDK1t4Enp8QW5nQ3x2PFZDVA59PFliZml8NTgheng=
160,592,192,0,0,16777215,0,0,0,1,4,0
158,16,192,0,1,16777215,0,1,0,1,3,0
205,351.50,192,0,1,0,0.50,0,0,1,5,0
186,264,192,0,0,0,0,0,0,1,17,0
186,352,192,0,0,0,0,0,0,1,18,0
186,392,192,0,0,0,0,0,0,1,19,0
210,288,192,0,0,0,0,0,0,1,14,0
210,368,192,0,0,0,0,0,0,1,16,0
210,328,192,0,0,0,0,0,0,1,15,0
210,112,192,0,0,0,0,0,0,1,13,0
157,304,48,0,736,32,0,0,0,1,12,0
157,216,208,0,944,32,0,0,0,1,2,0
157,240,176,0,32,32,0,0,0,1,6,0
1234567890
25,0,256,480,48,208,64,10002,0,0,0,0
25,0,256,480,48,208,112,10002,0,0,0,0
25,0,256,480,48,0,160,10002,0,0,0,0
25,0,256,480,48,480,160,10002,0,0,0,0
25,0,256,208,48,0,64,10002,0,0,0,0
25,0,256,208,48,0,112,10002,0,0,0,0
24,96,304,64,48,384,80,9998,0,0,0,0
24,96,304,64,48,528,80,9998,0,0,0,0
24,96,304,64,48,480,128,9998,0,0,0,0
24,96,304,64,48,288,64,9998,0,0,0,0
24,96,304,64,48,224,96,9998,0,0,0,0
24,96,304,64,48,144,160,9998,0,0,0,0
24,96,304,64,48,400,160,9998,0,0,0,0
24,160,256,336,32,0,224,9998,0,0,0,0
24,160,256,336,32,336,224,9998,0,0,0,0
24,160,256,336,32,0,256,9998,0,0,0,0
24,160,256,336,32,336,256,9998,0,0,0,0
24,160,256,336,32,0,288,9998,0,0,0,0
24,160,256,336,32,336,288,9998,0,0,0,0
24,160,256,336,32,0,320,9998,0,0,0,0
24,160,256,336,32,336,320,9998,0,0,0,0
24,96,304,64,48,0,0,9998,0,0,0,0
24,96,304,64,48,128,0,9998,0,0,0,0
24,96,304,64,48,64,0,9998,0,0,0,0
24,96,304,64,48,192,0,9998,0,0,0,0
24,96,304,64,48,256,0,9998,0,0,0,0
24,96,304,64,48,320,0,9998,0,0,0,0
24,96,304,64,48,384,0,9998,0,0,0,0
24,96,304,64,48,448,0,9998,0,0,0,0
24,96,304,64,48,512,0,9998,0,0,0,0
24,96,304,64,48,576,0,9998,0,0,0,0
987654321
DR05FkAjED1gOHkON0RDfUBsa1RPB3BLDQ==

