VVh6UkxwAHk1ZzUCBWN/I2YEVUICKjhHMGhnF00iZRc+L3VgKSQ9ZmRjbV9+STsq
160,1840,672,0,0,16777215,0,0,0,1,205,0
158,336,208,0,1,16777215,0,1,0,1,38,0
195,1671,505,0,0,128,262,0,222,1,223,0
195,1728,504,0,0,128,291,0,221,1,237,0
195,264,136,0,0,200,220,0,37,1,19,0
123,168,136,0,128,16777215,0,0,0,1,39,0
123,1760,568,0,128,16777215,0,0,0,1,238,0
123,1640,608,0,128,16777215,0,0,0,1,224,0
195,1880,712,0,0,128,303,0,287,1,239,0
123,688,624,0,128,16777215,0,0,0,1,151,0
123,800,624,0,128,16777215,0,0,0,1,152,0
123,912,624,0,128,16777215,0,0,0,1,153,0
123,1904,712,0,128,16777215,0,0,0,1,282,0
123,1136,624,0,128,16777215,0,0,0,1,155,0
123,1024,624,0,128,16777215,0,0,0,1,154,0
123,40,256,0,128,16777215,0,0,0,1,112,0
123,200,552,0,128,16777215,0,0,0,1,113,0
123,216,376,0,128,16777215,0,0,0,1,111,0
197,1960,1240,0,2,0,0,0,0,1,384,0
197,1712,576,0,2,0,0,0,0,1,234,0
174,1880,1176,0,1,319,327,0,0,0,318,0
174,40,399,0,1,104,0,0,0,1,103,0
174,304,112,0,1,28,29,30,31,0,37,0
174,376,208,0,1,16,0,0,0,0,5,0
167,1136,576,0,128,270,0,0,0,1,150,0
167,1024,576,0,128,270,0,0,0,1,141,0
167,912,576,0,128,270,0,0,0,1,140,0
189,256,408,0,0,128,217,0,0,1,107,0
167,800,576,0,128,270,0,0,0,1,139,0
205,347.53,272,0,1,0,0.50,0,0,1,41,0
181,144.22,56,0,23,128,0,0,0,1,32,0
181,293.99,453.99,0,69,200,0,0,0,1,78,0
167,688,576,0,128,270,0,0,0,1,138,0
205,696,656,0,1,0,0.50,0,0,1,147,0
205,696,656,0,1,0,0.50,0,0,1,148,0
205,696,656,0,1,0,0.50,0,0,1,149,0
205,696,656,0,1,0,0.50,0,0,1,146,0
205,696,656,0,1,0,0.50,0,0,1,145,0
205,696,656,0,1,0,0.50,0,0,1,143,0
205,696,656,0,1,0,0.50,0,0,1,142,0
205,696,656,0,1,0,0.50,0,0,1,144,0
308,200,416,0,0,128,0,0,0,1,98,0
219,1864,1160,0,16,32,0,0,0,1,319,0
186,1760,432,0,0,0,0,0,0,1,228,0
304,352,288,0,0,0,0,0,0,1,40,0
188,1728,672,0,0,227,0,0,0,1,231,0
188,240,368,0,0,60,0,0,0,1,63,0
188,1776,672,0,0,207,208,209,210,1,220,0
188,1648,376,0,0,353,0,0,0,1,360,0
188,1760,672,0,0,351,0,0,0,1,352,0
188,1744,672,0,0,215,213,212,211,1,219,0
188,1864,1048,0,0,299,0,0,0,1,298,0
188,1928,1048,0,0,262,0,0,0,1,272,0
188,104,319,0,0,54,0,0,0,1,44,0
185,1915.14,1344,0,337,32,1,0,0,1,333,0
185,200,552,0,0,64,1,0,0,1,94,0
185,200,552,0,0,64,1,0,0,1,93,0
176,1824,1200,0,370,64,48,0,0,1,369,0
176,560,656,0,178,32,32,0,0,0,179,0
176,1328,657,0,182,32,32,0,0,1,180,0
176,56,336,0,175,80,32,0,0,1,174,0
216,1728,1240,0,-1,0,1,96,WU9VUiAjIERPT01FRA==,0,370,0
216,1792,720,0,-1,0,0,96,TkVYVCBURVJNSU5BTCAjIERPV04gSEVSRQ==,1,249,0
216,1456,632,0,-1,0,0,156,SEFMRiBXQVkgVEhFUkUgIyBCRVNUIEFEVklDRSAjIEkgQ0FOIEdJVkUgWU9VICMgUVVJVCBOT1c=,0,182,0
216,64,376,0,-1,0,1,96,UVVJVCBOT1c=,0,175,0
216,560,736,0,-1,0,1,192,WU9VUiBDT01QTEVURUxZIE1FTlRBTA==,1,178,0
154,1609.62,360,0,12,2.50,32,32,1,1,357,1
154,1915.14,1344,0,11,0.50,32,32,-1,1,337,1
154,1872,1256,0,10,0.50,32,32,1,1,329,0
154,1871.43,1160,0,9,0.50,32,16,1,1,323,0
154,1904,1064,0,8,0.50,32,32,1,1,301,0
154,1904,776,0,6,0.50,32,32,1,1,289,0
154,1872,840,0,7,5,32,32,1,1,264,0
154,1624,528,0,5,5,8,8,-1,1,199,1
154,179.13,684.52,1,4,0.75,32,32,-1,1,69,1
154,160,296,0,3,0.50,32,16,1,0,60,0
154,96,360,0,2,0.50,160,16,1,0,54,0
154,53.25,56,1,1,0.75,16,16,-1,1,23,1
210,1840,488,0,0,180,0,0,0,1,387,0
210,560,672,0,0,0,0,0,0,1,122,0
210,560,704,0,0,180,0,0,0,1,121,0
210,168,480,0,121,0,0,0,0,1,118,0
210,152,480,0,122,0,0,0,0,1,119,0
210,1984,1224,0,387,90,0,0,0,1,385,0
157,1840,472,0,32,32,0,0,0,1,386,0
157,2000,1256,0,32,32,0,0,0,1,383,0
157,2000,1192,0,32,32,0,0,0,1,382,0
157,2000,1224,0,32,32,0,0,0,1,381,0
157,1968,1192,0,32,32,0,0,0,1,380,0
157,1968,1256,0,32,32,0,0,0,1,379,0
157,1648,392,0,32,32,0,0,0,1,359,0
157,1808,1232,0,32,32,0,0,0,1,350,0
157,1864,1280,0,16,16,0,0,0,1,342,0
157,1944,1280,0,16,16,0,0,0,1,341,0
157,1936,1304,0,32,32,0,0,0,1,340,0
157,1872,1304,0,32,32,0,0,0,1,339,0
157,1936,1256,0,32,32,0,0,0,1,326,0
157,1936,1216,0,32,16,0,0,0,1,317,0
157,1872,1224,0,32,32,0,0,0,1,316,0
157,1872,1192,0,32,32,0,0,0,1,315,0
157,1936,1192,0,32,32,0,0,0,1,314,0
157,1840,1232,0,32,32,0,0,0,1,313,0
157,1936,1160,0,32,32,0,0,0,1,312,0
157,1872,1128,0,32,32,0,0,0,1,311,0
157,1936,1128,0,32,32,0,0,0,1,310,0
157,1936,1096,0,32,32,0,0,0,1,309,0
157,1776,616,0,8,8,0,0,0,1,295,0
157,1936,832,0,32,32,0,0,0,1,285,0
157,1808,872,0,32,32,0,0,0,1,276,0
157,1840,872,0,32,32,0,0,0,1,275,0
157,1952,1032,0,32,32,0,0,0,1,271,0
157,1936,1000,0,32,32,0,0,0,1,270,0
157,1936,928,0,32,160,0,0,0,1,269,0
157,1936,1064,0,32,32,0,0,0,1,268,0
157,1872,1064,0,32,32,0,0,0,1,260,0
157,1872,936,0,32,160,0,0,0,1,259,0
157,1872,808,0,32,32,0,0,0,1,257,0
157,1936,808,0,32,32,0,0,0,1,256,0
157,1936,688,0,32,32,0,0,0,1,248,0
157,1936,712,0,32,32,0,0,0,1,247,0
157,1936,744,0,32,32,0,0,0,1,246,0
157,1872,776,0,32,32,0,0,0,1,243,0
157,1856,720,0,32,32,0,0,0,1,242,0
157,1872,744,0,32,32,0,0,0,1,241,0
157,1696,624,0,32,32,0,0,0,1,218,0
157,1712,592,0,32,32,0,0,0,1,217,0
157,1728,624,0,32,32,0,0,0,1,216,0
157,1616,632,0,128,16,0,0,0,1,202,0
157,1648,528,0,32,32,0,0,0,1,190,0
157,1560,528,0,32,32,0,0,0,1,189,0
157,912,504,0,16,16,0,0,0,1,186,0
157,1600,688,0,576,32,0,0,0,1,181,0
157,1240,552,0,16,16,0,0,0,1,165,0
157,1136,504,0,16,16,0,0,0,1,164,0
157,1024,504,0,16,16,0,0,0,1,163,0
157,801,504,0,16,16,0,0,0,1,161,0
157,616,552,0,16,16,0,0,0,1,160,0
157,1296,688,0,32,32,0,0,0,1,157,0
157,1264,688,0,32,32,0,0,0,1,156,0
157,1072,688,0,352,32,0,0,0,1,137,0
157,800,688,0,192,32,0,0,0,1,136,0
157,688,688,0,32,32,0,0,0,1,135,0
157,608,624,0,32,32,0,0,0,1,134,0
157,592,624,0,32,32,0,0,0,1,133,0
157,688,504,0,16,16,0,0,0,1,132,0
157,528,624,0,32,32,0,0,0,1,131,0
157,528,656,0,32,32,0,0,0,1,130,0
157,528,688,0,32,32,0,0,0,1,129,0
157,608,640,0,32,32,0,0,0,1,128,0
157,656,688,0,32,32,0,0,0,1,127,0
157,624,688,0,32,32,0,0,0,1,126,0
157,592,688,0,32,32,0,0,0,1,125,0
157,560,688,0,32,32,0,0,0,1,120,0
157,160,496,0,32,32,0,0,0,1,108,0
157,0,384,0,32,32,0,0,0,1,102,0
157,40,416,0,112,32,0,0,0,1,97,0
157,240,384,0,32,32,0,0,0,1,62,0
157,88,304,0,16,32,0,0,0,1,50,0
157,104,336,0,16,32,0,0,0,1,43,0
157,88,248,0,16,16,0,0,0,1,42,0
157,176,224,0,192,32,0,0,0,1,36,0
157,8,240,0,16,256,0,0,0,1,35,0
157,128,120,0,96,16,0,0,0,1,34,0
157,336,120,0,192,16,0,0,0,1,33,0
157,288,160,0,32,32,0,0,0,1,15,0
157,288,144,0,32,32,0,0,0,1,14,0
157,288,224,0,32,32,0,0,0,1,13,0
157,320,144,0,32,32,0,0,0,1,12,0
157,416,144,0,32,32,0,0,0,1,11,0
157,384,144,0,32,32,0,0,0,1,10,0
157,352,144,0,32,32,0,0,0,1,9,0
157,416,168,0,32,32,0,0,0,1,8,0
157,416,192,0,32,32,0,0,0,1,7,0
157,416,224,0,32,32,0,0,0,1,6,0
157,384,224,0,32,32,0,0,0,1,4,0
157,352,224,0,32,32,0,0,0,1,3,0
157,320,224,0,32,32,0,0,0,1,2,0
172,1744,432,0,0,0,0,0,0,1,227,1
172,96,400,0,0,0,0,0,0,0,104,0
172,16,112,0,0,0,0,0,0,1,31,0
172,48,112,0,0,0,0,0,0,1,30,0
172,176,112,0,0,0,0,0,0,1,29,0
172,208,112,0,0,0,0,0,0,1,28,0
169,272,176,0,0,0,0,0,0,1,16,0
301,1928,1280,0,0,0,180,331,0,1,332,1
166,1616,496,0,0,0,271,0,0,1,353,0
166,1768,488,0,0,0,255,0,0,1,351,1
166,1880,1280,0,0,0,0,0,0,1,331,0
166,1744,496,0,0,0,286,0,0,1,294,1
166,1816,920,0,0,0,290,0,0,1,277,1
166,1712,504,0,0,0,255,0,0,1,222,0
166,1712,503,0,0,0,285,0,0,1,221,0
166,1960,552,0,0,0,180,0,0,0,215,0
166,1960,568,0,0,0,180,0,0,0,213,0
166,1960,584,0,0,0,180,0,0,0,212,0
166,1960,600,0,0,0,180,0,0,0,211,0
166,1960,616,0,0,0,180,0,0,0,210,0
166,1960,632,0,0,0,180,0,0,0,209,0
166,1960,648,0,0,0,180,0,0,0,208,0
166,1960,664,0,0,0,180,0,0,0,207,0
166,1600,496,0,0,199,271,0,0,1,191,1
166,104,424,0,0,0,90,0,0,1,99,1
155,1824,360,0,2,12,0,0,0,1,356,0
155,1440,360,0,1,12,0,0,0,1,355,0
155,1936,1344,0,2,11,0,0,0,1,336,0
155,1872,1344,0,1,11,0,0,0,1,335,0
155,1904,1256,0,2,10,0,0,0,0,328,0
155,1872,1256,0,1,10,0,0,0,0,327,0
155,1872,1160,0,2,9,0,0,0,1,322,0
155,1824,1160,0,1,9,0,0,0,1,321,0
155,1872,1096,0,3,8,0,0,0,0,303,0
155,1904,1096,0,2,8,0,0,0,1,300,0
155,1904,1064,0,1,8,0,0,0,0,299,0
155,1936,776,0,2,6,0,0,0,0,288,0
155,1904,776,0,1,6,0,0,0,0,287,0
155,1872,1032,0,6,7,0,0,0,0,274,0
155,1840,1032,0,5,7,0,0,0,1,273,0
155,1840,904,0,4,7,0,0,0,1,267,0
155,1776,904,0,3,7,0,0,0,1,266,0
155,1776,840,0,2,7,0,0,0,1,263,0
155,1872,840,0,1,7,0,0,0,0,262,0
155,1624,528,0,2,5,0,0,0,1,198,0
155,1584,528,0,1,5,0,0,0,1,197,0
155,88,472,0,20,4,0,0,0,1,92,0
155,72,504,0,19,4,0,0,0,1,91,0
155,64,552,0,18,4,0,0,0,1,90,0
155,72,600,0,17,4,0,0,0,1,89,0
155,88,632,0,16,4,0,0,0,1,88,0
155,120,664,0,15,4,0,0,0,1,87,0
155,152,680,0,14,4,0,0,0,1,86,0
155,200,688,0,13,4,0,0,0,1,85,0
155,248,680,0,12,4,0,0,0,1,84,0
155,280,664,0,11,4,0,0,0,1,83,0
155,312,632,0,10,4,0,0,0,1,82,0
155,328,600,0,9,4,0,0,0,1,81,0
155,336,552,0,8,4,0,0,0,1,77,0
155,328,504,0,7,4,0,0,0,1,76,0
155,312,472,0,6,4,0,0,0,1,75,0
155,280,440,0,5,4,0,0,0,1,74,0
155,248,424,0,4,4,0,0,0,1,72,0
155,200,416,0,3,4,0,0,0,1,71,0
155,152,424,0,2,4,0,0,0,1,68,0
155,120,440,0,1,4,0,0,0,1,67,0
155,112,296,0,2,3,0,0,0,1,59,0
155,160,296,0,1,3,0,0,0,1,58,0
155,184,360,0,2,2,0,0,0,1,53,0
155,96,360,0,1,2,0,0,0,1,52,0
155,208,56,0,5,1,0,0,0,1,27,0
155,48,56,0,4,1,0,0,0,1,26,0
155,48,168,0,3,1,0,0,0,1,25,0
155,208,168,0,2,1,0,0,0,1,22,0
155,208,104,0,1,1,0,0,0,1,21,0
1234567890
25,368,48,16,16,992,1312,10002,0,0,0,0
25,368,48,16,16,976,1312,10002,0,0,0,0
25,368,48,16,16,960,1312,10002,0,0,0,0
25,368,48,16,16,960,1328,10002,0,0,0,0
25,368,48,16,16,944,1328,10002,0,0,0,0
25,368,48,16,16,944,1344,10002,0,0,0,0
25,208,112,16,16,176,112,10002,0,0,0,0
25,208,112,16,16,208,112,10002,0,0,0,0
25,208,112,16,16,16,112,10002,0,0,0,0
25,208,112,16,16,48,112,10002,0,0,0,0
25,224,112,16,16,32,112,10002,0,0,0,0
25,224,112,16,16,64,112,10002,0,0,0,0
25,224,112,16,16,192,112,10002,0,0,0,0
25,224,112,16,16,224,112,10002,0,0,0,0
25,192,112,16,16,272,176,10002,0,0,0,0
25,192,128,16,16,272,192,10002,0,0,0,0
25,208,112,16,16,96,400,10002,0,0,0,0
25,224,112,16,16,112,400,10002,0,0,0,0
25,224,112,16,16,1760,432,10002,0,0,0,0
25,208,112,16,16,1744,432,10002,0,0,0,0
25,464,192,16,16,1744,1280,10002,0,0,0,0
25,464,192,16,16,1744,1312,10002,0,0,0,0
25,464,192,16,16,1744,1328,10002,0,0,0,0
25,464,192,16,16,1760,1328,10002,0,0,0,0
25,464,192,16,16,1760,1344,10002,0,0,0,0
25,464,192,16,16,1776,1344,10002,0,0,0,0
25,464,192,16,16,1776,1328,10002,0,0,0,0
25,464,192,16,16,1776,1312,10002,0,0,0,0
25,464,192,16,16,1760,1312,10002,0,0,0,0
25,464,192,16,16,1744,1296,10002,0,0,0,0
25,464,192,16,16,1728,1296,10002,0,0,0,0
25,464,192,16,16,1696,1296,10002,0,0,0,0
25,464,192,16,16,1712,1296,10002,0,0,0,0
25,464,192,16,16,1712,1280,10002,0,0,0,0
25,464,192,16,16,1728,1280,10002,0,0,0,0
25,464,192,16,16,1728,1264,10002,0,0,0,0
25,464,192,16,16,1712,1248,10002,0,0,0,0
25,464,192,16,16,1712,1232,10002,0,0,0,0
25,464,192,16,16,1696,1232,10002,0,0,0,0
25,464,192,16,16,1680,1232,10002,0,0,0,0
25,464,192,16,16,1680,1248,10002,0,0,0,0
987654321
JgspFwEuXDAlP2VHIAtBP0IpdxhHDXBSFnZkEVw9aVs=

