UVx6TlN0AGU9Z1hDakV3An0rSX9oCzF1L3Z0DwNsIDg3LTg0YHVlPmRibV9+STsqAHQ4J0Mq
160,312,144,0,0,16777215,0,0,0,1,83,0
158,24,336,0,1,16777215,0,1,0,1,82,0
195,608,216,0,0,128,180,0,55,1,49,0
100,624,216,0,300,16777215,0,180,0,1,246,0
123,232,256,0,120,16777215,0,0,0,1,22,0
178,40,264,0,80,160,0,0,0,0,225,0
195,232,216,0,0,140,270,0,156,1,157,0
100,352,176,0,200,16777215,0,270,0,1,181,0
195,384,184,0,0,128,229,0,29,1,20,0
100,624,112,0,150,6596981,0,230,0,1,232,0
100,56,200,0,256,16777215,0,237,0,1,182,0
321,272,216,0,0,0,0,120,0,1,192,0
321,592,320,0,0,0,0,120,0,1,187,0
197,240,40,0,2,0,0,0,0,1,71,0
197,528,336,0,2,0,0,0,0,1,70,0
174,328,256,0,1,43,0,0,0,0,31,0
174,64,336,0,1,8,0,0,0,0,9,0
189,616,24,0,0,128,235,0,0,1,142,0
242,240,24,0,32,32,0,0,0,1,175,0
242,528,320,0,32,32,0,0,0,1,162,0
176,448,320,0,252,32,32,0,0,1,264,0
176,448,320,0,43,32,32,0,0,1,238,0
176,128,320,0,252,32,32,0,0,1,258,0
176,128,320,0,225,32,32,0,0,1,226,0
176,128,320,0,8,32,32,0,0,1,219,0
176,584,64,0,240,80,32,0,0,1,239,0
154,577.35,48,0,4,0.50,32,8,1,1,138,1
154,568,247.05,1,3,0.70,15,48,1,1,53,1
154,230.68,288,1,1,0.50,32,8,1,1,26,1
154,456,254.05,0,5,0.35,16,48,1,1,200,1
154,488,208.58,0,2,0.40,32,16,1,1,213,1
210,616,80,0,84,0,0,0,0,1,134,0
210,208,40,0,134,0,0,0,0,1,84,0
157,264,16,0,144,48,0,0,0,1,240,0
157,640,56,0,32,32,0,0,0,1,128,0
157,640,40,0,32,32,0,0,0,1,127,0
157,640,24,0,32,32,0,0,0,1,126,0
157,640,8,0,32,32,0,0,0,1,125,0
157,640,64,0,32,32,0,0,0,1,124,0
157,640,352,0,32,32,0,0,0,1,123,0
157,640,336,0,32,32,0,0,0,1,122,0
157,640,320,0,32,32,0,0,0,1,121,0
157,640,304,0,32,32,0,0,0,1,120,0
157,640,288,0,32,32,0,0,0,1,119,0
157,640,272,0,32,32,0,0,0,1,118,0
157,640,256,0,32,32,0,0,0,1,117,0
157,640,240,0,32,32,0,0,0,1,116,0
157,640,224,0,32,32,0,0,0,1,115,0
157,640,208,0,32,32,0,0,0,1,114,0
157,640,192,0,32,32,0,0,0,1,113,0
157,640,176,0,32,32,0,0,0,1,112,0
157,640,128,0,32,32,0,0,0,1,111,0
157,640,160,0,32,32,0,0,0,1,110,0
157,624,96,0,32,32,0,0,0,1,109,0
157,592,96,0,32,32,0,0,0,1,108,0
157,560,96,0,32,32,0,0,0,1,107,0
157,528,96,0,32,32,0,0,0,1,106,0
157,64,8,0,32,32,0,0,0,1,102,0
157,48,8,0,32,32,0,0,0,1,101,0
157,16,0,0,32,32,0,0,0,1,100,0
157,8,24,0,32,32,0,0,0,1,99,0
157,24,24,0,32,32,0,0,0,1,98,0
157,56,24,0,32,32,0,0,0,1,97,0
157,88,0,0,32,32,0,0,0,1,96,0
157,88,24,0,32,32,0,0,0,1,95,0
157,120,32,0,32,32,0,0,0,1,94,0
157,120,8,0,32,32,0,0,0,1,93,0
157,152,16,0,32,32,0,0,0,1,92,0
157,216,96,0,32,32,0,0,0,1,91,0
157,200,80,0,32,32,0,0,0,1,90,0
157,184,64,0,32,32,0,0,0,1,89,0
157,168,48,0,32,32,0,0,0,1,88,0
157,152,32,0,32,32,0,0,0,1,87,0
157,184,8,0,32,32,0,0,0,1,86,0
157,184,24,0,32,32,0,0,0,1,85,0
157,440,8,0,32,32,0,0,0,1,78,0
157,472,0,0,32,32,0,0,0,1,77,0
157,440,24,0,32,32,0,0,0,1,76,0
157,472,24,0,32,32,0,0,0,1,75,0
157,408,0,0,32,32,0,0,0,1,74,0
157,376,8,0,32,32,0,0,0,1,73,0
157,344,8,0,32,32,0,0,0,1,72,0
157,344,24,0,32,32,0,0,0,1,68,0
157,376,24,0,32,32,0,0,0,1,67,0
157,408,24,0,32,32,0,0,0,1,66,0
157,472,40,0,32,8,0,0,0,1,65,0
157,440,40,0,32,8,0,0,0,1,64,0
157,408,56,0,32,32,0,0,0,1,63,0
157,376,56,0,32,32,0,0,0,1,62,0
157,344,56,0,32,32,0,0,0,1,61,0
157,312,56,0,32,32,0,0,0,1,60,0
157,280,56,0,32,32,0,0,0,1,59,0
157,248,56,0,32,32,0,0,0,1,58,0
157,408,288,0,32,32,0,0,0,1,41,0
157,408,256,0,32,32,0,0,0,1,40,0
157,408,224,0,32,32,0,0,0,1,39,0
157,408,192,0,32,32,0,0,0,1,38,0
157,408,160,0,32,32,0,0,0,1,37,0
157,376,160,0,32,32,0,0,0,1,36,0
157,344,160,0,32,32,0,0,0,1,35,0
157,312,160,0,32,32,0,0,0,1,34,0
157,280,160,0,32,32,0,0,0,1,33,0
157,248,160,0,32,32,0,0,0,1,32,0
157,328,272,0,32,32,0,0,0,1,30,0
157,192,192,0,32,32,0,0,0,1,16,0
157,160,192,0,32,32,0,0,0,1,15,0
157,128,191,0,32,32,0,0,0,1,14,0
157,176,112,0,120,48,0,0,0,1,13,0
157,176,64,0,120,48,0,0,0,1,12,0
157,56,64,0,120,48,0,0,0,1,11,0
157,176,152,0,120,48,0,0,0,1,10,0
157,16,352,0,10000,32,0,0,0,1,7,0
157,88,248,0,48,120,0,0,0,1,6,0
157,56,168,0,120,56,0,0,0,1,5,0
157,56,112,0,120,56,0,0,0,1,4,0
169,400,304,0,0,0,0,0,0,1,43,0
169,80,304,0,0,0,0,0,0,1,8,0
237,320,0,0,16777215,300,0,0,0,1,180,0
166,280,176,0,0,0,271,0,0,0,252,0
166,120,216,0,0,0,319,0,0,0,156,0
166,480,48,0,0,0,275,0,0,0,55,1
166,328,176,0,0,0,270,0,0,0,29,0
166,424,264,0,0,0,0,0,0,1,202,1
166,424,224,0,0,0,0,0,0,1,203,1
166,424,184,0,0,0,0,0,0,1,204,1
155,608,48,0,2,4,0,0,0,1,137,0
155,528,48,0,1,4,0,0,0,1,136,0
155,568,264,0,2,3,0,0,0,1,52,0
155,568,136,0,1,3,0,0,0,1,51,0
155,280,288,0,2,1,0,0,0,1,25,0
155,184,288,0,1,1,0,0,0,1,24,0
155,456,272,0,1,5,0,0,0,1,198,0
155,456,176,0,2,5,0,0,0,1,199,0
155,488,152,0,1,2,0,0,0,1,211,0
155,488,296,0,2,2,0,0,0,1,212,0
1234567890
25,48,256,48,48,0,288,10002,0,0,0,0
25,48,256,48,48,0,240,10002,0,0,0,0
25,48,256,48,48,0,192,10002,0,0,0,0
25,48,256,48,48,48,192,10002,0,0,0,0
25,48,256,48,48,48,240,10002,0,0,0,0
25,48,256,48,48,48,288,10002,0,0,0,0
25,48,256,48,48,96,288,10002,0,0,0,0
25,48,256,48,48,144,288,10002,0,0,0,0
25,48,256,48,48,192,288,10002,0,0,0,0
25,48,256,48,48,240,288,10002,0,0,0,0
25,48,256,48,48,288,288,10002,0,0,0,0
25,48,256,48,48,336,288,10002,0,0,0,0
25,336,256,64,48,96,240,10002,0,0,0,0
25,336,256,64,48,224,240,10002,0,0,0,0
25,336,256,64,48,288,240,10002,0,0,0,0
25,336,256,64,48,96,192,10002,0,0,0,0
25,336,256,64,48,160,192,10002,0,0,0,0
25,336,256,64,48,224,192,10002,0,0,0,0
25,336,256,64,48,352,192,10002,0,0,0,0
25,96,288,48,16,208,176,10002,0,0,0,0
25,96,288,48,16,256,176,10002,0,0,0,0
25,96,288,48,16,304,176,10002,0,0,0,0
25,96,288,48,16,352,176,10002,0,0,0,0
25,256,160,16,48,384,288,10002,0,0,0,0
25,400,48,64,48,416,288,10002,0,0,0,0
25,400,48,64,48,480,288,10002,0,0,0,0
25,400,48,64,48,544,288,10002,0,0,0,0
25,208,128,48,48,224,96,10002,0,0,0,0
25,208,128,48,48,272,96,10002,0,0,0,0
25,208,128,48,48,320,96,10002,0,0,0,0
25,208,128,48,48,368,96,10002,0,0,0,0
25,336,304,64,48,608,288,10002,0,0,0,0
25,336,256,64,48,352,240,10002,0,0,0,0
25,400,256,64,48,288,192,10002,0,0,0,0
25,400,256,64,48,160,240,10002,0,0,0,0
25,96,48,48,48,416,240,10002,0,0,0,0
25,96,48,48,48,464,240,10002,0,0,0,0
25,96,48,48,48,512,240,10002,0,0,0,0
25,96,48,48,48,560,240,10002,0,0,0,0
25,96,48,48,48,608,240,10002,0,0,0,0
25,528,128,32,16,512,0,10002,0,0,0,0
25,528,128,32,16,544,0,10002,0,0,0,0
25,528,128,32,16,576,0,10002,0,0,0,0
25,528,128,32,16,608,0,10002,0,0,0,0
24,288,288,64,32,0,240,10000,0,0,0,0
24,320,256,32,32,0,192,10000,0,0,0,0
24,0,288,32,32,32,192,10000,0,0,0,0
24,288,176,32,32,256,208,10000,0,0,0,0
24,256,240,48,16,160,224,10000,0,0,0,0
24,432,32,32,16,112,272,10000,0,0,0,0
24,160,320,48,32,336,304,10000,0,0,0,0
24,32,288,64,16,208,176,10000,0,0,0,0
24,160,272,32,16,272,176,10000,0,0,0,0
24,320,256,32,32,160,240,10000,0,0,0,0
24,320,192,32,32,112,240,10000,0,0,0,0
24,96,256,32,32,256,304,10000,0,0,0,0
24,432,160,32,32,288,288,10000,0,0,0,0
38,112,320,16,16,240,320,9998,0,0,0,0
38,32,336,32,16,160,320,9998,0,0,0,0
38,144,256,16,32,240,288,9998,0,0,0,0
38,144,336,32,16,160,272,9998,0,0,0,0
38,96,336,16,16,384,320,9998,0,0,0,0
38,96,256,32,32,304,304,9998,0,0,0,0
38,256,128,32,32,368,208,9998,0,0,0,0
38,224,128,32,32,160,192,9998,0,0,0,0
38,448,144,48,32,464,256,9998,0,0,0,0
38,288,192,32,16,368,240,9998,0,0,0,0
38,352,320,48,16,0,272,9998,0,0,0,0
38,160,320,16,16,304,224,9998,0,0,0,0
25,96,48,48,48,416,192,10002,0,0,0,0
25,96,48,48,48,464,192,10002,0,0,0,0
25,96,48,48,48,560,192,10002,0,0,0,0
25,96,48,48,48,608,192,10002,0,0,0,0
25,0,96,48,48,224,48,10002,0,0,0,0
25,0,96,48,48,272,48,10002,0,0,0,0
25,0,96,48,48,320,48,10002,0,0,0,0
25,0,96,48,48,368,48,10002,0,0,0,0
25,272,256,64,48,400,144,10002,0,0,0,0
25,272,256,64,48,464,144,10002,0,0,0,0
25,272,256,64,48,528,144,10002,0,0,0,0
25,272,256,64,48,592,144,10002,0,0,0,0
25,272,256,64,48,416,96,10002,0,0,0,0
25,272,256,64,48,480,96,10002,0,0,0,0
25,272,256,64,48,544,96,10002,0,0,0,0
25,272,256,64,48,608,96,10002,0,0,0,0
25,48,96,48,48,416,48,10002,0,0,0,0
25,48,96,48,48,464,48,10002,0,0,0,0
25,48,96,48,48,512,48,10002,0,0,0,0
25,48,96,48,48,560,48,10002,0,0,0,0
25,48,96,48,48,608,48,10002,0,0,0,0
25,48,96,48,48,464,0,10002,0,0,0,0
25,48,96,48,48,416,0,10002,0,0,0,0
25,528,128,32,16,512,32,10002,0,0,0,0
25,528,128,32,16,544,32,10002,0,0,0,0
25,528,128,32,16,576,32,10002,0,0,0,0
25,528,128,32,16,608,32,10002,0,0,0,0
25,528,128,32,16,512,16,10002,0,0,0,0
25,528,128,32,16,544,16,10002,0,0,0,0
25,528,128,32,16,576,16,10002,0,0,0,0
25,528,128,32,16,608,16,10002,0,0,0,0
25,48,256,48,48,192,0,10002,0,0,0,0
25,48,256,48,48,240,0,10002,0,0,0,0
25,48,256,48,48,288,0,10002,0,0,0,0
38,496,48,32,48,544,288,9998,0,0,0,0
38,480,320,48,32,560,48,9998,0,0,0,0
38,384,224,32,32,560,160,9998,0,0,0,0
38,224,96,32,32,240,64,9998,0,0,0,0
38,256,128,32,32,416,160,9998,0,0,0,0
38,256,64,32,32,496,96,9998,0,0,0,0
38,416,320,48,16,544,128,9998,0,0,0,0
38,400,0,32,48,240,96,9998,0,0,0,0
38,320,192,64,32,560,224,9998,0,0,0,0
38,224,96,32,32,608,256,9998,0,0,0,0
38,192,0,32,32,480,0,9998,0,0,0,0
24,400,304,64,16,544,112,10000,0,0,0,0
24,432,320,64,32,352,96,10000,0,0,0,0
24,256,240,48,16,368,128,10000,0,0,0,0
24,464,112,32,16,576,320,10000,0,0,0,0
24,432,208,16,16,576,288,10000,0,0,0,0
24,160,288,64,32,320,64,10000,0,0,0,0
25,96,48,48,48,512,192,10002,0,0,0,0
24,352,256,32,32,512,192,9998,0,0,0,0
24,400,256,16,32,544,192,9998,0,0,0,0
24,64,320,48,32,256,0,9998,0,0,0,0
24,256,208,32,32,192,0,9998,0,0,0,0
24,352,304,112,16,416,144,10000,0,0,0,0
25,256,128,16,32,400,304,10002,0,0,0,0
38,144,288,32,32,480,288,9998,0,0,0,0
38,176,288,32,32,464,192,9998,0,0,0,0
38,96,256,48,32,448,160,9998,0,0,0,0
38,144,256,16,32,432,208,9998,0,0,0,0
38,96,336,32,16,496,320,9998,0,0,0,0
38,48,288,16,32,464,288,9998,0,0,0,0
38,144,336,32,16,464,224,9998,0,0,0,0
38,320,128,48,64,416,272,9998,0,0,0,0
38,96,320,16,16,528,320,9998,0,0,0,0
24,128,160,32,32,160,288,10000,0,0,0,0
38,144,336,32,16,192,320,9998,0,0,0,0
38,144,256,16,32,144,304,9998,0,0,0,0
38,400,144,48,32,224,256,9998,0,0,0,0
38,352,320,48,16,160,224,9998,0,0,0,0
38,384,256,32,32,256,208,9998,0,0,0,0
38,352,256,32,32,112,240,9998,0,0,0,0
987654321
NAUrDgxiVSdtKmNNNkZINEA/NRhgESRKEGtwWFgwYhYrZA==

