VVh6UkxwAHk1ZzUCBRlFNm0USUt0JjsfVVd4GlElfzk3PDw8NSY9ZmRjbV9+STsqAHQ4Jw==
259,304,128,0,700,400,0,0,0,0,76,0
259,32,96,0,200,200,0,0,0,0,33,0
160,440,720,0,1,16777215,0,0,0,1,180,0
158,24,192,0,1,16777215,0,1,0,1,8,0
321,624,688,0,0,0,0,120,0,1,214,0
100,536,568,0,256,16777215,164,0,164,1,175,0
123,336,480,0,128,16777215,0,0,0,1,129,0
123,304,176,0,128,16777215,0,0,0,1,107,0
321,112,128,0,0,0,0,120,0,1,146,0
123,64,112,0,128,16777215,0,0,0,1,7,0
197,200,192,0,3,0,0,0,0,1,42,0
174,579,679,0,0,152,166,0,0,0,173,1
174,72,280,0,0,5,7,33,40,0,32,1
181,600,568,0,168,128,0,0,0,1,164,0
205,363.50,520,0,-1,0,0.50,0,0,1,128,0
186,272,328,0,0,0,0,0,0,1,29,0
188,376,392,0,0,52,40,37,0,1,51,0
242,680,632,0,32,32,0,0,0,1,149,0
176,648,696,0,173,32,100,0,0,1,158,0
176,440,408,0,76,32,32,0,0,1,75,0
176,680,632,0,130,32,32,0,0,1,148,0
176,680,504,0,130,32,32,0,0,1,147,0
176,112,256,0,32,32,32,0,0,1,31,0
175,64,64,0,5,120,0,0,0,1,17,0
154,536,568,0,3,0.50,32,32,-1,1,168,1
154,353.01,424,0,2,0.50,32,32,-1,1,97,1
154,176,16,0,1,0.50,32,32,-1,1,41,1
157,1944,176,0,176,3328,0,0,0,1,213,0
157,1864,160,0,176,3328,0,0,0,1,212,0
157,1688,144,0,176,3328,0,0,0,1,211,0
157,1592,128,0,176,3328,0,0,0,1,210,0
157,1416,128,0,176,3328,0,0,0,1,209,0
157,56,1056,0,176,320,0,0,0,1,208,0
157,120,1120,0,176,320,0,0,0,1,207,0
157,878,1197,0,176,320,0,0,0,1,206,0
157,752,1168,0,176,320,0,0,0,1,205,0
157,644,1139,0,176,320,0,0,0,1,204,0
157,1240,104,0,176,3328,0,0,0,1,203,0
157,1168,96,0,176,3328,0,0,0,1,202,0
157,992,80,0,176,3328,0,0,0,1,201,0
157,816,88,0,176,320,0,0,0,1,200,0
157,816,264,0,176,320,0,0,0,1,199,0
157,816,448,0,176,320,0,0,0,1,198,0
157,816,608,0,176,320,0,0,0,1,197,0
157,504,1232,0,176,320,0,0,0,1,196,0
157,816,920,0,176,320,0,0,0,1,195,0
157,304,776,0,176,320,0,0,0,1,194,0
157,296,848,0,176,320,0,0,0,1,193,0
157,312,1056,0,176,320,0,0,0,1,192,0
157,296,1040,0,176,320,0,0,0,1,191,0
157,640,920,0,176,320,0,0,0,1,190,0
157,504,920,0,176,320,0,0,0,1,189,0
157,160,744,0,176,320,0,0,0,1,188,0
157,88,744,0,176,320,0,0,0,1,187,0
157,136,904,0,176,320,0,0,0,1,186,0
157,296,600,0,176,32,0,0,0,1,185,0
157,296,568,0,176,32,0,0,0,1,184,0
157,264,568,0,176,32,0,0,0,1,183,0
157,88,568,0,176,32,0,0,0,1,182,0
157,400,896,0,32,696,0,0,0,1,181,0
157,432,744,0,32,32,0,0,0,1,179,0
157,464,744,0,32,32,0,0,0,1,177,0
157,496,744,0,32,32,0,0,0,1,176,0
157,552,632,0,32,32,0,0,0,1,163,0
157,584,632,0,32,32,0,0,0,1,162,0
157,616,632,0,32,32,0,0,0,1,161,0
157,528,744,0,32,32,0,0,0,1,160,0
157,560,744,0,32,32,0,0,0,1,159,0
157,592,744,0,32,32,0,0,0,1,156,0
157,624,744,0,32,32,0,0,0,1,150,0
157,688,744,0,32,32,0,0,0,1,145,0
157,712,656,0,32,32,0,0,0,1,144,0
157,712,680,0,32,32,0,0,0,1,143,0
157,712,712,0,32,32,0,0,0,1,142,0
157,656,744,0,32,32,0,0,0,1,141,0
157,712,744,0,32,32,0,0,0,1,140,0
157,648,600,0,32,96,0,0,0,1,139,0
157,712,600,0,32,96,0,0,0,1,138,0
157,712,0,0,32,96,0,0,0,1,137,0
157,712,88,0,32,96,0,0,0,1,136,0
157,712,184,0,32,96,0,0,0,1,135,0
157,712,280,0,32,96,0,0,0,1,134,0
157,712,376,0,32,96,0,0,0,1,133,0
157,712,472,0,32,96,0,0,0,1,132,0
157,712,536,0,32,32,0,0,0,1,131,0
157,416,520,0,32,32,0,0,0,1,127,0
157,152,456,0,64,64,0,0,0,1,125,0
157,88,456,0,64,64,0,0,0,1,124,0
157,104,456,0,64,64,0,0,0,1,123,0
157,160,520,0,64,64,0,0,0,1,122,0
157,96,520,0,64,64,0,0,0,1,121,0
157,32,520,0,64,64,0,0,0,1,120,0
157,32,456,0,64,64,0,0,0,1,119,0
157,32,512,0,64,64,0,0,0,1,118,0
157,208,520,0,64,64,0,0,0,1,117,0
157,208,456,0,64,64,0,0,0,1,115,0
157,648,536,0,32,32,0,0,0,1,114,0
157,616,536,0,32,32,0,0,0,1,113,0
157,584,536,0,32,32,0,0,0,1,112,0
157,552,536,0,32,32,0,0,0,1,109,0
157,520,536,0,32,32,0,0,0,1,108,0
157,256,504,0,32,32,0,0,0,1,106,0
157,256,472,0,32,32,0,0,0,1,105,0
157,256,440,0,32,32,0,0,0,1,104,0
157,256,536,0,32,32,0,0,0,1,103,0
157,288,536,0,32,32,0,0,0,1,100,0
157,320,536,0,32,32,0,0,0,1,99,0
157,200,288,0,80,32,0,0,0,1,92,0
157,304,248,0,80,32,0,0,0,1,91,0
157,352,536,0,32,32,0,0,0,1,90,0
157,488,536,0,32,32,0,0,0,1,89,0
157,456,536,0,32,32,0,0,0,1,88,0
157,416,536,0,32,32,0,0,0,1,87,0
157,424,536,0,32,32,0,0,0,1,86,0
157,672,32,0,64,64,0,0,0,1,85,0
157,672,112,0,64,64,0,0,0,1,84,0
157,672,96,0,64,64,0,0,0,1,83,0
157,672,168,0,64,64,0,0,0,1,82,0
157,672,232,0,64,64,0,0,0,1,81,0
157,672,392,0,64,64,0,0,0,1,80,0
157,672,360,0,64,64,0,0,0,1,79,0
157,672,296,0,64,64,0,0,0,1,78,0
157,384,536,0,32,32,0,0,0,1,77,0
157,640,408,0,32,32,0,0,0,1,74,0
157,608,408,0,32,32,0,0,0,1,73,0
157,576,408,0,32,32,0,0,0,1,72,0
157,528,408,0,32,32,0,0,0,1,71,0
157,496,408,0,32,32,0,0,0,1,70,0
157,472,408,0,32,32,0,0,0,1,69,0
157,552,408,0,32,32,0,0,0,1,68,0
157,304,392,0,64,64,0,0,0,1,67,0
157,288,392,0,64,64,0,0,0,1,66,0
157,224,392,0,64,64,0,0,0,1,65,0
157,160,392,0,64,64,0,0,0,1,64,0
157,96,392,0,64,64,0,0,0,1,63,0
157,32,392,0,64,64,0,0,0,1,62,0
157,624,384,0,64,64,0,0,0,1,61,0
157,576,384,0,64,64,0,0,0,1,60,0
157,520,384,0,64,64,0,0,0,1,59,0
157,624,360,0,64,64,0,0,0,1,58,0
157,584,360,0,64,64,0,0,0,1,57,0
157,520,360,0,64,64,0,0,0,1,56,0
157,472,400,0,32,32,0,0,0,1,55,0
157,472,368,0,32,32,0,0,0,1,54,0
157,472,344,0,32,32,0,0,0,1,53,0
157,408,344,0,32,32,0,0,0,1,50,0
157,408,376,0,32,32,0,0,0,1,49,0
157,408,408,0,32,32,0,0,0,1,48,0
157,376,408,0,32,32,0,0,0,1,47,0
157,344,408,0,32,32,0,0,0,1,45,0
157,344,376,0,32,32,0,0,0,1,44,0
157,344,344,0,32,32,0,0,0,1,43,0
157,224,208,0,32,32,0,0,0,1,36,0
157,208,208,0,32,32,0,0,0,1,35,0
157,176,208,0,32,32,0,0,0,1,34,0
157,312,344,0,32,32,0,0,0,1,30,0
157,280,344,0,32,32,0,0,0,1,27,0
157,248,344,0,32,32,0,0,0,1,26,0
157,200,344,0,32,32,0,0,0,1,25,0
157,216,344,0,32,32,0,0,0,1,24,0
157,176,344,0,32,32,0,0,0,1,23,0
157,144,344,0,32,32,0,0,0,1,22,0
157,112,344,0,32,32,0,0,0,1,21,0
157,80,344,0,32,32,0,0,0,1,20,0
157,48,344,0,32,32,0,0,0,1,19,0
157,16,344,0,32,32,0,0,0,1,18,0
157,144,208,0,32,32,0,0,0,1,6,0
157,144,72,0,32,296,0,0,0,1,4,0
157,80,208,0,32,32,0,0,0,1,3,0
157,48,208,0,32,32,0,0,0,1,2,0
157,16,208,0,32,32,0,0,0,1,16,0
172,664,520,0,0,0,0,0,0,1,130,1
172,424,328,0,0,0,0,0,0,1,52,1
172,96,192,0,1,0,0,0,0,1,5,1
301,600,648,0,0,0,270,0,0,1,178,1
301,352.51,424,0,97,0,269,102,0,1,101,1
253,200,192,0,16777215,0,1,0,0,1,157,0
166,448,560,0,0,0,304,0,0,1,152,1
166,280,512,0,0,0,0,0,0,0,102,1
166,176,16,0,41,0,270,0,0,1,37,1
155,576,704,0,6,3,0,0,0,1,174,0
155,504,704,0,5,3,0,0,0,1,172,0
155,504,600,0,4,3,0,0,0,1,171,0
155,600,600,0,3,3,0,0,0,1,170,0
155,600,568,0,2,3,0,0,0,1,167,0
155,536,568,0,1,3,0,0,0,0,166,0
155,400,424,0,2,2,0,0,0,1,96,0
155,280,424,0,1,2,0,0,0,1,95,0
155,176,16,0,2,1,0,0,0,0,40,0
155,232,16,0,1,1,0,0,0,1,39,0
1234567890
25,0,0,48,48,0,0,10002,0,0,0,0
25,0,0,48,48,48,0,10002,0,0,0,0
25,0,0,48,48,96,0,10002,0,0,0,0
25,0,0,48,48,96,48,10002,0,0,0,0
25,0,0,48,48,48,48,10002,0,0,0,0
25,0,0,48,48,0,48,10002,0,0,0,0
25,0,0,48,48,0,96,10002,0,0,0,0
25,0,0,48,48,0,144,10002,0,0,0,0
25,0,0,48,48,48,96,10002,0,0,0,0
25,0,0,48,48,48,144,10002,0,0,0,0
25,0,0,48,48,96,96,10002,0,0,0,0
25,0,0,48,48,96,144,10002,0,0,0,0
25,176,176,80,80,48,224,10002,0,0,0,0
25,176,176,80,80,128,224,10002,0,0,0,0
25,176,176,80,80,208,224,10002,0,0,0,0
25,176,176,80,80,208,304,10002,0,0,0,0
25,176,176,80,80,128,304,10002,0,0,0,0
25,176,176,80,80,48,304,10002,0,0,0,0
25,176,176,80,80,240,144,10002,0,0,0,0
25,176,176,80,80,160,112,10002,0,0,0,0
25,176,176,80,80,160,32,10002,0,0,0,0
25,176,176,80,80,240,32,10002,0,0,0,0
25,176,176,80,80,320,32,10002,0,0,0,0
25,176,176,80,80,320,112,10002,0,0,0,0
25,176,176,80,80,320,192,10002,0,0,0,0
25,176,176,80,80,320,272,10002,0,0,0,0
25,176,176,80,80,400,256,10002,0,0,0,0
25,176,176,80,80,400,176,10002,0,0,0,0
25,176,176,80,80,480,256,10002,0,0,0,0
25,176,176,80,80,480,176,10002,0,0,0,0
25,176,176,80,80,560,176,10002,0,0,0,0
25,176,176,80,80,560,256,10002,0,0,0,0
25,176,176,80,80,560,96,10002,0,0,0,0
25,176,176,80,80,400,96,10002,0,0,0,0
25,176,176,80,80,480,96,10002,0,0,0,0
25,176,176,80,80,480,16,10002,0,0,0,0
25,176,176,80,80,560,16,10002,0,0,0,0
25,176,176,80,80,400,16,10002,0,0,0,0
25,176,176,64,32,336,0,10002,0,0,0,0
25,176,176,80,16,400,0,10002,0,0,0,0
25,176,176,80,16,480,0,10002,0,0,0,0
25,176,176,80,16,560,0,10002,0,0,0,0
25,192,176,32,80,288,224,10002,0,0,0,0
25,192,176,32,80,288,304,10002,0,0,0,0
25,176,176,64,32,240,112,10002,0,0,0,0
25,224,208,16,32,304,112,10002,0,0,0,0
25,224,208,16,32,320,0,10002,0,0,0,0
25,224,208,16,32,304,0,10002,0,0,0,0
25,224,208,16,32,272,0,10002,0,0,0,0
25,224,208,16,32,288,0,10002,0,0,0,0
25,224,208,16,32,160,0,10002,0,0,0,0
25,224,208,16,32,176,0,10002,0,0,0,0
25,224,208,16,32,192,0,10002,0,0,0,0
25,224,208,16,32,208,0,10002,0,0,0,0
25,224,208,16,32,224,0,10002,0,0,0,0
25,224,208,16,32,240,0,10002,0,0,0,0
25,224,208,16,32,256,0,10002,0,0,0,0
25,176,176,32,80,16,224,10002,0,0,0,0
25,176,176,32,80,16,304,10002,0,0,0,0
25,208,208,32,32,368,352,10002,0,0,0,0
25,208,208,32,32,336,352,10002,0,0,0,0
25,208,208,32,32,352,384,10002,0,0,0,0
25,208,208,32,32,384,384,10002,0,0,0,0
25,192,176,16,80,0,224,10002,0,0,0,0
25,192,176,16,80,0,304,10002,0,0,0,0
25,192,224,32,16,96,208,10002,0,0,0,0
25,208,112,32,16,96,192,10002,0,0,0,0
35,336,96,48,48,416,336,10002,0,0,0,0
35,336,96,48,48,416,384,10002,0,0,0,0
35,336,96,48,48,416,432,10002,0,0,0,0
35,336,96,48,48,368,416,10002,0,0,0,0
35,336,96,48,48,368,464,10002,0,0,0,0
35,336,96,48,48,416,480,10002,0,0,0,0
35,336,96,48,48,320,464,10002,0,0,0,0
35,336,96,48,48,320,416,10002,0,0,0,0
35,336,96,48,48,272,416,10002,0,0,0,0
35,336,96,48,48,272,464,10002,0,0,0,0
35,336,128,48,16,352,512,10002,0,0,0,0
35,336,128,48,16,304,512,10002,0,0,0,0
35,336,128,48,16,256,512,10002,0,0,0,0
35,336,96,48,48,464,416,10002,0,0,0,0
35,336,96,48,48,464,464,10002,0,0,0,0
35,336,128,48,16,464,512,10002,0,0,0,0
35,336,96,48,48,512,416,10002,0,0,0,0
35,336,96,48,48,512,464,10002,0,0,0,0
35,336,96,48,48,560,464,10002,0,0,0,0
35,336,96,48,48,560,416,10002,0,0,0,0
35,336,96,48,48,608,416,10002,0,0,0,0
35,336,96,48,48,656,416,10002,0,0,0,0
35,336,96,48,48,656,464,10002,0,0,0,0
35,336,96,48,48,608,464,10002,0,0,0,0
35,336,128,48,16,512,512,10002,0,0,0,0
35,336,128,48,16,560,512,10002,0,0,0,0
35,336,128,48,16,608,512,10002,0,0,0,0
35,336,128,48,16,656,512,10002,0,0,0,0
24,0,160,32,32,192,240,10000,0,0,0,0
24,0,160,32,32,208,160,10000,0,0,0,0
24,0,192,32,32,192,96,10000,0,0,0,0
24,256,144,32,32,96,112,10000,0,0,0,0
25,0,0,48,48,416,544,10002,0,0,0,0
25,0,0,48,48,464,544,10002,0,0,0,0
25,0,0,48,48,512,544,10002,0,0,0,0
25,0,0,48,48,560,544,10002,0,0,0,0
25,0,0,48,48,608,544,10002,0,0,0,0
25,0,0,48,48,656,544,10002,0,0,0,0
25,0,0,32,16,656,528,10002,0,0,0,0
25,0,0,32,16,688,528,10002,0,0,0,0
25,0,0,48,48,656,592,10002,0,0,0,0
25,0,0,48,48,656,640,10002,0,0,0,0
25,0,0,48,48,656,688,10002,0,0,0,0
25,0,0,48,48,608,688,10002,0,0,0,0
25,0,0,48,48,608,640,10002,0,0,0,0
25,0,0,48,48,560,640,10002,0,0,0,0
25,0,0,48,48,560,688,10002,0,0,0,0
25,0,0,48,48,512,688,10002,0,0,0,0
25,0,0,48,48,512,640,10002,0,0,0,0
25,0,0,48,48,592,592,10002,0,0,0,0
25,0,0,48,48,544,592,10002,0,0,0,0
25,0,0,48,48,496,592,10002,0,0,0,0
25,0,0,48,48,448,592,10002,0,0,0,0
25,0,0,48,48,400,592,10002,0,0,0,0
25,0,0,48,48,400,640,10002,0,0,0,0
25,0,0,48,48,448,640,10002,0,0,0,0
25,0,0,48,48,464,688,10002,0,0,0,0
25,0,0,48,48,416,688,10002,0,0,0,0
25,16,0,16,48,496,640,10002,0,0,0,0
38,448,48,48,32,336,464,10000,0,0,0,0
24,256,144,32,32,608,672,10000,0,0,0,0
24,432,208,16,16,672,688,10000,0,0,0,0
987654321
NCkdUlFi

