VVh6UkxxBnkpcyF4YUNBA2weaGJ2FW0OK2p1F0oiQBAkLzVgNDghenh/cUNiVSc2HGgk
259,688,328,0,32,32,0,0,0,1,230,0
259,688,304,0,32,32,0,0,0,1,229,0
259,688,160,0,32,32,0,0,0,1,228,0
259,688,144,0,32,32,0,0,0,1,227,0
259,688,112,0,32,32,0,0,0,1,226,0
259,752,144,0,32,32,0,0,0,1,225,0
259,784,144,0,32,32,0,0,0,1,224,0
259,784,112,0,32,32,0,0,0,1,223,0
259,752,112,0,32,32,0,0,0,1,222,0
259,176,160,0,32,32,0,0,0,1,59,0
259,176,144,0,32,32,0,0,0,1,58,0
259,176,112,0,32,32,0,0,0,1,57,0
259,176,80,0,32,32,0,0,0,1,56,0
259,176,328,0,32,32,0,0,0,1,55,0
259,176,304,0,32,32,0,0,0,1,54,0
259,40,80,0,200,190,0,0,0,0,21,0
347,480,272,0,18,0,0,120,0,1,306,0
160,840,264,0,0,16777215,0,0,0,1,322,0
158,96,160,0,1,16777215,0,1,0,1,15,0
100,96,192,0,256,16777215,79,0,0,1,75,0
195,352,200,0,0,128,0,129,288,1,132,0
100,352,200,0,256,16777215,129,0,0,1,125,0
100,480,200,0,256,16777215,0,269,0,1,309,0
100,384,8,0,256,16777215,0,0,0,1,107,0
321,64,208,0,0,0,0,120,0,1,177,0
123,64,120,0,128,16777215,0,0,0,1,16,0
321,48,96,0,0,0,0,120,0,1,293,0
197,608,272,0,2,0,0,0,0,1,324,0
197,544,272,0,2,0,0,0,0,1,323,0
197,272,272,0,2,0,0,0,0,1,325,0
174,656,271,0,0,211,212,0,0,0,300,1
193,776,120,0,0,191,209,0,0,0,215,1
174,656,240,0,0,191,209,0,0,0,290,1
174,72,216,0,0,2,21,0,0,0,20,1
205,104.55,344,0,1,0,0.50,0,0,1,62,0
205,744.51,160,0,1,0,0.50,0,0,1,219,0
219,784,288,0,32,32,0,0,0,1,313,1
219,752,288,0,32,32,0,0,0,1,312,1
186,688,176,0,0,0,0,0,0,1,208,0
186,176,176,0,0,0,0,0,0,1,45,0
188,48,272,0,0,46,38,0,0,1,61,0
242,544,264,0,32,200,0,0,0,1,297,0
242,720,224,0,32,200,0,0,0,1,292,0
242,272,256,0,32,333,0,0,0,1,96,0
176,608,232,0,300,32,100,0,0,1,299,0
176,16,224,0,20,32,32,0,0,1,19,0
175,16,96,0,2,160,0,0,0,1,18,0
154,344.26,232,0,3,0.50,32,32,-1,1,129,1
154,114.85,228.49,0,1,0.50,32,32,-1,1,79,1
210,568,192,0,0,180,0,0,0,1,193,0
210,584,192,0,0,180,0,0,0,1,194,0
210,680,328,0,193,0,0,0,0,1,204,0
210,696,328,0,194,0,0,0,0,1,205,0
210,184,344,0,53,0,0,0,0,1,52,0
210,176,64,0,0,180,0,0,0,1,53,0
210,168,344,0,53,0,0,0,0,1,51,0
157,1334,233,0,64,328,0,0,0,1,350,0
157,1288,216,0,64,328,0,0,0,1,349,0
157,1296,152,0,64,328,0,0,0,1,348,0
157,1334,92,0,64,328,0,0,0,1,347,0
157,1285,87,0,64,328,0,0,0,1,346,0
157,1304,72,0,64,328,0,0,0,1,345,0
157,1232,64,0,64,328,0,0,0,1,344,0
157,1232,232,0,64,328,0,0,0,1,343,0
157,1168,208,0,64,328,0,0,0,1,342,0
157,1168,144,0,64,328,0,0,0,1,341,0
157,1102,131,0,64,328,0,0,0,1,340,0
157,1072,120,0,64,328,0,0,0,1,339,0
157,1104,224,0,64,328,0,0,0,1,338,0
157,1048,208,0,64,328,0,0,0,1,337,0
157,784,176,0,32,32,0,0,0,1,212,0
157,752,176,0,32,32,0,0,0,1,211,0
157,1024,176,0,64,328,0,0,0,1,336,0
157,960,176,0,64,328,0,0,0,1,335,0
157,960,240,0,64,328,0,0,0,1,334,0
157,1000,240,0,64,328,0,0,0,1,333,0
157,1008,24,0,64,64,0,0,0,1,332,0
157,984,32,0,64,64,0,0,0,1,331,0
157,912,96,0,64,64,0,0,0,1,330,0
157,920,32,0,64,64,0,0,0,1,329,0
157,864,32,0,64,64,0,0,0,1,328,0
157,864,96,0,64,64,0,0,0,1,326,0
157,912,200,0,64,64,0,0,0,1,321,0
157,912,160,0,64,64,0,0,0,1,320,0
157,912,240,0,64,64,0,0,0,1,319,0
157,912,352,0,64,64,0,0,0,1,318,0
157,912,304,0,64,64,0,0,0,1,317,0
157,848,360,0,64,64,0,0,0,1,316,0
157,848,304,0,64,64,0,0,0,1,315,0
157,856,160,0,64,64,0,0,0,1,314,0
157,768,32,0,64,64,0,0,0,1,311,0
157,800,32,0,64,64,0,0,0,1,310,0
157,816,352,0,32,64,0,0,0,1,305,1
157,816,304,0,32,64,0,0,0,1,304,1
157,400,32,0,64,32,0,0,0,1,287,0
157,488,80,0,64,64,0,0,0,1,286,0
157,472,64,0,64,64,0,0,0,1,285,0
157,424,88,0,64,64,0,0,0,1,284,0
157,464,56,0,64,64,0,0,0,1,283,0
157,474,16,0,64,64,0,0,0,1,282,0
157,456,24,0,64,64,0,0,0,1,281,0
157,320,40,0,64,64,0,0,0,1,280,0
157,312,88,0,64,64,0,0,0,1,279,0
157,376,112,0,64,64,0,0,0,1,278,0
157,423.85,61.44,0,32,32,0,0,0,1,277,0
157,752,80,0,32,32,0,0,0,1,221,0
157,784,80,0,32,32,0,0,0,1,220,0
157,816,80,0,32,32,0,0,0,1,218,0
157,816,112,0,32,32,0,0,0,1,217,0
157,816,144,0,32,32,0,0,0,1,216,0
157,816,176,0,32,32,0,0,0,1,213,0
157,704,32,0,64,64,0,0,0,1,210,0
157,720,304,0,32,64,0,0,0,1,207,1
157,656,304,0,32,64,0,0,0,1,206,0
157,720,360,0,32,64,0,0,0,1,203,0
157,688,360,0,32,64,0,0,0,1,202,0
157,672,360,0,32,64,0,0,0,1,201,0
157,640,352,0,32,64,0,0,0,1,200,0
157,720,176,0,32,32,0,0,0,1,198,0
157,720,144,0,32,32,0,0,0,1,197,0
157,720,112,0,32,32,0,0,0,1,196,0
157,720,80,0,32,32,0,0,0,1,195,0
157,688,80,0,32,32,0,0,0,1,192,0
157,600,112,0,64,64,0,0,0,1,190,0
157,584,96,0,64,64,0,0,0,1,189,0
157,544,104,0,64,64,0,0,0,1,188,0
157,520,104,0,64,64,0,0,0,1,187,0
157,576,32,0,64,64,0,0,0,1,186,0
157,536,32,0,64,64,0,0,0,1,185,0
157,640,32,0,64,64,0,0,0,1,184,0
157,640,96,0,64,64,0,0,0,1,183,0
157,640,160,0,64,64,0,0,0,1,182,0
157,608,160,0,64,64,0,0,0,1,181,0
157,544,160,0,64,64,0,0,0,1,180,0
157,640,304,0,32,64,0,0,0,1,179,0
157,480,160,0,64,64,0,0,0,1,176,0
157,472,96,0,64,64,0,0,0,1,175,0
157,536,32,0,64,64,0,0,0,1,174,0
157,304,0,0,64,32,0,0,0,1,173,0
157,352,16,0,64,32,0,0,0,1,172,0
157,344,32,0,64,32,0,0,0,1,171,0
157,539,47,0,64,64,0,0,0,1,170,0
157,379,3,0,64,64,0,0,0,1,169,0
157,400,133,0,64,64,0,0,0,1,168,0
157,329,132,0,64,64,0,0,0,1,167,0
157,312,136,0,64,64,0,0,0,1,166,0
157,336,2,0,64,64,0,0,0,1,165,0
157,416,16,0,64,32,0,0,0,1,164,0
157,465,28,0,64,32,0,0,0,1,163,0
157,376,64,0,64,32,0,0,0,1,162,0
157,416,112,0,64,32,0,0,0,1,161,0
157,416,144,0,64,32,0,0,0,1,160,0
157,376,144,0,64,32,0,0,0,1,159,0
157,320,144,0,64,32,0,0,0,1,158,0
157,592,360,0,32,64,0,0,0,1,157,0
157,560,360,0,32,64,0,0,0,1,156,0
157,624,360,0,32,64,0,0,0,1,155,0
157,568,352,0,32,64,0,0,0,1,154,0
157,624,304,0,32,64,0,0,0,1,152,0
157,592,304,0,32,64,0,0,0,1,151,0
157,560,304,0,32,64,0,0,0,1,150,0
157,528,304,0,32,64,0,0,0,1,149,0
157,528,360,0,32,64,0,0,0,1,147,0
157,496,360,0,32,64,0,0,0,1,146,0
157,496,304,0,32,64,0,0,0,1,145,0
157,464,352,0,32,64,0,0,0,1,144,0
157,464,304,0,32,64,0,0,0,1,143,0
157,400,304,0,32,64,0,0,0,1,124,0
157,400,360,0,32,64,0,0,0,1,123,0
157,432,360,0,32,64,0,0,0,1,121,0
157,432,304,0,32,64,0,0,0,1,120,0
157,432,176,0,32,32,0,0,0,1,119,0
157,400,176,0,32,32,0,0,0,1,118,0
157,368,176,0,32,32,0,0,0,1,117,0
157,336,176,0,32,32,0,0,0,1,116,0
157,304,176,0,32,32,0,0,0,1,115,0
157,368,360,0,32,64,0,0,0,1,99,0
157,368,304,0,32,64,0,0,0,1,98,0
157,336,352,0,32,64,0,0,0,1,95,0
157,336,304,0,32,64,0,0,0,1,94,0
157,304,336,0,32,64,0,0,0,1,93,0
157,272,8,0,32,64,0,0,0,1,92,0
157,272,40,0,32,64,0,0,0,1,91,0
157,272,96,0,32,64,0,0,0,1,90,0
157,304,288,0,32,32,0,0,0,1,89,0
157,272,144,0,32,32,0,0,0,1,88,0
157,272,176,0,32,32,0,0,0,1,87,0
157,272,352,0,32,32,0,0,0,1,86,0
157,272,320,0,32,32,0,0,0,1,85,0
157,272,288,0,32,32,0,0,0,1,84,0
157,240,32,0,32,64,0,0,0,1,74,0
157,240,96,0,32,64,0,0,0,1,73,0
157,240,144,0,32,32,0,0,0,1,72,0
157,240,176,0,32,32,0,0,0,1,71,0
157,192,16,0,64,32,0,0,0,1,70,0
157,160,16,0,64,32,0,0,0,1,69,0
157,96,16,0,64,32,0,0,0,1,68,0
157,32,16,0,64,32,0,0,0,1,67,0
157,240,352,0,32,32,0,0,0,1,66,0
157,240,320,0,32,32,0,0,0,1,65,0
157,240,288,0,32,32,0,0,0,1,63,0
157,176,360,0,32,32,0,0,0,1,50,0
157,208,352,0,32,32,0,0,0,1,49,0
157,208,320,0,32,32,0,0,0,1,48,0
157,208,288,0,32,32,0,0,0,1,47,0
157,176,48,0,32,32,0,0,0,1,44,0
157,208,48,0,32,32,0,0,0,1,43,0
157,208,80,0,32,32,0,0,0,1,42,0
157,208,112,0,32,32,0,0,0,1,41,0
157,208,144,0,32,32,0,0,0,1,40,0
157,208,176,0,32,32,0,0,0,1,39,0
157,16,344,0,32,32,0,0,0,1,37,0
157,48,344,0,32,32,0,0,0,1,36,0
157,48,320,0,32,32,0,0,0,1,35,0
157,16,320,0,32,32,0,0,0,1,34,0
157,128,360,0,32,32,0,0,0,1,32,0
157,144,352,0,32,32,0,0,0,1,31,0
157,144,320,0,32,32,0,0,0,1,30,0
157,104,360,0,32,32,0,0,0,1,29,0
157,72,352,0,32,32,0,0,0,1,28,0
157,72,320,0,32,32,0,0,0,1,27,0
157,144,288,0,32,32,0,0,0,1,26,0
157,72,288,0,32,32,0,0,0,1,24,0
157,48,288,0,32,32,0,0,0,1,23,0
157,16,288,0,32,32,0,0,0,1,22,0
157,16,48,0,32,32,0,0,0,1,14,0
157,48,48,0,32,32,0,0,0,1,13,0
157,80,48,0,32,32,0,0,0,1,12,0
157,112,48,0,32,32,0,0,0,1,11,0
157,144,48,0,32,32,0,0,0,1,10,0
157,144,80,0,32,32,0,0,0,1,9,0
157,144,112,0,32,32,0,0,0,1,8,0
157,144,144,0,32,32,0,0,0,1,7,0
157,144,176,0,32,32,0,0,0,1,6,0
157,112,176,0,32,32,0,0,0,1,5,0
157,80,176,0,32,32,0,0,0,1,4,0
157,48,176,0,32,32,0,0,0,1,3,0
172,672,272,0,0,0,0,0,0,1,209,1
172,672,176,0,0,0,0,0,0,1,191,1
172,160,272,0,0,0,0,0,0,1,46,1
172,160,176,0,0,0,0,0,0,1,38,1
172,0,168,0,1,0,0,0,0,1,2,1
301,736,160,0,0,0,0,290,0,1,289,1
301,88,320,0,0,0,0,60,0,1,33,1
166,232,264,0,0,0,0,0,0,0,288,1
166,216,264,0,0,0,90,0,0,0,60,1
155,416,232,0,3,3,0,0,0,1,131,0
155,352,232,0,2,3,0,0,0,1,128,0
155,304,232,0,1,3,0,0,0,1,127,0
155,144,216,0,3,1,0,0,0,1,81,0
155,88,240,0,2,1,0,0,0,1,78,0
155,32,208,0,1,1,0,0,0,1,77,0
1234567890
35,0,0,48,48,0,64,10002,0,0,0,0
35,0,0,48,48,48,64,10002,0,0,0,0
35,0,0,48,48,96,64,10002,0,0,0,0
35,0,0,48,48,96,112,10002,0,0,0,0
35,0,0,48,48,48,112,10002,0,0,0,0
35,0,0,48,48,0,112,10002,0,0,0,0
35,0,0,48,48,0,176,10002,0,0,0,0
35,0,0,48,48,0,224,10002,0,0,0,0
35,0,0,48,48,48,176,10002,0,0,0,0
35,0,0,48,48,48,224,10002,0,0,0,0
35,0,0,48,48,96,224,10002,0,0,0,0
35,0,0,48,48,96,176,10002,0,0,0,0
35,0,0,48,48,144,176,10002,0,0,0,0
35,0,0,48,48,144,224,10002,0,0,0,0
35,0,0,48,48,192,176,10002,0,0,0,0
35,0,0,48,48,192,224,10002,0,0,0,0
35,0,0,48,48,80,272,10002,0,0,0,0
35,0,0,48,48,80,320,10002,0,0,0,0
24,464,288,32,32,0,160,10000,0,0,0,0
35,0,0,48,16,0,160,10002,0,0,0,0
35,0,0,48,16,144,272,10002,0,0,0,0
24,0,160,32,32,0,240,10000,0,0,0,0
24,464,112,32,16,128,256,10000,0,0,0,0
38,448,80,48,16,224,224,10000,0,0,0,0
38,320,128,48,64,96,192,10000,0,0,0,0
38,384,224,32,32,32,80,9998,0,0,0,0
38,352,256,32,32,48,192,9998,0,0,0,0
35,0,0,48,48,240,192,10002,0,0,0,0
35,0,0,48,48,240,240,10002,0,0,0,0
35,0,0,48,48,288,240,10002,0,0,0,0
35,0,0,48,48,288,192,10002,0,0,0,0
35,0,0,48,48,336,192,10002,0,0,0,0
35,0,0,48,48,384,192,10002,0,0,0,0
35,0,0,48,48,432,192,10002,0,0,0,0
35,0,0,48,48,480,192,10002,0,0,0,0
35,0,0,48,48,480,240,10002,0,0,0,0
35,0,0,48,48,432,240,10002,0,0,0,0
35,0,0,48,48,384,240,10002,0,0,0,0
35,0,0,48,48,336,240,10002,0,0,0,0
35,0,0,48,48,528,192,10002,0,0,0,0
35,0,0,48,48,576,192,10002,0,0,0,0
35,0,0,48,48,624,192,10002,0,0,0,0
35,0,0,48,48,624,240,10002,0,0,0,0
35,0,0,48,48,576,240,10002,0,0,0,0
35,0,0,48,48,528,240,10002,0,0,0,0
35,0,0,48,48,672,192,10002,0,0,0,0
35,0,0,48,48,672,240,10002,0,0,0,0
35,0,0,48,48,672,288,10002,0,0,0,0
35,0,0,48,48,720,224,10002,0,0,0,0
35,0,0,48,48,736,96,10002,0,0,0,0
35,0,0,48,48,784,96,10002,0,0,0,0
35,0,0,48,48,720,176,10002,0,0,0,0
35,0,0,48,48,768,176,10002,0,0,0,0
35,0,0,48,48,768,224,10002,0,0,0,0
35,0,0,48,48,768,272,10002,0,0,0,0
35,0,0,48,48,720,272,10002,0,0,0,0
35,0,0,48,48,720,320,10002,0,0,0,0
35,0,0,48,48,768,320,10002,0,0,0,0
35,0,0,48,48,816,192,10002,0,0,0,0
35,0,0,48,48,816,240,10002,0,0,0,0
35,0,0,48,48,816,288,10002,0,0,0,0
35,0,0,48,48,816,336,10002,0,0,0,0
35,0,0,32,16,672,176,10002,0,0,0,0
35,0,0,48,16,736,160,10002,0,0,0,0
35,0,0,48,16,784,160,10002,0,0,0,0
35,32,0,16,48,864,192,10002,0,0,0,0
35,32,0,16,48,864,240,10002,0,0,0,0
24,0,160,32,32,640,240,10000,0,0,0,0
24,496,192,64,32,400,192,10000,0,0,0,0
24,464,128,32,16,368,256,10000,0,0,0,0
24,464,112,32,16,288,256,10000,0,0,0,0
24,432,64,32,32,432,224,10000,0,0,0,0
987654321
NCkdUlFi

