UVx6TlN0AGU9Z1x5ZllMAnogf39JQ3x3F3F+DFI0aBQ2Kz18NTghenh/cUNiVSc2HA==
158,320,180,0,1,16777215,0,1,0,1,13,0
157,360,208,0,32,32,0,0,0,1,6,0
157,424,208,0,32,32,0,0,0,1,5,0
157,264,208,0,32,32,0,0,0,1,4,0
157,296,208,0,32,32,0,0,0,1,3,0
157,328,208,0,32,32,0,0,0,1,2,0
157,392,208,0,32,32,0,0,0,1,12,0
1234567890
24,400,16,16,16,352,160,9998,0,0,0,0
24,368,0,16,16,352,176,9998,0,0,0,0
24,352,0,16,16,368,176,9998,0,0,0,0
24,432,96,32,16,384,176,9998,0,0,0,0
24,432,96,32,16,368,160,9998,0,0,0,0
24,432,96,32,16,416,160,9998,0,0,0,0
24,432,96,32,16,416,176,9998,0,0,0,0
24,432,96,32,16,384,144,9998,0,0,0,0
24,432,96,32,16,352,128,9998,0,0,0,0
24,432,96,32,16,400,128,9998,0,0,0,0
24,432,96,32,16,416,96,9998,0,0,0,0
24,432,96,32,16,368,96,9998,0,0,0,0
24,432,96,32,16,368,112,9998,0,0,0,0
25,272,0,192,144,448,0,10002,0,0,0,0
25,272,0,192,144,448,144,10002,0,0,0,0
25,272,0,192,144,448,288,10002,0,0,0,0
25,272,0,192,144,256,0,10002,0,0,0,0
25,272,0,192,144,256,144,10002,0,0,0,0
25,272,0,192,144,256,288,10002,0,0,0,0
25,272,0,192,144,0,0,10002,0,0,0,0
25,272,0,192,144,0,144,10002,0,0,0,0
25,272,0,192,144,0,288,10002,0,0,0,0
25,400,0,64,144,192,0,10002,0,0,0,0
25,400,0,64,144,192,144,10002,0,0,0,0
25,400,0,64,144,192,288,10002,0,0,0,0
38,96,32,128,32,240,192,10000,0,0,0,0
39,272,80,192,32,240,192,9998,0,0,0,0
987654321
BgsiCwU0VQ==

