XlF4Tll7AmU9Z1scO0d0AmY/QWBFQ3x2EWBYFFoFZRg3ORU1c3F9Znl/cUNiVSc2HGgkO182bg==
259,32,24,0,400,60,0,0,0,0,58,0
160,960,424,0,0,16777215,0,0,0,1,213,0
158,32,48,0,1,16777215,0,1,0,1,4,0
321,368,144,0,0,0,0,120,0,1,185,0
321,112,96,0,0,0,0,120,0,1,183,0
100,136,24,0,256,16777215,10,180,0,1,6,0
100,0,96,0,256,16777215,0,0,0,1,16,0
197,56,240,0,2,60,0,0,0,1,47,0
174,240,48,0,0,20,21,0,0,0,26,1
174,16,208,0,0,0,38,36,0,0,60,1
316,576,432,0,0,1,0,0,0,0,155,0
186,344,240,0,0,0,0,0,0,1,113,0
186,200,48,0,0,0,0,0,0,1,25,0
188,240,176,0,0,36,20,21,0,1,48,0
188,408,432,0,0,96,115,0,0,1,112,0
185,800,520,0,0,32,1,0,0,1,163,0
185,752,520,0,0,32,1,0,0,1,162,0
185,704,520,0,0,32,1,0,0,1,161,0
242,408,272,0,32,32,0,0,0,1,124,0
242,504,272,0,32,32,0,0,0,1,123,0
176,240,224,0,38,32,32,0,0,1,81,0
176,504,376,0,155,32,32,0,0,1,156,0
176,112,24,0,17,32,64,0,0,1,18,0
176,192,96,0,58,64,32,0,0,1,59,0
175,344,31,0,26,390,0,0,0,1,27,0
154,782.51,440,0,2,0.50,32,8,1,1,173,1
154,80,24.00,0,1,0.50,32,32,-1,1,10,1
216,96,120,0,-1,1,0,192,V2xjb21lIFRvIFRoZSBPbGQgVGltZXM=,1,17,0
157,960,240,0,64,296,0,0,0,1,216,0
157,976,368,0,32,32,0,0,0,1,215,0
157,944,368,0,32,32,0,0,0,1,214,0
157,984,448,0,32,32,0,0,0,1,212,0
157,968,448,0,32,32,0,0,0,1,211,0
157,936,448,0,32,32,0,0,0,1,210,0
157,976,862,0,64,296,0,0,0,1,209,0
157,928,848,0,64,296,0,0,0,1,208,0
157,912,832,0,64,296,0,0,0,1,207,0
157,584,808,0,64,296,0,0,0,1,206,0
157,648,792,0,64,296,0,0,0,1,205,0
157,824,776,0,64,296,0,0,0,1,204,0
157,848,768,0,64,296,0,0,0,1,203,0
157,776,760,0,64,296,0,0,0,1,202,0
157,712,752,0,64,296,0,0,0,1,201,0
157,648,656,0,64,64,0,0,0,1,200,0
157,976,584,0,64,296,0,0,0,1,199,0
157,960,120,0,64,296,0,0,0,1,198,0
157,992,232,0,64,296,0,0,0,1,197,0
157,944,232,0,64,296,0,0,0,1,196,0
157,904,448,0,32,32,0,0,0,1,195,0
157,912,584,0,64,296,0,0,0,1,194,0
157,896,240,0,64,296,0,0,0,1,193,0
157,896,216,0,64,296,0,0,0,1,192,0
157,896,112,0,64,296,0,0,0,1,191,0
157,832,104,0,64,296,0,0,0,1,190,0
157,832,240,0,64,296,0,0,0,1,189,0
157,768,128,0,64,296,0,0,0,1,188,0
157,768,296,0,64,64,0,0,0,1,187,0
157,768,360,0,64,64,0,0,0,1,182,0
157,704,48,0,64,64,0,0,0,1,181,0
157,704,112,0,64,64,0,0,0,1,180,0
157,704,96,0,64,64,0,0,0,1,179,0
157,704,168,0,64,64,0,0,0,1,178,0
157,704,232,0,64,64,0,0,0,1,177,0
157,704,296,0,64,64,0,0,0,1,176,0
157,704,360,0,64,64,0,0,0,1,175,0
157,856,464,0,64,64,0,0,0,1,169,0
157,856,528,0,64,64,0,0,0,1,168,0
157,856,592,0,64,64,0,0,0,1,167,0
157,792,592,0,64,64,0,0,0,1,166,0
157,776,592,0,64,64,0,0,0,1,165,0
157,712,592,0,64,64,0,0,0,1,164,0
157,648,464,0,64,64,0,0,0,1,160,0
157,648,592,0,64,64,0,0,0,1,154,0
157,648,528,0,64,64,0,0,0,1,153,0
157,584,624,0,64,296,0,0,0,1,151,0
157,528,608,0,64,296,0,0,0,1,150,0
157,472,608,0,64,296,0,0,0,1,149,0
157,408,608,0,64,296,0,0,0,1,148,0
157,344,608,0,64,296,0,0,0,1,147,0
157,280,600,0,64,296,0,0,0,1,145,0
157,216,600,0,64,296,0,0,0,1,144,0
157,152,600,0,64,296,0,0,0,1,143,0
157,88,600,0,64,296,0,0,0,1,142,0
157,24,584,0,64,296,0,0,0,1,141,0
157,24,424,0,64,64,0,0,0,1,140,0
157,80,424,0,64,64,0,0,0,1,139,0
157,144,424,0,64,64,0,0,0,1,138,0
157,200,424,0,64,64,0,0,0,1,137,0
157,264,424,0,64,64,0,0,0,1,136,0
157,584,496,0,64,64,0,0,0,1,135,0
157,600,448,0,32,32,0,0,0,1,134,0
157,312,408,0,32,32,0,0,0,1,133,0
157,312,416,0,32,32,0,0,0,1,132,0
157,312,448,0,32,32,0,0,0,1,131,0
157,640,16,0,64,64,0,0,0,1,130,0
157,640,80,0,64,64,0,0,0,1,129,0
157,640,144,0,64,64,0,0,0,1,128,0
157,640,208,0,64,64,0,0,0,1,127,0
157,640,304,0,64,64,0,0,0,1,126,0
157,640,272,0,64,64,0,0,0,1,125,0
157,568,448,0,32,32,0,0,0,1,121,0
157,536,448,0,32,32,0,0,0,1,120,0
157,504,448,0,32,32,0,0,0,1,119,0
157,552,360,0,64,64,0,0,0,1,118,0
157,552,336,0,64,64,0,0,0,1,117,0
157,552,272,0,64,64,0,0,0,1,116,0
157,472,448,0,32,32,0,0,0,1,111,0
157,440,448,0,32,32,0,0,0,1,110,0
157,344,448,0,32,32,0,0,0,1,109,0
157,376,448,0,32,32,0,0,0,1,108,0
157,408,448,0,32,32,0,0,0,1,107,0
157,640,360,0,64,64,0,0,0,1,106,0
157,584,360,0,64,64,0,0,0,1,105,0
157,456,360,0,64,64,0,0,0,1,103,0
157,32,360,0,64,64,0,0,0,1,102,0
157,80,360,0,64,64,0,0,0,1,101,0
157,128,360,0,64,64,0,0,0,1,100,0
157,160,360,0,64,64,0,0,0,1,99,0
157,264,360,0,64,64,0,0,0,1,98,0
157,360,360,0,64,64,0,0,0,1,97,0
157,584,336,0,64,64,0,0,0,1,95,0
157,608,336,0,64,64,0,0,0,1,94,0
157,608,272,0,64,64,0,0,0,1,93,0
157,584,272,0,64,64,0,0,0,1,92,0
157,456,336,0,64,64,0,0,0,1,89,0
157,456,272,0,64,64,0,0,0,1,88,0
157,360,272,0,64,64,0,0,0,1,85,0
157,360,336,0,64,64,0,0,0,1,83,0
157,269,335,0,64,64,0,0,0,1,79,0
157,256,304,0,64,64,0,0,0,1,78,0
157,296,360,0,64,64,0,0,0,1,77,0
157,296,304,0,64,64,0,0,0,1,76,0
157,216,360,0,64,64,0,0,0,1,74,0
157,158,349,0,64,64,0,0,0,1,73,0
157,152,304,0,64,64,0,0,0,1,72,0
157,208,304,0,64,64,0,0,0,1,71,0
157,96,352,0,64,64,0,0,0,1,70,0
157,96,304,0,64,64,0,0,0,1,69,0
157,32,352,0,64,64,0,0,0,1,68,0
157,32,304,0,64,64,0,0,0,1,67,0
157,312,256,0,32,32,0,0,0,1,66,0
157,184,192,0,32,32,0,0,0,1,65,0
157,280,256,0,32,32,0,0,0,1,64,0
157,248,256,0,32,32,0,0,0,1,63,0
157,216,256,0,32,32,0,0,0,1,62,0
157,184,256,0,32,32,0,0,0,1,61,0
157,152,192,0,32,32,0,0,0,1,37,0
157,272,128,0,32,32,0,0,0,1,55,0
157,272,96,0,32,32,0,0,0,1,54,0
157,272,64,0,32,32,0,0,0,1,53,0
157,272,160,0,32,32,0,0,0,1,52,0
157,272,192,0,32,32,0,0,0,1,51,0
157,240,192,0,32,32,0,0,0,1,50,0
157,208,192,0,32,32,0,0,0,1,49,0
157,16,192,0,32,32,0,0,0,1,46,0
157,16,224,0,32,32,0,0,0,1,45,0
157,16,256,0,32,32,0,0,0,1,44,0
157,24,256,0,32,32,0,0,0,1,43,0
157,56,256,0,32,32,0,0,0,1,42,0
157,88,256,0,32,32,0,0,0,1,41,0
157,120,256,0,32,32,0,0,0,1,40,0
157,152,256,0,32,32,0,0,0,1,39,0
157,16,160,0,32,32,0,0,0,1,35,0
157,24,160,0,32,32,0,0,0,1,34,0
157,56,160,0,32,32,0,0,0,1,33,0
157,120,160,0,32,32,0,0,0,1,31,0
157,144,160,0,32,32,0,0,0,1,30,0
157,208,160,0,32,32,0,0,0,1,29,0
157,176,160,0,32,32,0,0,0,1,28,0
157,240,8,0,32,32,0,0,0,1,24,0
157,240,32,0,32,32,0,0,0,1,23,0
157,240,64,0,32,32,0,0,0,1,22,0
157,144,64,0,32,32,0,0,0,1,19,0
157,112,64,0,32,32,0,0,0,1,11,0
157,80,64,0,32,32,0,0,0,1,5,0
157,48,64,0,32,32,0,0,0,1,3,0
157,16,64,0,32,32,0,0,0,1,2,0
157,152,224,0,32,32,0,0,0,1,38,0
172,488,240,0,0,0,0,0,0,1,115,1
172,392,240,0,0,0,0,0,0,0,87,1
172,72,144,0,0,0,0,0,0,1,36,1
172,192,48,0,1,0,0,0,0,1,21,1
172,160,48,0,0,0,0,0,0,1,20,1
301,592,392,0,0,0,270,159,0,1,157,1
166,624,392,0,0,0,271,0,0,0,159,1
166,400,344,0,0,0,0,0,0,1,122,1
166,488,304,0,0,0,0,0,0,1,96,1
155,816,440,0,2,2,0,0,0,1,172,0
155,696,440,0,1,2,0,0,0,1,171,0
155,80,0,0,2,1,0,0,0,1,9,0
155,80,32,0,1,1,0,0,0,1,8,0
1234567890
25,176,176,80,80,160,0,10002,0,0,0,0
25,176,176,80,80,160,80,10002,0,0,0,0
25,176,176,80,80,240,80,10002,0,0,0,0
25,176,176,80,80,224,160,10002,0,0,0,0
25,176,176,80,80,304,160,10002,0,0,0,0
25,176,176,80,80,0,176,10002,0,0,0,0
25,176,176,64,16,80,176,10002,0,0,0,0
25,176,176,80,16,80,192,10002,0,0,0,0
25,176,176,80,16,80,208,10002,0,0,0,0
25,176,176,80,16,80,224,10002,0,0,0,0
25,176,176,48,16,160,208,10002,0,0,0,0
25,208,176,16,16,208,208,10002,0,0,0,0
25,208,176,16,16,208,224,10002,0,0,0,0
25,208,176,16,16,192,224,10002,0,0,0,0
25,208,176,16,16,176,224,10002,0,0,0,0
25,208,176,16,16,160,224,10002,0,0,0,0
25,208,176,16,16,80,160,10002,0,0,0,0
25,208,176,16,16,64,160,10002,0,0,0,0
25,208,176,16,16,96,160,10002,0,0,0,0
25,176,176,80,80,0,64,10002,0,0,0,0
25,176,176,80,80,80,64,10002,0,0,0,0
25,176,176,80,48,80,0,10002,0,0,0,0
25,176,176,80,48,0,0,10002,0,0,0,0
25,176,176,80,48,256,0,10002,0,0,0,0
25,176,176,64,32,288,48,10002,0,0,0,0
25,176,176,80,80,320,80,10002,0,0,0,0
25,176,176,80,80,352,0,10002,0,0,0,0
25,208,192,16,48,336,0,10002,0,0,0,0
25,176,176,80,80,384,160,10002,0,0,0,0
25,176,176,80,80,400,80,10002,0,0,0,0
25,176,176,80,80,432,0,10002,0,0,0,0
25,176,176,80,80,512,0,10002,0,0,0,0
25,176,176,80,80,592,0,10002,0,0,0,0
25,176,176,80,80,592,80,10002,0,0,0,0
25,176,176,80,80,512,80,10002,0,0,0,0
25,176,176,32,80,480,80,10002,0,0,0,0
25,176,176,80,80,464,160,10002,0,0,0,0
25,176,176,80,80,544,160,10002,0,0,0,0
25,176,176,48,80,480,256,10002,0,0,0,0
25,176,176,48,80,384,256,10002,0,0,0,0
25,176,176,48,80,480,336,10002,0,0,0,0
25,176,176,48,80,496,416,10002,0,0,0,0
25,176,176,48,80,384,336,10002,0,0,0,0
25,176,176,48,80,320,384,10002,0,0,0,0
25,224,176,16,48,368,384,10002,0,0,0,0
25,192,240,64,16,384,416,10002,0,0,0,0
25,208,208,48,16,448,416,10002,0,0,0,0
25,192,176,48,32,432,384,10002,0,0,0,0
25,192,176,48,32,528,384,10002,0,0,0,0
25,192,176,48,32,544,416,10002,0,0,0,0
25,176,176,64,48,576,368,10002,0,0,0,0
25,176,176,64,48,592,416,10002,0,0,0,0
25,176,176,64,48,640,368,10002,0,0,0,0
25,176,176,64,48,656,416,10002,0,0,0,0
25,176,176,64,48,704,368,10002,0,0,0,0
25,176,176,64,48,672,464,10002,0,0,0,0
25,176,176,64,48,720,416,10002,0,0,0,0
25,176,176,64,48,736,464,10002,0,0,0,0
25,176,176,64,48,800,464,10002,0,0,0,0
25,176,176,64,48,784,416,10002,0,0,0,0
25,176,176,64,48,768,368,10002,0,0,0,0
25,176,176,64,48,768,512,10002,0,0,0,0
25,176,176,64,48,704,512,10002,0,0,0,0
25,176,176,64,48,640,512,10002,0,0,0,0
38,400,144,48,32,384,192,10000,0,0,0,0
38,400,144,48,32,480,192,10000,0,0,0,0
38,32,336,32,16,256,224,9998,0,0,0,0
38,32,336,32,16,176,128,9998,0,0,0,0
38,352,224,32,32,96,80,9998,0,0,0,0
38,352,224,32,32,352,128,9998,0,0,0,0
25,176,176,32,16,64,144,10002,0,0,0,0
25,176,176,32,16,96,144,10002,0,0,0,0
25,176,176,48,16,384,240,10002,0,0,0,0
25,176,176,48,16,480,240,10002,0,0,0,0
24,0,192,32,32,400,304,10000,0,0,0,0
24,256,80,64,64,544,176,10000,0,0,0,0
24,464,128,32,16,192,224,10000,0,0,0,0
24,464,112,32,16,432,416,10000,0,0,0,0
24,0,160,32,32,336,400,10000,0,0,0,0
38,448,80,48,16,384,320,9998,0,0,0,0
25,176,176,32,48,864,384,10002,0,0,0,0
25,192,176,16,32,848,384,10002,0,0,0,0
25,192,176,16,32,848,416,10002,0,0,0,0
25,192,176,16,32,832,384,10002,0,0,0,0
25,192,176,64,80,896,384,10002,0,0,0,0
25,192,176,64,80,960,384,10002,0,0,0,0
987654321
NCkdUlFi

