UVx6TlN0AGU9Z1x5ZllMAnogf39JQ3xDF25kDFsieBk3PDw8KSQ9ZmRjbV9+STsqAHQ=
160,448,144,0,0,16777215,0,0,0,1,3,0
158,152,152,0,1,16777215,0,1,0,1,2,0
123,448,72,0,128,16777215,0,0,0,1,35,0
100,72,88,0,256,16777215,0,0,0,1,36,0
197,296,152,0,2,0,0,0,0,1,4,0
174,560,152,0,1,0,0,0,0,0,9,1
174,584,152,0,0,0,0,0,0,0,8,1
174,544,152,0,1,0,0,0,0,0,7,1
174,528,152,0,1,0,0,0,0,0,6,1
174,344,152,0,1,0,0,0,0,0,5,1
188,240,152,0,0,0,0,0,0,1,12,0
188,272,168,0,0,0,0,0,0,1,11,0
188,256,152,0,0,0,0,0,0,1,10,0
157,496,104,0,32,32,0,0,0,1,17,0
157,496,136,0,32,32,0,0,0,1,16,0
157,56,72,0,32,32,0,0,0,1,15,0
157,56,104,0,32,32,0,0,0,1,14,0
157,56,136,0,32,32,0,0,0,1,13,0
157,256,168,0,800,32,0,0,0,1,34,0
1234567890
25,0,0,144,144,0,144,10002,0,0,0,0
25,0,0,144,144,0,288,10002,0,0,0,0
25,0,0,144,144,144,288,10002,0,0,0,0
25,0,0,144,144,288,288,10002,0,0,0,0
25,0,0,144,144,432,288,10002,0,0,0,0
25,0,0,144,144,576,288,10002,0,0,0,0
25,0,0,144,144,576,144,10002,0,0,0,0
25,0,0,144,144,432,144,10002,0,0,0,0
25,0,0,144,144,288,144,10002,0,0,0,0
25,0,0,144,144,144,144,10002,0,0,0,0
25,0,0,144,144,0,0,10002,0,0,0,0
25,0,0,144,144,144,0,10002,0,0,0,0
25,0,0,144,144,288,0,10002,0,0,0,0
25,0,0,144,144,432,0,10002,0,0,0,0
25,0,0,144,144,576,0,10002,0,0,0,0
39,304,48,96,48,352,144,9998,0,0,0,0
39,304,48,96,48,448,144,9998,0,0,0,0
39,304,48,96,48,544,144,9998,0,0,0,0
39,304,48,96,48,64,144,9998,0,0,0,0
38,448,48,48,32,192,256,9998,0,0,0,0
38,448,48,48,32,336,272,9998,0,0,0,0
38,448,48,48,32,544,256,9998,0,0,0,0
38,448,48,48,32,304,240,9998,0,0,0,0
38,448,48,48,32,304,16,9998,0,0,0,0
38,448,48,48,32,576,48,9998,0,0,0,0
38,448,48,48,32,336,64,9998,0,0,0,0
38,448,48,48,32,256,160,9998,0,0,0,0
38,448,48,48,32,368,224,9998,0,0,0,0
38,448,48,48,32,176,224,9998,0,0,0,0
38,448,48,48,32,112,272,9998,0,0,0,0
38,448,48,48,32,64,288,9998,0,0,0,0
38,448,48,48,32,64,192,9998,0,0,0,0
987654321
BgsiCwU0VQ==

