VVh6UkxxBnkpcyF4YUNBA2weaGJ2FW0OFUBBPXJhPEV+enVgKSQ9ZmRjbV9+SQ==
259,880,224,0,392,200,0,0,0,1,156,0
259,560,48,0,352,109,0,0,0,1,146,0
259,912,56,0,352,109,0,0,0,1,143,0
259,176,72,0,336,200,0,0,0,0,62,0
160,968,240,0,0,16777215,0,0,0,1,157,0
158,40,112,0,1,16777215,0,1,0,1,2,0
123,320,128,0,128,16777215,0,0,0,1,30,0
224,352,56,0,128,16777215,0,1,0,1,164,0
123,552,32,0,128,16777215,0,0,0,1,93,0
123,864,184,0,224,16777215,0,0,0,1,155,0
123,40,40,0,128,16777215,0,0,0,1,8,0
100,192,24,0,256,16777215,0,270,0,1,166,0
197,559,96,0,1,97,0,0,0,1,89,0
174,648,80,0,0,86,87,0,0,0,97,1
174,377,213,0,0,91,92,146,0,0,95,1
174,232,80,0,0,33,39,0,0,0,38,1
174,800,96,0,1,97,146,0,0,0,148,1
174,470,67,0,0,86,87,0,0,0,90,1
316,520,96,0,1,1,0,0,0,0,92,0
189,336,32,0,0,128,213,0,0,1,160,0
220,576,112,0,144,32,0,0,0,0,86,1
186,592,96,0,0,0,0,0,0,1,88,0
188,592,248,0,0,151,0,0,0,1,150,0
242,488,224,0,80,100,0,0,0,1,168,0
176,432,224,0,55,32,109,0,0,1,68,0
176,432,224,0,62,32,109,0,0,1,61,0
176,432,224,0,66,32,109,0,0,1,64,0
176,432,264,0,95,32,200,0,0,1,94,0
176,144,32,0,24,32,200,0,0,1,23,0
176,320,144,0,24,32,32,0,0,1,32,0
176,320,144,0,38,32,32,0,0,1,37,0
176,784,224,0,151,64,200,0,0,1,158,0
317,552,56,0,92,1,1,0,1,1,91,0
154,320,168,0,1,0.50,32,16,1,1,35,1
157,568,112,0,144,32,0,0,0,1,87,0
157,224,8,0,80,32,0,0,0,1,162,0
157,688,144,0,32,32,0,0,0,1,154,0
157,688,168,0,32,32,0,0,0,1,153,0
157,688,200,0,32,32,0,0,0,1,152,0
157,680,8,0,352,32,0,0,0,1,145,0
157,888,112,0,304,32,0,0,0,1,142,0
157,720,32,0,32,32,0,0,0,1,141,0
157,720,48,0,32,32,0,0,0,1,140,0
157,720,112,0,32,32,0,0,0,1,138,0
157,688,112,0,32,32,0,0,0,1,137,0
157,656,112,0,32,32,0,0,0,1,136,0
157,792,352,0,624,32,0,0,0,1,135,0
157,792,328,0,624,32,0,0,0,1,134,0
157,784,296,0,624,32,0,0,0,1,133,0
157,776,264,0,576,32,0,0,0,1,132,0
157,2000,192,0,752,32,0,0,0,1,131,0
157,2000,176,0,752,32,0,0,0,1,130,0
157,2000,160,0,752,32,0,0,0,1,129,0
157,2000,144,0,752,32,0,0,0,1,128,0
157,2000,128,0,752,32,0,0,0,1,127,0
157,2000,112,0,752,32,0,0,0,1,126,0
157,2000,96,0,752,32,0,0,0,1,125,0
157,2000,80,0,752,32,0,0,0,1,124,0
157,2000,64,0,752,32,0,0,0,1,123,0
157,2000,48,0,752,32,0,0,0,1,122,0
157,2000,32,0,752,32,0,0,0,1,121,0
157,2000,344,0,752,32,0,0,0,1,120,0
157,2000,328,0,752,32,0,0,0,1,119,0
157,2000,312,0,752,32,0,0,0,1,118,0
157,2000,296,0,752,32,0,0,0,1,117,0
157,2000,280,0,752,32,0,0,0,1,116,0
157,2000,264,0,752,32,0,0,0,1,115,0
157,2000,248,0,752,32,0,0,0,1,114,0
157,2000,232,0,752,32,0,0,0,1,113,0
157,2000,216,0,752,32,0,0,0,1,112,0
157,1992,16,0,752,32,0,0,0,1,111,0
157,1416,344,0,752,32,0,0,0,1,110,0
157,1416,336,0,752,32,0,0,0,1,109,0
157,1416,304,0,752,32,0,0,0,1,108,0
157,1416,272,0,752,32,0,0,0,1,107,0
157,1416,240,0,752,32,0,0,0,1,106,0
157,1416,208,0,752,32,0,0,0,1,105,0
157,1416,176,0,752,32,0,0,0,1,104,0
157,1416,144,0,752,32,0,0,0,1,103,0
157,1416,112,0,752,32,0,0,0,1,102,0
157,1416,80,0,752,32,0,0,0,1,101,0
157,1416,48,0,752,32,0,0,0,1,100,0
157,1416,16,0,752,32,0,0,0,1,99,0
157,464,344,0,32,32,0,0,0,1,84,0
157,464,312,0,32,32,0,0,0,1,83,0
157,408,40,0,128,32,0,0,0,1,82,0
157,408,64,0,128,32,0,0,0,1,81,0
157,416,96,0,128,32,0,0,0,1,80,0
157,416,128,0,128,32,0,0,0,1,79,0
157,488,40,0,32,32,0,0,0,1,75,0
157,488,64,0,32,32,0,0,0,1,74,0
157,488,96,0,32,32,0,0,0,1,73,0
157,488,128,0,32,32,0,0,0,1,72,0
157,424,160,0,160,32,0,0,0,1,69,0
157,360,344,0,112,32,0,0,0,1,59,0
157,360,328,0,112,32,0,0,0,1,58,0
157,432,344,0,32,32,0,0,0,1,57,0
157,432,312,0,32,32,0,0,0,1,56,0
157,96,312,0,416,32,0,0,0,1,54,0
157,96,344,0,416,32,0,0,0,1,53,0
157,96,288,0,416,32,0,0,0,1,52,0
157,144,288,0,288,32,0,0,0,1,51,0
157,152,344,0,304,32,0,0,0,1,50,0
157,152,320,0,304,32,0,0,0,1,49,0
157,96,312,0,416,32,0,0,0,1,48,0
157,152,256,0,304,32,0,0,0,1,47,0
157,152,224,0,304,32,0,0,0,1,46,0
157,464,280,0,32,32,0,0,0,1,45,0
157,136,192,0,272,32,0,0,0,1,44,0
157,288,192,0,32,32,0,0,0,1,43,0
157,432,280,0,32,32,0,0,0,1,41,0
157,496,264,0,96,32,0,0,0,1,40,0
157,144,160,0,320,32,0,0,0,1,28,0
157,352,160,0,32,32,0,0,0,1,27,0
157,352,72,0,32,96,0,0,0,1,26,0
157,352,96,0,32,96,0,0,0,1,25,0
157,264,128,0,80,32,0,0,0,1,22,0
157,264,96,0,80,32,0,0,0,1,21,0
157,320,8,0,640,32,0,0,0,1,19,0
157,176,128,0,96,32,0,0,0,1,9,0
157,208,96,0,32,32,0,0,0,1,6,0
157,176,96,0,32,32,0,0,0,1,5,0
157,144,96,0,32,32,0,0,0,1,4,0
157,144,96,0,32,32,0,0,0,1,3,0
157,80,128,0,160,32,0,0,0,1,18,0
169,672,216,0,1,0,0,0,0,1,151,1
169,720,64,0,1,0,0,0,0,0,139,1
172,304,160,0,0,0,0,0,0,0,66,1
172,304,80,0,0,0,0,0,0,1,24,1
166,312,304,0,0,0,0,0,0,1,55,1
155,431,256,0,3,1,0,0,0,1,39,0
155,320,256,0,2,1,0,0,0,1,34,0
155,320,168,0,1,1,0,0,0,0,33,0
1234567890
25,208,112,32,16,304,80,10002,0,0,0,0
25,176,176,80,80,0,16,10002,0,0,0,0
25,176,176,80,80,80,16,10002,0,0,0,0
25,176,176,80,80,160,0,10002,0,0,0,0
25,176,176,80,80,240,0,10002,0,0,0,0
25,176,176,80,80,0,144,10002,0,0,0,0
25,176,176,80,80,80,144,10002,0,0,0,0
25,176,176,80,80,160,144,10002,0,0,0,0
25,176,176,80,80,240,144,10002,0,0,0,0
25,176,176,80,80,368,0,10002,0,0,0,0
25,176,176,80,80,368,80,10002,0,0,0,0
25,176,176,80,80,448,80,10002,0,0,0,0
25,176,176,80,80,448,0,10002,0,0,0,0
25,176,176,80,80,528,0,10002,0,0,0,0
25,176,176,80,80,608,0,10002,0,0,0,0
25,176,176,80,80,608,80,10002,0,0,0,0
25,176,176,80,80,528,80,10002,0,0,0,0
25,176,176,80,80,608,160,10002,0,0,0,0
25,176,176,80,80,528,160,10002,0,0,0,0
25,176,176,80,80,448,160,10002,0,0,0,0
25,176,176,80,80,368,160,10002,0,0,0,0
25,176,176,80,80,288,224,10002,0,0,0,0
25,176,176,80,80,208,224,10002,0,0,0,0
25,176,176,80,80,128,224,10002,0,0,0,0
25,176,176,80,80,48,224,10002,0,0,0,0
25,176,176,48,80,0,224,10002,0,0,0,0
25,176,176,80,80,0,304,10002,0,0,0,0
25,176,176,80,80,80,304,10002,0,0,0,0
25,176,176,80,80,160,304,10002,0,0,0,0
25,176,176,80,80,240,304,10002,0,0,0,0
25,176,176,80,80,320,304,10002,0,0,0,0
25,176,176,80,80,400,304,10002,0,0,0,0
25,176,176,80,80,480,304,10002,0,0,0,0
25,176,176,80,80,560,304,10002,0,0,0,0
25,176,176,80,64,368,240,10002,0,0,0,0
25,176,176,80,64,448,240,10002,0,0,0,0
25,176,176,80,64,528,240,10002,0,0,0,0
25,176,176,80,64,608,240,10002,0,0,0,0
25,176,208,48,48,320,144,10002,0,0,0,0
25,208,224,48,32,320,192,10002,0,0,0,0
25,208,224,48,32,304,96,10002,0,0,0,0
25,208,224,32,16,304,128,10002,0,0,0,0
25,224,208,16,48,320,32,10002,0,0,0,0
25,224,208,16,16,320,16,10002,0,0,0,0
25,224,208,16,16,0,96,10002,0,0,0,0
25,224,208,16,16,16,96,10002,0,0,0,0
25,224,208,16,16,32,96,10002,0,0,0,0
25,224,208,16,16,48,96,10002,0,0,0,0
25,224,208,16,16,64,96,10002,0,0,0,0
25,224,208,16,16,80,96,10002,0,0,0,0
25,224,208,16,16,96,96,10002,0,0,0,0
25,224,208,16,16,112,96,10002,0,0,0,0
25,176,176,80,80,640,304,10002,0,0,0,0
25,176,176,80,80,720,304,10002,0,0,0,0
25,176,176,80,80,688,224,10002,0,0,0,0
25,176,176,80,80,768,224,10002,0,0,0,0
25,176,176,80,80,800,304,10002,0,0,0,0
25,176,176,80,80,880,304,10002,0,0,0,0
25,176,176,80,80,960,304,10002,0,0,0,0
25,176,176,80,80,960,224,10002,0,0,0,0
25,176,176,80,80,848,224,10002,0,0,0,0
25,192,176,32,80,928,224,10002,0,0,0,0
25,176,176,80,80,688,0,10002,0,0,0,0
25,176,176,80,80,688,80,10002,0,0,0,0
25,176,176,80,64,688,160,10002,0,0,0,0
25,176,176,80,80,768,144,10002,0,0,0,0
25,176,176,80,80,848,144,10002,0,0,0,0
25,176,176,80,80,928,144,10002,0,0,0,0
25,176,176,80,80,928,64,10002,0,0,0,0
25,176,176,80,80,848,64,10002,0,0,0,0
25,176,176,80,80,768,64,10002,0,0,0,0
25,176,176,80,64,768,0,10002,0,0,0,0
25,176,176,80,64,848,0,10002,0,0,0,0
25,176,176,80,64,928,0,10002,0,0,0,0
25,176,176,32,80,1008,144,10002,0,0,0,0
25,176,176,32,80,1008,64,10002,0,0,0,0
25,176,176,32,80,1008,-16,10002,0,0,0,0
25,176,176,32,80,1312,0,10002,0,0,0,0
24,256,80,64,64,608,32,10000,0,0,0,0
24,464,112,32,16,224,64,10000,0,0,0,0
987654321
NCkdUlFi

