UVx6TlN0AGU9Z1l2GW58PQlxN3BHGjRHF1V2DFYiIEV+enVgKSQ9ZmRjbV8=
259,480,192,0,32,32,0,0,0,1,110,0
259,480,128,0,32,32,0,0,0,1,107,0
259,192,256,0,32,32,0,0,0,1,104,0
259,480,256,0,32,32,0,0,0,1,94,0
259,448,256,0,32,32,0,0,0,1,93,0
259,192,192,0,32,32,0,0,0,1,54,0
160,432,200,0,0,16777215,0,0,0,1,24,0
100,400,112,0,256,16777215,0,226,0,1,96,0
100,208,144,0,256,16777215,0,308,0,1,51,0
197,480,208,0,2,0,0,0,0,1,109,0
197,480,272,0,2,0,0,0,0,1,99,0
185,360,136,0,0,32,1,0,0,1,129,0
185,376,216,0,0,32,1,0,0,1,127,0
185,280,168,0,0,32,1,0,0,1,126,0
210,480,144,0,105,0,0,0,0,1,103,0
210,448,272,0,97,0,0,0,0,1,98,0
210,192,208,0,98,0,0,0,0,1,97,0
210,192,272,0,103,0,0,0,0,1,105,0
157,352,256,0,32,32,0,0,0,1,128,0
157,512,96,0,32,32,0,0,0,1,91,0
157,512,128,0,32,32,0,0,0,1,90,0
157,512,160,0,32,32,0,0,0,1,89,0
157,512,192,0,32,32,0,0,0,1,88,0
157,512,224,0,32,32,0,0,0,1,87,0
157,512,256,0,32,32,0,0,0,1,86,0
157,512,288,0,32,32,0,0,0,1,85,0
157,480,288,0,32,32,0,0,0,1,83,0
157,448,288,0,32,32,0,0,0,1,82,0
157,416,288,0,32,32,0,0,0,1,81,0
157,208,112,0,32,32,0,0,0,1,79,0
157,160,96,0,32,32,0,0,0,1,78,0
157,192,96,0,32,32,0,0,0,1,77,0
157,224,96,0,32,32,0,0,0,1,76,0
157,256,96,0,32,32,0,0,0,1,75,0
157,288,96,0,32,32,0,0,0,1,74,0
157,448,96,0,32,32,0,0,0,1,73,0
157,416,96,0,32,32,0,0,0,1,72,0
157,384,96,0,32,32,0,0,0,1,71,0
157,352,96,0,32,32,0,0,0,1,70,0
157,320,96,0,32,32,0,0,0,1,69,0
157,319,128,0,32,32,0,0,0,1,65,0
157,288,128,0,32,32,0,0,0,1,64,0
157,256,128,0,32,32,0,0,0,1,63,0
157,224,128,0,32,32,0,0,0,1,62,0
157,192,128,0,32,32,0,0,0,1,61,0
157,160,288,0,32,32,0,0,0,1,60,0
157,160,256,0,32,32,0,0,0,1,59,0
157,160,128,0,32,32,0,0,0,1,58,0
157,160,224,0,32,32,0,0,0,1,57,0
157,160,192,0,32,32,0,0,0,1,56,0
157,160,160,0,32,32,0,0,0,1,55,0
157,480,96,0,32,32,0,0,0,1,22,0
157,480,160,0,32,32,0,0,0,1,21,0
157,480,224,0,32,32,0,0,0,1,18,0
157,448,224,0,32,32,0,0,0,1,17,0
157,416,224,0,32,32,0,0,0,1,16,0
157,384,288,0,32,32,0,0,0,1,15,0
157,384,256,0,32,32,0,0,0,1,14,0
157,416,256,0,32,32,0,0,0,1,13,0
157,352,288,0,32,32,0,0,0,1,11,0
157,192,160,0,32,32,0,0,0,1,10,0
157,192,224,0,32,32,0,0,0,1,8,0
157,320,288,0,32,32,0,0,0,1,5,0
157,288,288,0,32,32,0,0,0,1,4,0
157,256,288,0,32,32,0,0,0,1,3,0
157,224,288,0,32,32,0,0,0,1,2,0
157,192,288,0,32,32,0,0,0,1,47,0
166,408,112,0,0,0,270,0,0,1,106,1
158,264,272,0,1,16777215,0,1,0,1,6,0
1234567890
24,288,176,32,32,320,160,10000,0,0,0,0
24,256,176,32,32,208,144,10000,0,0,0,0
24,128,160,16,16,352,224,10000,0,0,0,0
24,112,192,32,32,352,176,10000,0,0,0,0
24,128,192,16,32,240,144,10000,0,0,0,0
24,0,256,64,32,272,192,10000,0,0,0,0
24,64,256,32,32,368,112,10000,0,0,0,0
24,400,192,16,32,384,224,10000,0,0,0,0
24,400,192,16,32,336,96,10000,0,0,0,0
24,400,192,16,32,288,128,10000,0,0,0,0
24,144,272,272,48,256,288,10000,0,0,0,0
24,160,288,304,32,192,64,10000,0,0,0,0
24,336,0,16,16,240,192,10000,0,0,0,0
24,368,224,96,16,208,256,10000,0,0,0,0
24,464,192,32,16,304,256,10000,0,0,0,0
24,320,192,32,32,544,64,10000,0,0,0,0
24,288,144,32,32,80,288,10000,0,0,0,0
24,192,192,64,64,64,32,10000,0,0,0,0
24,256,240,48,16,416,112,10000,0,0,0,0
24,560,128,16,32,528,96,10000,0,0,0,0
24,560,320,16,32,528,128,10000,0,0,0,0
24,432,144,32,16,416,144,10000,0,0,0,0
36,112,0,112,80,176,144,10002,0,0,0,0
36,112,0,112,80,288,144,10002,0,0,0,0
36,112,0,112,80,288,64,10002,0,0,0,0
36,112,0,112,80,288,224,10002,0,0,0,0
36,112,0,112,80,176,224,10002,0,0,0,0
36,48,0,48,48,464,240,10002,0,0,0,0
36,48,0,48,48,416,240,10002,0,0,0,0
36,48,0,112,112,400,112,10002,0,0,0,0
987654321
LR05FkA2VTpxImNJc05JM0AjaRYAUA==

