UVx6TlN0AGU9Z1gcP1JkHGI2QW9WEjMRNDg7NUwQbx07Ly81aHF/ImRjbV9+STsqAHQ4J0Mq
259,600,176,0,32,32,0,0,0,1,35,0
259,136,176,0,32,32,0,0,0,1,34,0
259,136,120,0,32,32,0,0,0,1,33,0
259,600,120,0,32,32,0,0,0,1,32,0
259,416,32,0,32,32,0,0,0,1,31,0
259,384,32,0,32,32,0,0,0,1,30,0
259,352,32,0,32,32,0,0,0,1,29,0
259,320,32,0,32,32,0,0,0,1,28,0
259,448,64,0,32,32,0,0,0,1,27,0
259,416,64,0,32,32,0,0,0,1,26,0
259,384,64,0,32,32,0,0,0,1,25,0
259,352,64,0,32,32,0,0,0,1,24,0
259,320,64,0,32,32,0,0,0,1,23,0
259,288,64,0,32,32,0,0,0,1,22,0
158,184,160,0,1,16777215,0,1,0,1,7,0
160,536,160,0,0,16777215,0,0,0,1,2,0
218,136,72,0,256,16777215,0,0,0,1,8,0
218,600,72,0,256,16777215,0,180,0,1,9,0
174,472,160,0,1,41,0,0,0,0,40,1
181,184,72,0,0,128,0,0,0,1,17,0
181,552,72,0,0,128,180,0,0,1,18,0
185,568,224,0,0,32,1,0,0,1,15,0
185,472,224,0,0,32,1,0,0,1,14,0
185,376,224,0,0,32,1,0,0,1,13,0
185,280,224,0,0,32,1,0,0,1,12,0
185,184,224,0,0,32,1,0,0,1,11,0
216,376,296,0,-1,0,1,96,UFVOWSNMSVRUTEUjSFVNQU5T,1,45,0
157,136,144,0,32,48,0,0,0,1,6,0
157,600,136,0,32,48,0,0,0,1,5,0
157,272,120,0,296,32,0,0,0,1,4,0
157,368,176,0,496,32,0,0,0,1,3,0
157,472,120,0,296,32,0,0,0,1,44,0
169,480,128,0,0,0,0,0,0,1,41,1
253,328,256,0,1762964,270,0,0,0,1,47,0
253,328,264,0,1762964,270,0,0,0,1,48,0
253,328,272,0,1762964,270,0,0,0,1,49,0
253,328,280,0,1762964,270,0,0,0,1,50,0
253,328,288,0,1762964,270,0,0,0,1,51,0
253,328,296,0,1762964,270,0,0,0,1,52,0
253,328,304,0,1762964,270,0,0,0,1,53,0
253,328,312,0,1762964,270,0,0,0,1,54,0
253,328,320,0,1762964,270,0,0,0,1,55,0
253,328,328,0,1762964,270,0,0,0,1,56,0
253,328,336,0,1762964,270,0,0,0,1,57,0
253,432,256,0,1762964,270,0,0,0,1,58,0
253,432,264,0,1762964,270,0,0,0,1,59,0
253,432,272,0,1762964,270,0,0,0,1,60,0
253,432,280,0,1762964,270,0,0,0,1,61,0
253,432,288,0,1762964,270,0,0,0,1,62,0
253,432,296,0,1762964,270,0,0,0,1,63,0
253,432,304,0,1762964,270,0,0,0,1,64,0
253,432,312,0,1762964,270,0,0,0,1,65,0
253,432,320,0,1762964,270,0,0,0,1,66,0
253,432,328,0,1762964,270,0,0,0,1,67,0
253,432,336,0,1762964,270,0,0,0,1,68,0
166,0,200,0,0,0,0,0,0,1,16,1
1234567890
37,144,176,96,96,0,208,9998,0,0,0,0
37,144,176,96,96,0,304,9998,0,0,0,0
37,144,176,96,96,560,272,9998,0,0,0,0
37,144,176,96,96,96,256,9998,0,0,0,0
37,144,176,96,96,96,352,9998,0,0,0,0
37,144,176,96,96,624,96,9998,0,0,0,0
37,144,176,96,96,16,96,9998,0,0,0,0
35,368,256,32,48,240,112,10002,0,0,0,0
35,368,256,32,48,272,112,10002,0,0,0,0
35,368,256,32,48,208,112,10002,0,0,0,0
35,368,256,32,48,304,112,10002,0,0,0,0
35,368,256,32,48,336,112,10002,0,0,0,0
35,368,256,32,48,368,112,10002,0,0,0,0
35,368,256,32,48,400,112,10002,0,0,0,0
35,368,256,32,48,432,112,10002,0,0,0,0
35,368,256,32,48,480,112,10002,0,0,0,0
35,368,256,32,48,560,112,10002,0,0,0,0
35,368,256,32,48,144,112,10002,0,0,0,0
38,400,144,48,32,576,16,9998,0,0,0,0
38,400,144,48,32,16,16,9998,0,0,0,0
38,400,144,48,32,16,48,9998,0,0,0,0
38,400,144,48,32,64,16,9998,0,0,0,0
38,400,144,48,32,528,16,9998,0,0,0,0
38,400,144,48,32,576,48,9998,0,0,0,0
38,400,144,48,32,64,48,9998,0,0,0,0
38,400,144,48,32,112,16,9998,0,0,0,0
38,400,144,48,32,112,48,9998,0,0,0,0
38,400,144,48,32,160,16,9998,0,0,0,0
38,480,192,48,32,480,304,9998,0,0,0,0
38,480,192,48,32,480,272,9998,0,0,0,0
38,480,192,48,32,224,304,9998,0,0,0,0
38,480,192,48,32,224,272,9998,0,0,0,0
987654321
LR05FkAjED1gOHkOP05bP1hsb1cODj9RCmx1FEdxaxAmajhwInd5Py0lJE9oKQ==

