UVx6TldwAGU9Z1xDBVJOaGI1egpCTjRlL3A7Kls1QBw1Ii0DcXthenh/cUNiVSc2HGgkO18=
368,64,400,0,28,180,0,120,0,1,695,0
329,144,576,0,8,180,0,120,0,1,681,0
363,560,552,0,23,0,0,120,1,1,642,0
349,368,704,0,20,180,0,120,0,1,635,0
347,560,528,0,18,180,0,120,0,1,634,0
347,520,528,0,18,180,0,120,0,1,606,0
333,424,536,0,9,180,0,120,0,1,605,0
333,480,536,0,9,180,0,120,0,1,604,0
333,368,536,0,9,180,0,120,0,1,545,0
332,424,424,0,12,0,0,120,0,1,538,0
333,600,424,0,9,0,0,120,0,1,525,0
333,64,424,0,9,0,0,120,0,1,473,0
364,416,656,0,24,0,0,120,0,1,355,0
363,264,640,0,23,0,0,120,0,1,307,0
331,528,544,0,11,0,0,120,0,1,292,0
335,320,664,0,14,0,0,120,0,1,186,0
332,168,664,0,12,0,0,120,0,1,170,0
330,272,544,0,10,0,0,120,0,1,158,0
329,272,576,0,8,0,0,120,0,1,148,0
160,280,528,0,0,16777215,0,0,0,1,86,0
158,64,704,0,1,16777215,0,1,0,1,3,0
123,168,632,0,128,16777215,0,0,0,1,36,0
123,400,400,0,1000,255,0,0,0,1,18,0
326,320,456,0,5,0,0,120,0,1,508,0
325,64,424,0,4,0,0,120,0,1,494,0
322,192,608,0,1,0,0,120,0,1,346,0
328,272,688,0,7,0,0,120,0,1,281,0
321,424,688,0,0,0,0,120,0,1,783,0
321,88,600,0,0,0,0,120,0,1,784,0
197,88,616,0,2,74,0,0,0,1,69,0
197,424,704,0,2,18,0,0,0,1,116,0
174,272,704,0,1,78,0,0,0,0,79,0
167,320,456,0,592,270,0,0,0,1,19,0
189,560,616,0,0,128,270,0,0,1,118,0
189,512,632,0,0,128,270,0,0,1,117,0
189,464,648,0,0,128,270,0,0,1,119,0
205,250.33,704,0,1,0,0.50,0,0,1,35,0
186,560,592,0,0,0,0,0,0,1,115,0
188,560,592,0,0,91,0,0,0,1,133,0
188,192,616,0,0,57,0,0,0,1,65,0
188,96,704,0,0,32,0,0,0,1,27,0
188,56,616,0,0,22,0,0,0,1,41,0
188,400,704,0,0,91,0,0,0,1,134,0
188,256,704,0,0,5,0,0,0,1,7,0
188,400,704,0,0,0,0,0,0,1,137,0
242,416,696,0,32,16,0,0,0,1,120,0
242,272,584,0,64,64,0,0,0,1,70,0
314,232,600,0,763,16,32,0,0,1,764,0
314,312,600,0,763,16,32,0,0,1,762,0
314,120,688,0,753,16,32,0,0,1,754,0
314,232,688,0,753,16,32,0,0,1,761,0
176,424,688,0,745,32,32,0,0,1,746,0
216,184,432,0,-1,0,0,192,R09PRCBKT0Ih,0,745,0
216,184,408,0,-1,0,0,192,S0lMTCBUSEUgUkVEIExJR0hUIQ==,1,743,0
154,397.00,536,0,2,0.50,48,16,1,1,93,1
154,144,712,0,1,0.50,32,16,1,1,59,1
216,368,600,0,-1,0,0,96,U1FVSVNI,0,763,0
216,176,688,0,-1,0,0,96,U1FVSVNI,0,753,0
157,568,536,0,16,16,0,0,0,1,132,0
157,328,536,0,32,16,0,0,0,1,123,0
157,640,608,0,16,448,0,0,0,1,121,0
157,536,536,0,64,16,0,0,0,1,102,0
157,560,600,0,32,16,0,0,0,1,101,0
157,512,616,0,32,16,0,0,0,1,100,0
157,464,632,0,32,16,0,0,0,1,99,0
157,416,648,0,32,16,0,0,0,1,98,0
157,368,664,0,32,16,0,0,0,1,97,0
157,320,680,0,32,16,0,0,0,1,96,0
157,312,536,0,16,16,0,0,0,1,84,0
157,232,536,0,16,16,0,0,0,1,83,0
157,232,576,0,16,16,0,0,0,1,81,0
157,232,568,0,16,16,0,0,0,1,77,0
157,312,560,0,16,48,0,0,0,1,73,0
157,312,624,0,16,16,0,0,0,1,72,0
157,272,536,0,80,16,0,0,0,1,61,0
157,56,720,0,144,32,0,0,0,1,53,0
157,552,720,0,336,32,0,0,0,1,52,0
157,296,664,0,16,96,0,0,0,1,34,0
157,264,624,0,48,16,0,0,0,1,33,0
157,232,664,0,16,16,0,0,0,1,31,0
157,120,648,0,16,16,0,0,0,1,30,0
157,232,560,0,16,16,0,0,0,1,28,0
157,120,664,0,16,16,0,0,0,1,25,0
157,232,648,0,16,16,0,0,0,1,24,0
157,200,624,0,80,16,0,0,0,1,20,0
157,16,504,0,32,240,0,0,0,1,17,0
157,312,376,0,768,32,0,0,0,1,16,0
157,16,656,0,32,48,0,0,0,1,6,0
157,64,624,0,128,16,0,0,0,1,4,0
157,16,680,0,32,48,0,0,0,1,2,0
157,328,720,0,336,32,0,0,0,1,15,0
169,224,496,0,0,0,0,0,0,0,78,0
169,304,584,0,0,0,0,0,0,1,74,0
169,224,672,0,0,0,0,0,0,1,32,0
169,224,584,0,0,0,0,0,0,1,22,0
169,112,672,0,0,0,0,0,0,1,5,0
166,304,696,0,0,0,0,0,0,1,95,1
155,496,536,0,2,2,0,0,0,1,92,0
155,352,536,0,1,2,0,0,0,0,91,0
155,144,624,0,2,1,200,0,0,1,58,0
155,144,712,0,1,1,0,0,0,0,57,0
1234567890
24,0,0,640,352,0,352,10000,0,0,0,0
25,0,0,624,352,16,352,10002,0,0,0,0
24,256,80,64,64,32,448,9998,0,0,0,0
24,256,80,64,64,32,512,9998,0,0,0,0
24,256,80,64,64,32,384,9998,0,0,0,0
24,256,80,64,64,96,384,9998,0,0,0,0
24,256,80,64,64,160,384,9998,0,0,0,0
24,256,80,64,64,224,384,9998,0,0,0,0
24,256,80,64,64,224,448,9998,0,0,0,0
24,256,80,64,64,160,448,9998,0,0,0,0
24,256,80,64,64,96,448,9998,0,0,0,0
24,256,80,64,64,96,512,9998,0,0,0,0
24,256,80,64,64,160,512,9998,0,0,0,0
24,256,80,64,64,224,512,9998,0,0,0,0
24,256,80,64,64,224,576,9998,0,0,0,0
24,256,80,64,64,160,576,9998,0,0,0,0
24,256,80,64,64,96,576,9998,0,0,0,0
24,256,80,64,64,32,576,9998,0,0,0,0
24,256,80,64,64,32,640,9998,0,0,0,0
24,256,80,64,64,96,640,9998,0,0,0,0
24,256,80,64,64,160,640,9998,0,0,0,0
24,256,80,64,64,224,640,9998,0,0,0,0
24,256,80,64,64,288,640,9998,0,0,0,0
24,256,80,64,64,288,576,9998,0,0,0,0
24,256,80,64,64,288,512,9998,0,0,0,0
24,256,80,64,64,288,448,9998,0,0,0,0
24,256,80,64,64,288,384,9998,0,0,0,0
24,256,80,64,64,352,640,9998,0,0,0,0
24,256,80,64,64,352,384,9998,0,0,0,0
24,256,80,64,64,352,448,9998,0,0,0,0
24,256,80,64,64,352,512,9998,0,0,0,0
24,256,80,64,64,352,576,9998,0,0,0,0
24,256,80,64,64,416,384,9998,0,0,0,0
24,256,80,64,64,416,448,9998,0,0,0,0
24,256,80,64,64,416,512,9998,0,0,0,0
24,256,80,64,64,416,576,9998,0,0,0,0
24,256,80,64,64,416,640,9998,0,0,0,0
24,256,80,64,64,480,384,9998,0,0,0,0
24,256,80,64,64,480,448,9998,0,0,0,0
24,256,80,64,64,480,512,9998,0,0,0,0
24,256,80,64,64,480,576,9998,0,0,0,0
24,256,80,64,64,480,640,9998,0,0,0,0
24,256,80,64,64,544,384,9998,0,0,0,0
24,256,80,64,64,544,448,9998,0,0,0,0
24,256,80,64,64,544,512,9998,0,0,0,0
24,256,80,64,64,544,576,9998,0,0,0,0
24,256,80,64,64,544,640,9998,0,0,0,0
24,256,80,64,64,608,384,9998,0,0,0,0
24,256,80,64,64,608,448,9998,0,0,0,0
24,256,80,64,64,608,512,9998,0,0,0,0
24,256,80,64,64,608,576,9998,0,0,0,0
24,256,80,64,64,608,640,9998,0,0,0,0
987654321
Jkg5Cg8wRGlpLntLPwtENBQ7c1FNFnBbFnA3DEsjYlU9LD9wZDR9Py87NQ==
EAAjDgViUT9qImlHPUwNNlU2fkpdXjFMHSV2WEw+bhomZA==

