UVx6TlN0AGU9Z18cFVFJHQ05VHxFSh9zRDg7PV8idVliZml8NTghenh/cUNi
158,360,176,0,1,16777215,0,1,0,1,2,0
160,272,296,0,0,16777215,0,0,0,1,30,0
123,416,128,0,128,16777215,0,0,0,1,27,0
174,304,176,0,1,28,0,0,0,0,31,1
186,208,200,0,0,0,0,0,0,1,33,0
188,256,200,0,0,29,0,0,0,1,32,0
157,336,232,0,32,32,0,0,0,1,45,0
157,320,216,0,32,32,0,0,0,1,44,0
157,320,248,0,32,32,0,0,0,1,43,0
157,320,280,0,32,32,0,0,0,1,42,0
157,320,312,0,32,32,0,0,0,1,41,0
157,288,312,0,32,32,0,0,0,1,40,0
157,256,312,0,32,32,0,0,0,1,39,0
157,224,304,0,32,32,0,0,0,1,38,0
157,204,283,0,32,32,0,0,0,1,37,0
157,184,269,0,32,32,0,0,0,1,36,0
157,160,256,0,32,32,0,0,0,1,35,0
157,152,232,0,32,32,0,0,0,1,34,0
157,152,104,0,32,32,0,0,0,1,26,0
157,152,200,0,32,32,0,0,0,1,25,0
157,152,136,0,32,32,0,0,0,1,24,0
157,152,168,0,32,32,0,0,0,1,23,0
157,184,96,0,32,32,0,0,0,1,22,0
157,216,216,0,32,32,0,0,0,1,21,0
157,216,96,0,32,32,0,0,0,1,20,0
157,280,192,0,32,32,0,0,0,1,19,0
157,248,216,0,32,32,0,0,0,1,18,0
157,280,96,0,32,32,0,0,0,1,17,0
157,312,96,0,32,32,0,0,0,1,16,0
157,344,96,0,32,32,0,0,0,1,15,0
157,376,96,0,32,32,0,0,0,1,14,0
157,408,96,0,32,32,0,0,0,1,13,0
157,440,96,0,32,32,0,0,0,1,12,0
157,440,128,0,32,32,0,0,0,1,11,0
157,440,160,0,32,32,0,0,0,1,10,0
157,280,160,0,32,32,0,0,0,1,9,0
157,312,192,0,32,32,0,0,0,1,8,0
157,440,192,0,32,32,0,0,0,1,7,0
157,408,192,0,32,32,0,0,0,1,6,0
157,248,96,0,32,32,0,0,0,1,5,0
157,376,192,0,32,32,0,0,0,1,4,0
157,344,192,0,32,32,0,0,0,1,3,0
172,168,200,0,0,0,0,0,0,1,29,1
169,280,112,0,0,0,0,0,0,1,28,1
253,224,248,0,16777215,0,0,0,0,1,48,0
253,248,144,0,16777215,0,0,0,0,1,47,0
253,200,144,0,16777215,0,0,0,0,1,46,0
1234567890
25,256,176,16,16,272,192,10002,0,0,0,0
25,64,64,16,16,304,176,10002,0,0,0,0
25,64,64,16,16,320,176,10002,0,0,0,0
25,352,192,32,16,496,176,10002,0,0,0,0
25,352,192,32,16,480,192,10002,0,0,0,0
25,352,192,32,16,448,208,10002,0,0,0,0
25,352,192,32,16,448,224,10002,0,0,0,0
25,352,192,32,16,400,224,10002,0,0,0,0
25,352,192,32,16,352,208,10002,0,0,0,0
25,592,96,32,48,400,112,10002,0,0,0,0
25,592,96,32,48,400,160,10002,0,0,0,0
25,592,96,32,48,368,128,10002,0,0,0,0
25,592,96,32,48,336,128,10002,0,0,0,0
25,592,96,32,48,304,128,10002,0,0,0,0
25,592,96,32,48,272,128,10002,0,0,0,0
25,592,96,32,48,368,80,10002,0,0,0,0
25,592,96,32,48,336,80,10002,0,0,0,0
25,592,96,32,48,304,80,10002,0,0,0,0
25,592,96,32,48,272,80,10002,0,0,0,0
25,592,96,32,48,240,112,10002,0,0,0,0
25,592,96,32,48,240,160,10002,0,0,0,0
25,592,96,32,48,208,112,10002,0,0,0,0
25,592,96,32,48,176,112,10002,0,0,0,0
25,592,96,32,48,144,112,10002,0,0,0,0
25,592,96,32,48,208,160,10002,0,0,0,0
25,592,96,32,48,176,160,10002,0,0,0,0
25,592,96,32,48,144,160,10002,0,0,0,0
25,592,96,32,48,160,208,10002,0,0,0,0
25,592,96,32,48,192,208,10002,0,0,0,0
25,592,96,32,48,192,256,10002,0,0,0,0
25,592,96,32,48,224,224,10002,0,0,0,0
25,592,96,32,48,224,272,10002,0,0,0,0
25,592,96,32,48,256,208,10002,0,0,0,0
25,592,96,32,48,288,208,10002,0,0,0,0
25,592,96,32,48,288,256,10002,0,0,0,0
24,112,320,48,32,176,224,9998,0,0,0,0
24,112,320,48,32,272,208,9998,0,0,0,0
24,112,320,48,32,224,144,9998,0,0,0,0
24,112,320,48,32,224,112,9998,0,0,0,0
24,112,320,48,32,224,176,9998,0,0,0,0
24,112,320,48,32,320,112,9998,0,0,0,0
24,112,320,48,32,320,144,9998,0,0,0,0
24,112,320,48,32,368,112,9998,0,0,0,0
24,112,320,48,32,384,144,9998,0,0,0,0
24,112,320,48,32,176,112,9998,0,0,0,0
24,112,320,48,32,176,160,9998,0,0,0,0
24,112,320,48,32,240,240,9998,0,0,0,0
24,112,320,48,32,288,272,9998,0,0,0,0
24,112,320,48,32,192,272,9998,0,0,0,0
24,32,0,16,16,288,192,10000,0,0,0,0
987654321
MwAjEUArQ2loMi1IOlleLhQgfk5LEn4=

