VVh6Ukx2CX8pcyF8FEdFOGN1bmJoLClGLjR7HHkHYBY1d2R8dnFyIzo6NRYwC3J7Tyw4JkMqcicrGjVqOiVFLQ==
158,256,224,0,1,16777215,0,1,0,1,2,0
160,952,352,0,0,16777215,0,0,0,1,98,0
100,472,336,0,256,16777215,0,0,0,1,56,0
123,432,112,0,128,16777215,0,0,0,1,24,0
123,904,264,0,128,16777215,0,0,0,1,130,0
123,752,240,0,128,16773117,0,0,0,1,62,0
123,755,240,0,128,255,0,0,0,0,63,0
195,432,104,0,0,128,270,0,28,1,25,0
321,320,248,0,0,0,0,120,0,1,32,0
197,1096,352,0,2,0,0,0,0,1,139,0
197,432,224,0,4,33,0,0,0,1,27,0
197,592,352,0,2,0,0,0,0,1,131,0
316,240,224,0,1,1,0,0,0,1,121,0
167,952,280,0,128,270,0,0,0,1,126,0
205,704.50,288,0,1,0,0.50,0,0,1,119,0
205,584.50,288,0,1,0,0.50,0,0,1,120,0
205,670.33,288,0,1,0,0.50,0,0,1,118,0
308,280,152,0,0,128,252,0,0,1,122,0
185,432,104,0,0,32,1,0,0,1,26,0
185,320,248,0,0,32,1,0,0,1,4,0
176,904,336,0,106,32,32,1,0,1,107,0
176,784,336,0,104,32,32,0,0,1,103,0
176,656,336,0,100,32,32,0,0,1,99,0
176,720,336,0,102,32,32,0,0,1,101,0
176,528,336,0,62,32,32,0,0,1,61,0
176,560,336,0,63,32,32,0,0,1,64,0
216,752,240,0,-1,0,0,192,SU5UUlVERVIgICAgICAgICAgICAgICBJTlRSVURFUg==,1,69,0
210,656,288,0,0,0,0,0,0,1,124,0
157,1128,368,0,32,32,0,0,0,1,138,0
157,1128,336,0,32,32,0,0,0,1,137,0
157,1128,304,0,32,32,0,0,0,1,136,0
157,1096,368,0,32,32,0,0,0,1,135,0
157,1096,304,0,32,32,0,0,0,1,134,0
157,1064,304,0,32,32,0,0,0,1,133,0
157,1064,368,0,32,32,0,0,0,1,132,0
157,904,240,0,32,32,0,0,0,1,97,0
157,968,240,0,32,32,0,0,0,1,96,0
157,936,240,0,32,32,0,0,0,1,95,0
157,1000,240,0,32,32,0,0,0,1,94,0
157,1032,240,0,32,32,0,0,0,1,93,0
157,1032,272,0,32,32,0,0,0,1,92,0
157,1032,304,0,32,32,0,0,0,1,91,0
157,1032,368,0,32,32,0,0,0,1,89,0
157,1000,368,0,32,32,0,0,0,1,88,0
157,968,368,0,32,32,0,0,0,1,87,0
157,936,368,0,32,32,0,0,0,1,86,0
157,904,368,0,32,32,0,0,0,1,85,0
157,872,368,0,32,32,0,0,0,1,84,0
157,880,272,0,32,32,0,0,0,1,83,0
157,848,304,0,32,32,0,0,0,1,82,0
157,840,368,0,32,32,0,0,0,1,81,0
157,816,304,0,32,32,0,0,0,1,80,0
157,808,368,0,32,32,0,0,0,1,79,0
157,784,304,0,32,32,0,0,0,1,78,0
157,776,368,0,32,32,0,0,0,1,77,0
157,752,304,0,32,32,0,0,0,1,76,0
157,744,368,0,32,32,0,0,0,1,75,0
157,720,304,0,32,32,0,0,0,1,74,0
157,712,368,0,32,32,0,0,0,1,73,0
157,688,304,0,32,32,0,0,0,1,72,0
157,680,368,0,32,32,0,0,0,1,71,0
157,656,304,0,32,32,0,0,0,1,70,0
157,648,368,0,32,32,0,0,0,1,60,0
157,624,304,0,32,32,0,0,0,1,59,0
157,592,304,0,32,32,0,0,0,1,58,0
157,616,368,0,32,32,0,0,0,1,57,0
157,584,368,0,32,32,0,0,0,1,55,0
157,552,368,0,32,32,0,0,0,1,54,0
157,520,368,0,32,32,0,0,0,1,53,0
157,488,368,0,32,32,0,0,0,1,52,0
157,456,368,0,32,32,0,0,0,1,51,0
157,456,336,0,32,32,0,0,0,1,50,0
157,456,272,0,32,32,0,0,0,1,49,0
157,456,304,0,32,32,0,0,0,1,48,0
157,248,144,0,32,32,0,0,0,1,47,0
157,216,144,0,32,32,0,0,0,1,46,0
157,216,176,0,32,32,0,0,0,1,45,0
157,216,208,0,32,32,0,0,0,1,44,0
157,216,240,0,32,32,0,0,0,1,43,0
157,240,240,0,32,32,0,0,0,1,42,0
157,560,112,0,32,32,0,0,0,1,41,0
157,560,144,0,32,32,0,0,0,1,40,0
157,560,176,0,32,32,0,0,0,1,39,0
157,528,304,0,32,32,0,0,0,1,38,0
157,560,304,0,32,32,0,0,0,1,37,0
157,560,272,0,32,32,0,0,0,1,36,0
157,560,240,0,32,32,0,0,0,1,35,0
157,560,208,0,32,32,0,0,0,1,34,0
157,496,208,0,32,32,0,0,0,1,29,0
157,496,240,0,32,32,0,0,0,1,10,0
157,464,240,0,32,32,0,0,0,1,9,0
157,432,240,0,32,32,0,0,0,1,8,0
157,400,240,0,32,32,0,0,0,1,7,0
157,368,240,0,32,32,0,0,0,1,6,0
157,272,240,0,32,32,0,0,0,1,3,0
169,848,320,0,0,0,0,0,0,0,106,0
172,512,192,0,0,0,0,0,0,1,33,1
166,752,328,0,0,0,271,0,0,0,104,1
166,688,328,0,0,0,270,0,0,0,102,1
166,616,328,0,0,0,270,0,0,0,100,1
166,360,216,0,0,0,0,0,0,0,28,1
1234567890
25,480,64,16,16,272,160,10002,0,0,0,0
25,480,64,16,16,272,192,10002,0,0,0,0
25,480,64,16,16,256,192,10002,0,0,0,0
25,480,64,16,16,304,160,10002,0,0,0,0
25,480,64,16,16,288,192,10002,0,0,0,0
25,480,64,16,16,256,224,10002,0,0,0,0
25,480,64,16,16,240,224,10002,0,0,0,0
25,480,64,16,16,288,160,10002,0,0,0,0
25,480,64,16,16,320,192,10002,0,0,0,0
25,480,64,16,16,320,160,10002,0,0,0,0
25,480,64,16,16,336,160,10002,0,0,0,0
25,480,64,16,16,352,176,10002,0,0,0,0
25,480,64,16,16,304,192,10002,0,0,0,0
25,480,64,16,16,352,160,10002,0,0,0,0
25,480,64,16,16,352,192,10002,0,0,0,0
25,480,64,16,16,352,208,10002,0,0,0,0
25,480,64,16,16,336,208,10002,0,0,0,0
25,480,64,16,16,320,208,10002,0,0,0,0
25,480,64,16,16,304,208,10002,0,0,0,0
25,480,64,16,16,288,208,10002,0,0,0,0
25,480,64,16,16,272,208,10002,0,0,0,0
25,480,64,16,16,256,208,10002,0,0,0,0
25,480,64,16,16,240,208,10002,0,0,0,0
25,480,64,16,16,240,192,10002,0,0,0,0
25,480,64,16,16,224,176,10002,0,0,0,0
25,480,64,16,16,240,176,10002,0,0,0,0
25,480,64,16,16,224,160,10002,0,0,0,0
25,480,64,16,16,240,160,10002,0,0,0,0
25,480,64,16,16,256,160,10002,0,0,0,0
25,480,64,16,16,256,176,10002,0,0,0,0
25,480,64,16,16,272,176,10002,0,0,0,0
25,480,64,16,16,288,176,10002,0,0,0,0
25,480,64,16,16,304,176,10002,0,0,0,0
25,480,64,16,16,320,176,10002,0,0,0,0
25,480,64,16,16,336,176,10002,0,0,0,0
25,480,64,16,16,336,192,10002,0,0,0,0
25,480,64,16,16,288,224,10002,0,0,0,0
25,480,64,16,16,304,240,10002,0,0,0,0
25,480,64,16,16,320,224,10002,0,0,0,0
25,480,64,16,16,320,240,10002,0,0,0,0
25,480,64,16,16,336,256,10002,0,0,0,0
25,480,64,16,16,368,176,10002,0,0,0,0
25,480,64,16,16,384,192,10002,0,0,0,0
25,480,64,16,16,368,208,10002,0,0,0,0
25,480,64,16,16,384,208,10002,0,0,0,0
25,480,64,16,16,384,160,10002,0,0,0,0
25,480,64,16,16,368,144,10002,0,0,0,0
25,480,64,16,16,384,128,10002,0,0,0,0
25,480,64,16,16,352,128,10002,0,0,0,0
25,480,64,16,16,336,128,10002,0,0,0,0
25,480,64,16,16,320,128,10002,0,0,0,0
25,480,64,16,16,336,144,10002,0,0,0,0
25,480,64,16,16,288,144,10002,0,0,0,0
25,480,64,16,16,272,128,10002,0,0,0,0
25,480,64,16,16,304,112,10002,0,0,0,0
25,480,64,16,16,368,112,10002,0,0,0,0
25,480,64,16,16,272,112,10002,0,0,0,0
24,144,192,16,16,320,208,9998,0,0,0,0
987654321
LkgsDRUsVGlxI2Rdc0dILFEgO09GFzxHWWdlF0kiZRs1ai04YDQ=
BAcnDxUsWT18a2FLJU5BKRhselZKXhkCGmpiFFo/KwFyKDwxcTR4ImRzIAE2WV46
AwckRRRiRCFsJWYOPF9FP0Y/O1tBCzxGVyVEFx4YLBk3LC1waHtiImg8J08mEXI=
Cw08BwxiUSVqJWgCc0lYLhQhelxLXjlWWWZ4FU49aQEzKDU1Kw==

