UVx6TlN0AGU9Z19mCVt3CwlxN2xLDSQOSSknVA59PFliZml8NQ==
160,320,264,0,0,16777215,0,0,0,1,24,0
158,136,264,0,1,16777215,0,1,0,1,17,0
123,272,128,0,128,16777215,0,0,0,1,2,0
381,96,264,0,0,0,0,0,0,1,3,1
210,168,264,0,0,0,0,0,0,1,19,0
157,88,192,0,32,32,0,0,0,1,45,0
157,64,184,0,32,32,0,0,0,1,44,0
157,64,216,0,32,32,0,0,0,1,43,0
157,64,248,0,32,32,0,0,0,1,42,0
157,112,216,0,32,32,0,0,0,1,41,0
157,64,280,0,32,32,0,0,0,1,40,0
157,144,200,0,32,32,0,0,0,1,39,0
157,152,184,0,32,32,0,0,0,1,38,0
157,128,184,0,32,32,0,0,0,1,37,0
157,136,168,0,32,32,0,0,0,1,36,0
157,144,152,0,32,32,0,0,0,1,35,0
157,112,192,0,32,32,0,0,0,1,34,0
157,176,192,0,32,32,0,0,0,1,33,0
157,208,192,0,32,32,0,0,0,1,32,0
157,240,192,0,32,32,0,0,0,1,31,0
157,272,192,0,32,32,0,0,0,1,30,0
157,304,192,0,32,32,0,0,0,1,29,0
157,368,216,0,32,32,0,0,0,1,28,0
157,336,192,0,32,32,0,0,0,1,27,0
157,368,248,0,32,32,0,0,0,1,26,0
157,368,280,0,32,32,0,0,0,1,25,0
157,336,280,0,32,32,0,0,0,1,23,0
157,304,280,0,32,32,0,0,0,1,22,0
157,272,280,0,32,32,0,0,0,1,20,0
157,224,280,0,32,32,0,0,0,1,8,0
157,192,280,0,32,32,0,0,0,1,7,0
157,160,280,0,32,32,0,0,0,1,6,0
157,128,280,0,32,32,0,0,0,1,5,0
157,96,280,0,32,32,0,0,0,1,4,0
157,276,98,0,32,32,0,0,0,1,16,0
169,240,264,0,0,0,0,0,0,1,18,1
1234567890
25,288,96,16,16,192,240,10002,0,0,0,0
25,288,96,16,16,208,240,10002,0,0,0,0
25,288,96,16,16,224,240,10002,0,0,0,0
25,288,96,16,16,240,240,10002,0,0,0,0
25,288,96,16,16,256,240,10002,0,0,0,0
25,288,96,16,16,272,240,10002,0,0,0,0
25,288,96,16,16,288,240,10002,0,0,0,0
25,288,96,16,16,304,240,10002,0,0,0,0
25,288,96,16,16,336,240,10002,0,0,0,0
25,288,96,16,16,320,240,10002,0,0,0,0
25,288,96,16,16,320,224,10002,0,0,0,0
25,288,96,16,16,336,224,10002,0,0,0,0
25,288,96,16,16,304,224,10002,0,0,0,0
25,288,96,16,16,288,224,10002,0,0,0,0
25,288,96,16,16,272,224,10002,0,0,0,0
25,288,96,16,16,256,224,10002,0,0,0,0
25,288,96,16,16,240,224,10002,0,0,0,0
25,288,96,16,16,224,224,10002,0,0,0,0
25,288,96,16,16,192,224,10002,0,0,0,0
25,288,96,16,16,208,224,10002,0,0,0,0
37,192,48,16,16,208,208,9998,0,0,0,0
37,192,48,16,16,224,208,9998,0,0,0,0
37,192,48,16,16,240,208,9998,0,0,0,0
37,192,48,16,16,304,208,9998,0,0,0,0
37,192,48,16,16,208,192,9998,0,0,0,0
37,192,48,16,16,272,192,9998,0,0,0,0
37,192,48,16,16,288,176,9998,0,0,0,0
37,192,48,16,16,240,176,9998,0,0,0,0
37,192,48,16,16,224,176,9998,0,0,0,0
37,192,48,16,16,224,160,9998,0,0,0,0
37,192,48,16,16,240,160,9998,0,0,0,0
37,192,48,16,16,256,160,9998,0,0,0,0
37,192,48,16,16,256,144,9998,0,0,0,0
37,192,48,16,16,208,160,9998,0,0,0,0
37,192,48,16,16,208,176,9998,0,0,0,0
37,192,48,16,16,224,192,9998,0,0,0,0
37,192,48,16,16,240,192,9998,0,0,0,0
37,192,48,16,16,256,208,9998,0,0,0,0
37,192,48,16,16,288,208,9998,0,0,0,0
37,192,48,16,16,304,192,9998,0,0,0,0
37,192,48,16,16,320,224,9998,0,0,0,0
37,192,48,16,16,320,160,9998,0,0,0,0
37,192,48,16,16,320,208,9998,0,0,0,0
37,192,48,16,16,320,192,9998,0,0,0,0
37,192,48,16,16,320,176,9998,0,0,0,0
37,192,48,16,16,304,176,9998,0,0,0,0
37,192,48,16,16,288,192,9998,0,0,0,0
37,192,48,16,16,272,208,9998,0,0,0,0
37,192,48,16,16,256,192,9998,0,0,0,0
37,192,48,16,16,256,176,9998,0,0,0,0
37,192,48,16,16,336,96,9998,0,0,0,0
37,192,48,16,16,304,160,9998,0,0,0,0
37,192,48,16,16,288,160,9998,0,0,0,0
37,192,48,16,16,272,176,9998,0,0,0,0
37,192,48,16,16,272,160,9998,0,0,0,0
37,192,48,16,16,304,144,9998,0,0,0,0
37,192,48,16,16,288,144,9998,0,0,0,0
37,192,48,16,16,320,112,9998,0,0,0,0
37,192,48,16,16,304,112,9998,0,0,0,0
37,192,48,16,16,272,144,9998,0,0,0,0
37,192,48,16,16,240,144,9998,0,0,0,0
37,192,48,16,16,224,144,9998,0,0,0,0
37,192,48,16,16,208,144,9998,0,0,0,0
37,192,48,16,16,208,128,9998,0,0,0,0
37,192,48,16,16,224,128,9998,0,0,0,0
37,192,48,16,16,240,128,9998,0,0,0,0
37,192,48,16,16,256,128,9998,0,0,0,0
37,192,48,16,16,272,128,9998,0,0,0,0
37,192,48,16,16,288,128,9998,0,0,0,0
37,192,48,16,16,304,128,9998,0,0,0,0
37,192,48,16,16,320,128,9998,0,0,0,0
37,192,48,16,16,320,144,9998,0,0,0,0
37,192,48,16,16,352,128,9998,0,0,0,0
37,192,48,16,16,352,144,9998,0,0,0,0
37,192,48,16,16,352,160,9998,0,0,0,0
37,192,48,16,16,352,176,9998,0,0,0,0
37,192,48,16,16,352,192,9998,0,0,0,0
37,192,48,16,16,352,208,9998,0,0,0,0
37,192,48,16,16,352,224,9998,0,0,0,0
37,192,48,16,16,352,240,9998,0,0,0,0
37,192,48,16,16,352,256,9998,0,0,0,0
37,192,48,16,16,336,256,9998,0,0,0,0
37,192,48,16,16,320,256,9998,0,0,0,0
37,192,48,16,16,304,256,9998,0,0,0,0
37,192,48,16,16,288,256,9998,0,0,0,0
37,192,48,16,16,272,256,9998,0,0,0,0
37,192,48,16,16,256,256,9998,0,0,0,0
37,192,48,16,16,240,256,9998,0,0,0,0
37,192,48,16,16,224,256,9998,0,0,0,0
37,192,48,16,16,208,256,9998,0,0,0,0
37,192,48,16,16,192,256,9998,0,0,0,0
37,192,48,16,16,176,256,9998,0,0,0,0
37,192,48,16,16,160,256,9998,0,0,0,0
37,192,48,16,16,144,256,9998,0,0,0,0
37,192,48,16,16,128,256,9998,0,0,0,0
37,192,48,16,16,112,256,9998,0,0,0,0
37,192,48,16,16,96,256,9998,0,0,0,0
37,192,48,16,16,80,256,9998,0,0,0,0
37,192,48,16,16,80,240,9998,0,0,0,0
37,192,48,16,16,96,240,9998,0,0,0,0
37,192,48,16,16,112,240,9998,0,0,0,0
37,192,48,16,16,128,240,9998,0,0,0,0
37,192,48,16,16,144,240,9998,0,0,0,0
37,192,48,16,16,160,240,9998,0,0,0,0
37,192,48,16,16,176,240,9998,0,0,0,0
37,192,48,16,16,176,224,9998,0,0,0,0
37,192,48,16,16,160,224,9998,0,0,0,0
37,192,48,16,16,144,224,9998,0,0,0,0
37,192,48,16,16,128,224,9998,0,0,0,0
37,192,48,16,16,112,224,9998,0,0,0,0
37,192,48,16,16,96,224,9998,0,0,0,0
37,192,48,16,16,80,224,9998,0,0,0,0
37,192,48,16,16,80,208,9998,0,0,0,0
37,192,48,16,16,96,208,9998,0,0,0,0
37,192,48,16,16,112,208,9998,0,0,0,0
37,192,48,16,16,128,208,9998,0,0,0,0
37,192,48,16,16,144,208,9998,0,0,0,0
37,192,48,16,16,160,208,9998,0,0,0,0
37,192,48,16,16,176,208,9998,0,0,0,0
37,192,48,16,16,192,208,9998,0,0,0,0
37,192,48,16,16,80,192,9998,0,0,0,0
37,192,48,16,16,96,192,9998,0,0,0,0
37,192,48,16,16,112,192,9998,0,0,0,0
37,192,48,16,16,128,192,9998,0,0,0,0
37,192,48,16,16,144,192,9998,0,0,0,0
37,192,48,16,16,160,192,9998,0,0,0,0
37,192,48,16,16,176,192,9998,0,0,0,0
37,192,48,16,16,192,192,9998,0,0,0,0
37,192,48,16,16,192,176,9998,0,0,0,0
37,192,48,16,16,176,176,9998,0,0,0,0
37,192,48,16,16,160,176,9998,0,0,0,0
37,192,48,16,16,144,176,9998,0,0,0,0
37,192,48,16,16,128,176,9998,0,0,0,0
37,192,48,16,16,112,176,9998,0,0,0,0
37,192,48,16,16,96,176,9998,0,0,0,0
37,192,48,16,16,80,176,9998,0,0,0,0
37,192,48,16,16,80,160,9998,0,0,0,0
37,192,48,16,16,160,160,9998,0,0,0,0
37,192,48,16,16,176,160,9998,0,0,0,0
37,192,48,16,16,192,160,9998,0,0,0,0
37,192,48,16,16,192,144,9998,0,0,0,0
37,192,48,16,16,80,144,9998,0,0,0,0
37,192,48,16,16,128,160,9998,0,0,0,0
37,192,48,16,16,160,128,9998,0,0,0,0
37,192,48,16,16,128,144,9998,0,0,0,0
37,192,48,16,16,144,144,9998,0,0,0,0
37,192,48,16,16,176,144,9998,0,0,0,0
37,192,48,16,16,160,144,9998,0,0,0,0
37,192,48,16,16,144,160,9998,0,0,0,0
37,192,48,16,16,112,160,9998,0,0,0,0
37,192,48,16,16,96,160,9998,0,0,0,0
37,192,48,16,16,144,128,9998,0,0,0,0
37,192,48,16,16,128,128,9998,0,0,0,0
37,192,48,16,16,96,144,9998,0,0,0,0
37,192,48,16,16,96,128,9998,0,0,0,0
37,192,48,16,16,80,128,9998,0,0,0,0
37,192,48,16,16,112,96,9998,0,0,0,0
37,192,48,16,16,240,80,9998,0,0,0,0
37,192,48,16,16,224,80,9998,0,0,0,0
37,192,48,16,16,208,80,9998,0,0,0,0
37,192,48,16,16,192,80,9998,0,0,0,0
37,192,48,16,16,176,80,9998,0,0,0,0
37,192,48,16,16,160,80,9998,0,0,0,0
37,192,48,16,16,144,80,9998,0,0,0,0
37,192,48,16,16,128,80,9998,0,0,0,0
37,192,48,16,16,112,80,9998,0,0,0,0
37,192,48,16,16,96,80,9998,0,0,0,0
37,192,48,16,16,80,80,9998,0,0,0,0
37,192,48,16,16,80,96,9998,0,0,0,0
37,192,48,16,16,80,112,9998,0,0,0,0
37,192,48,16,16,96,96,9998,0,0,0,0
37,192,48,16,16,96,112,9998,0,0,0,0
37,192,48,16,16,112,144,9998,0,0,0,0
37,192,48,16,16,112,128,9998,0,0,0,0
37,192,48,16,16,112,112,9998,0,0,0,0
37,192,48,16,16,128,96,9998,0,0,0,0
37,192,48,16,16,144,112,9998,0,0,0,0
37,192,48,16,16,176,128,9998,0,0,0,0
37,192,48,16,16,192,128,9998,0,0,0,0
37,192,48,16,16,192,96,9998,0,0,0,0
37,192,48,16,16,208,96,9998,0,0,0,0
37,192,48,16,16,160,112,9998,0,0,0,0
37,192,48,16,16,176,112,9998,0,0,0,0
37,192,48,16,16,192,112,9998,0,0,0,0
37,192,48,16,16,288,112,9998,0,0,0,0
37,192,48,16,16,272,112,9998,0,0,0,0
37,192,48,16,16,256,112,9998,0,0,0,0
37,192,48,16,16,208,112,9998,0,0,0,0
37,192,48,16,16,224,112,9998,0,0,0,0
37,192,48,16,16,240,112,9998,0,0,0,0
37,192,48,16,16,272,96,9998,0,0,0,0
37,192,48,16,16,304,96,9998,0,0,0,0
37,192,48,16,16,320,96,9998,0,0,0,0
37,192,48,16,16,288,96,9998,0,0,0,0
37,192,48,16,16,272,80,9998,0,0,0,0
37,192,48,16,16,256,80,9998,0,0,0,0
37,192,48,16,16,224,96,9998,0,0,0,0
37,192,48,16,16,240,96,9998,0,0,0,0
37,192,48,16,16,256,96,9998,0,0,0,0
37,192,48,16,16,288,80,9998,0,0,0,0
37,192,48,16,16,304,80,9998,0,0,0,0
37,192,48,16,16,320,80,9998,0,0,0,0
37,192,48,16,16,336,80,9998,0,0,0,0
37,192,48,16,16,352,80,9998,0,0,0,0
37,192,48,16,16,352,96,9998,0,0,0,0
37,192,48,16,16,352,112,9998,0,0,0,0
37,192,48,16,16,336,112,9998,0,0,0,0
37,192,48,16,16,336,128,9998,0,0,0,0
37,192,48,16,16,336,144,9998,0,0,0,0
37,192,48,16,16,336,160,9998,0,0,0,0
37,192,48,16,16,336,176,9998,0,0,0,0
37,192,48,16,16,336,192,9998,0,0,0,0
37,192,48,16,16,336,208,9998,0,0,0,0
37,192,48,16,16,336,224,9998,0,0,0,0
37,192,48,16,16,336,240,9998,0,0,0,0
987654321

