UVx6TlN0AGU9Z1x5Kx9MAnlxN31WDjVQEGB5G1cwIEV+enVgKSQ9ZmRjbV8=
259,384,192,0,32,32,0,0,0,1,16,0
158,320,176,0,1,16777215,0,1,0,1,2,0
160,512,176,0,0,16777215,0,0,0,1,7,0
123,376,128,0,128,16777215,0,0,0,1,4,0
100,416,215,0,256,16777215,0,0,0,1,5,0
316,408,176,0,0,1,0,0,0,1,13,0
316,106,82,0,0,1,0,0,0,1,11,0
219,167,105,0,32,32,0,0,0,1,12,1
185,256,264,0,0,32,1,0,0,1,17,0
179,440,160,0,0,32,32,0,0,1,15,0
289,472,160,0,0,0,0,0,0,1,20,0
317,357,176,0,0,1,1,0,0,1,19,0
175,384,160,0,0,60,0,0,0,1,18,0
216,400,96,0,0,0,0,96,PFRFWFQ+,1,14,0
157,216,360,0,32,32,0,0,0,1,116,0
157,200,360,0,32,32,0,0,0,1,115,0
157,184,352,0,32,32,0,0,0,1,114,0
157,168,336,0,32,32,0,0,0,1,113,0
157,152,320,0,32,32,0,0,0,1,112,0
157,136,304,0,32,32,0,0,0,1,111,0
157,120,288,0,32,32,0,0,0,1,110,0
157,104,272,0,32,32,0,0,0,1,109,0
157,88,256,0,32,32,0,0,0,1,108,0
157,72,240,0,32,32,0,0,0,1,107,0
157,180,311,0,32,32,0,0,0,1,106,0
157,164,295,0,32,32,0,0,0,1,105,0
157,148,279,0,32,32,0,0,0,1,104,0
157,132,263,0,32,32,0,0,0,1,103,0
157,164,295,0,32,32,0,0,0,1,102,0
157,148,279,0,32,32,0,0,0,1,101,0
157,132,263,0,32,32,0,0,0,1,100,0
157,56,223,0,32,32,0,0,0,1,99,0
157,100,231,0,32,32,0,0,0,1,98,0
157,224,320,0,32,32,0,0,0,1,97,0
157,208,304,0,32,32,0,0,0,1,96,0
157,192,288,0,32,32,0,0,0,1,95,0
157,176,272,0,32,32,0,0,0,1,94,0
157,160,256,0,32,32,0,0,0,1,93,0
157,144,240,0,32,32,0,0,0,1,92,0
157,128,224,0,32,32,0,0,0,1,91,0
157,112,208,0,32,32,0,0,0,1,90,0
157,96,192,0,32,32,0,0,0,1,89,0
157,80,176,0,32,32,0,0,0,1,88,0
157,128,217,0,32,32,0,0,0,1,87,0
157,112,201,0,32,32,0,0,0,1,86,0
157,96,185,0,32,32,0,0,0,1,85,0
157,149,220,0,32,32,0,0,0,1,84,0
157,133,204,0,32,32,0,0,0,1,83,0
157,117,188,0,32,32,0,0,0,1,82,0
157,101,172,0,32,32,0,0,0,1,81,0
157,80,169,0,32,32,0,0,0,1,80,0
157,416,360,0,32,32,0,0,0,1,79,0
157,400,360,0,32,32,0,0,0,1,78,0
157,384,360,0,32,32,0,0,0,1,77,0
157,368,360,0,32,32,0,0,0,1,76,0
157,352,360,0,32,32,0,0,0,1,75,0
157,336,360,0,32,32,0,0,0,1,74,0
157,320,360,0,32,32,0,0,0,1,73,0
157,304,352,0,32,32,0,0,0,1,72,0
157,288,336,0,32,32,0,0,0,1,71,0
157,272,320,0,32,32,0,0,0,1,70,0
157,256,304,0,32,32,0,0,0,1,69,0
157,240,288,0,32,32,0,0,0,1,68,0
157,224,272,0,32,32,0,0,0,1,67,0
157,208,256,0,32,32,0,0,0,1,66,0
157,192,240,0,32,32,0,0,0,1,65,0
157,176,224,0,32,32,0,0,0,1,64,0
157,160,208,0,32,32,0,0,0,1,63,0
157,144,192,0,32,32,0,0,0,1,62,0
157,128,176,0,32,32,0,0,0,1,61,0
157,112,160,0,32,32,0,0,0,1,60,0
157,257,355,0,32,32,0,0,0,1,59,0
157,241,339,0,32,32,0,0,0,1,58,0
157,225,323,0,32,32,0,0,0,1,57,0
157,209,307,0,32,32,0,0,0,1,56,0
157,193,291,0,32,32,0,0,0,1,55,0
157,177,275,0,32,32,0,0,0,1,54,0
157,161,259,0,32,32,0,0,0,1,53,0
157,145,243,0,32,32,0,0,0,1,52,0
157,129,227,0,32,32,0,0,0,1,51,0
157,113,211,0,32,32,0,0,0,1,50,0
157,97,195,0,32,32,0,0,0,1,49,0
157,226,287,0,32,32,0,0,0,1,48,0
157,210,271,0,32,32,0,0,0,1,47,0
157,194,255,0,32,32,0,0,0,1,46,0
157,178,239,0,32,32,0,0,0,1,45,0
157,162,223,0,32,32,0,0,0,1,44,0
157,146,207,0,32,32,0,0,0,1,43,0
157,130,191,0,32,32,0,0,0,1,42,0
157,114,175,0,32,32,0,0,0,1,41,0
157,81,179,0,32,32,0,0,0,1,40,0
157,132,263,0,32,32,0,0,0,1,39,0
157,116,247,0,32,32,0,0,0,1,38,0
157,100,231,0,32,32,0,0,0,1,37,0
157,84,215,0,32,32,0,0,0,1,36,0
157,68,199,0,32,32,0,0,0,1,35,0
157,280,360,0,32,32,0,0,0,1,34,0
157,264,360,0,32,32,0,0,0,1,33,0
157,248,360,0,32,32,0,0,0,1,32,0
157,232,352,0,32,32,0,0,0,1,31,0
157,216,336,0,32,32,0,0,0,1,30,0
157,200,320,0,32,32,0,0,0,1,29,0
157,184,304,0,32,32,0,0,0,1,28,0
157,168,288,0,32,32,0,0,0,1,27,0
157,152,272,0,32,32,0,0,0,1,26,0
157,136,256,0,32,32,0,0,0,1,25,0
157,120,240,0,32,32,0,0,0,1,24,0
157,104,224,0,32,32,0,0,0,1,23,0
157,64,160,0,32,32,0,0,0,1,22,0
157,108,258,0,32,32,0,0,0,1,21,0
157,480,192,0,320,32,0,0,0,1,8,0
157,304,192,0,32,32,0,0,0,1,3,0
169,169,222,0,0,0,0,0,0,1,10,1
301,317,265,0,0,0,0,0,0,1,9,1
1234567890
25,96,64,16,16,352,192,10002,0,0,0,0
25,96,64,16,16,384,192,10002,0,0,0,0
25,96,64,16,16,416,192,10002,0,0,0,0
25,96,64,16,16,560,176,10002,0,0,0,0
25,96,64,16,16,544,176,10002,0,0,0,0
25,96,64,16,16,528,176,10002,0,0,0,0
25,96,64,16,16,512,176,10002,0,0,0,0
25,96,64,16,16,496,176,10002,0,0,0,0
25,96,64,16,16,480,176,10002,0,0,0,0
25,96,64,16,16,464,176,10002,0,0,0,0
25,96,64,16,16,448,176,10002,0,0,0,0
25,96,64,16,16,432,176,10002,0,0,0,0
25,96,64,16,16,416,176,10002,0,0,0,0
25,96,64,16,16,400,176,10002,0,0,0,0
25,96,64,16,16,384,176,10002,0,0,0,0
25,96,64,16,16,368,176,10002,0,0,0,0
25,96,64,16,16,352,176,10002,0,0,0,0
25,96,64,16,16,336,176,10002,0,0,0,0
25,96,64,16,16,320,176,10002,0,0,0,0
25,96,64,16,16,304,176,10002,0,0,0,0
25,96,64,16,16,288,176,10002,0,0,0,0
25,96,64,16,16,288,192,10002,0,0,0,0
25,96,64,16,16,304,192,10002,0,0,0,0
25,96,64,16,16,448,208,10002,0,0,0,0
25,96,64,16,16,528,208,10002,0,0,0,0
25,96,64,16,16,560,208,10002,0,0,0,0
25,96,64,16,16,544,208,10002,0,0,0,0
25,96,64,16,16,512,208,10002,0,0,0,0
25,96,64,16,16,496,208,10002,0,0,0,0
25,96,64,16,16,480,208,10002,0,0,0,0
25,96,64,16,16,464,208,10002,0,0,0,0
25,96,64,16,16,432,208,10002,0,0,0,0
25,96,64,16,16,416,208,10002,0,0,0,0
25,96,64,16,16,400,208,10002,0,0,0,0
25,96,64,16,16,384,208,10002,0,0,0,0
25,96,64,16,16,368,208,10002,0,0,0,0
25,96,64,16,16,352,208,10002,0,0,0,0
25,96,64,16,16,336,208,10002,0,0,0,0
25,96,64,16,16,320,208,10002,0,0,0,0
25,96,64,16,16,288,208,10002,0,0,0,0
25,96,64,16,16,304,208,10002,0,0,0,0
25,96,64,16,16,320,192,10002,0,0,0,0
25,96,64,16,16,336,192,10002,0,0,0,0
25,96,64,16,16,368,192,10002,0,0,0,0
25,96,64,16,16,400,192,10002,0,0,0,0
25,96,64,16,16,432,192,10002,0,0,0,0
25,96,64,16,16,576,176,10002,0,0,0,0
25,96,64,16,16,576,208,10002,0,0,0,0
25,96,64,16,16,592,208,10002,0,0,0,0
25,96,64,16,16,592,176,10002,0,0,0,0
25,96,64,16,16,608,208,10002,0,0,0,0
25,96,64,16,16,624,208,10002,0,0,0,0
25,96,64,16,16,624,192,10002,0,0,0,0
25,96,64,16,16,624,176,10002,0,0,0,0
25,96,64,16,16,608,176,10002,0,0,0,0
25,96,64,16,16,608,192,10002,0,0,0,0
25,96,64,16,16,592,192,10002,0,0,0,0
25,96,64,16,16,576,192,10002,0,0,0,0
25,96,64,16,16,560,192,10002,0,0,0,0
25,96,64,16,16,544,192,10002,0,0,0,0
25,96,64,16,16,528,192,10002,0,0,0,0
25,96,64,16,16,512,192,10002,0,0,0,0
25,96,64,16,16,496,192,10002,0,0,0,0
25,96,64,16,16,480,192,10002,0,0,0,0
25,96,64,16,16,464,192,10002,0,0,0,0
25,96,64,16,16,448,192,10002,0,0,0,0
24,464,80,32,32,272,144,10000,0,0,0,0
24,464,80,32,32,240,144,10000,0,0,0,0
987654321
LR05FkAjEDpsJn1CNgtBP0IpdxhaEXBPGG5yWAxxbRY6IzwmYHl0ODwg

