UVx6TlN0AGU9Z25DP1lMDUw6fwp7Tx1mODg7NUcCaRY9JD0cYGJ0OmRjbV9+STsqAHQ4J0Mq
158,64,240,0,1,16777215,0,1,0,1,65,0
160,304,96,0,0,16777215,0,0,0,1,16,0
195,40,48,0,0,128,275,0,77,1,70,0
195,288,136,0,0,128,282,0,71,1,79,0
224,240,144,0,128,16777215,0,0,0,1,73,0
224,120,144,0,128,16777215,0,0,0,1,74,0
157,192,48,0,32,32,0,0,0,1,78,0
157,240,32,0,32,32,0,0,0,1,64,0
157,216,32,0,32,32,0,0,0,1,63,0
157,184,32,0,32,32,0,0,0,1,62,0
157,152,32,0,32,32,0,0,0,1,61,0
157,120,32,0,32,32,0,0,0,1,60,0
157,88,32,0,32,32,0,0,0,1,59,0
157,56,32,0,32,32,0,0,0,1,58,0
157,264,32,0,32,32,0,0,0,1,57,0
157,288,32,0,32,32,0,0,0,1,56,0
157,320,32,0,32,32,0,0,0,1,55,0
157,344,32,0,32,32,0,0,0,1,54,0
157,344,88,0,32,32,0,0,0,1,53,0
157,344,56,0,32,32,0,0,0,1,52,0
157,344,128,0,32,32,0,0,0,1,51,0
157,344,112,0,32,32,0,0,0,1,50,0
157,328,112,0,32,32,0,0,0,1,49,0
157,296,112,0,32,32,0,0,0,1,48,0
157,344,152,0,32,32,0,0,0,1,47,0
157,264,112,0,32,32,0,0,0,1,46,0
157,232,112,0,32,32,0,0,0,1,45,0
157,200,112,0,32,32,0,0,0,1,44,0
157,344,256,0,32,32,0,0,0,1,43,0
157,344,224,0,32,32,0,0,0,1,42,0
157,312,256,0,32,32,0,0,0,1,41,0
157,280,256,0,32,32,0,0,0,1,40,0
157,248,256,0,32,32,0,0,0,1,39,0
157,344,216,0,32,32,0,0,0,1,38,0
157,248,184,0,32,32,0,0,0,1,37,0
157,344,184,0,32,32,0,0,0,1,36,0
157,168,112,0,32,32,0,0,0,1,35,0
157,136,112,0,32,32,0,0,0,1,34,0
157,104,112,0,32,32,0,0,0,1,33,0
157,56,184,0,32,32,0,0,0,1,32,0
157,24,64,0,32,32,0,0,0,1,31,0
157,24,128,0,32,32,0,0,0,1,30,0
157,24,192,0,32,32,0,0,0,1,29,0
157,216,256,0,32,32,0,0,0,1,26,0
157,216,184,0,32,32,0,0,0,1,25,0
157,184,184,0,32,32,0,0,0,1,24,0
157,152,184,0,32,32,0,0,0,1,23,0
157,88,184,0,32,32,0,0,0,1,17,0
157,24,32,0,32,32,0,0,0,1,13,0
157,24,96,0,32,32,0,0,0,1,12,0
157,208,256,0,32,32,0,0,0,1,11,0
157,176,256,0,32,32,0,0,0,1,10,0
157,120,184,0,32,32,0,0,0,1,9,0
157,24,160,0,32,32,0,0,0,1,8,0
157,24,256,0,32,32,0,0,0,1,7,0
157,56,256,0,32,32,0,0,0,1,6,0
157,24,224,0,32,32,0,0,0,1,5,0
157,144,256,0,32,32,0,0,0,1,4,0
157,119,256,0,32,32,0,0,0,1,3,0
157,88,256,0,32,32,0,0,0,1,2,0
169,184,64,0,0,0,0,0,0,0,77,1
166,40,152,0,0,0,0,0,0,0,71,1
1234567890
25,416,64,16,16,368,176,10002,0,0,0,0
25,416,64,16,16,400,160,10002,0,0,0,0
25,416,64,16,16,416,176,10002,0,0,0,0
25,416,64,16,16,416,192,10002,0,0,0,0
25,416,64,16,16,432,224,10002,0,0,0,0
25,208,176,48,32,208,96,10002,0,0,0,0
25,208,176,48,32,416,128,10002,0,0,0,0
25,208,176,48,32,480,96,10002,0,0,0,0
25,0,0,48,48,320,192,10002,0,0,0,0
25,0,0,48,48,320,144,10002,0,0,0,0
25,0,0,48,48,320,96,10002,0,0,0,0
25,0,0,48,48,320,48,10002,0,0,0,0
25,0,0,48,48,320,0,10002,0,0,0,0
25,0,0,48,48,272,16,10002,0,0,0,0
25,0,0,48,48,224,16,10002,0,0,0,0
25,0,0,48,48,144,16,10002,0,0,0,0
25,0,0,48,48,96,16,10002,0,0,0,0
25,0,0,48,48,224,160,10002,0,0,0,0
25,0,0,48,48,176,160,10002,0,0,0,0
25,0,0,48,48,128,160,10002,0,0,0,0
25,0,0,48,48,80,160,10002,0,0,0,0
25,0,0,48,48,32,160,10002,0,0,0,0
25,0,0,48,48,48,240,10002,0,0,0,0
25,0,0,48,48,96,240,10002,0,0,0,0
25,0,0,48,48,144,240,10002,0,0,0,0
25,0,0,48,48,192,240,10002,0,0,0,0
25,0,0,48,48,240,240,10002,0,0,0,0
25,0,0,48,48,0,240,10002,0,0,0,0
25,0,0,48,48,288,240,10002,0,0,0,0
25,0,0,48,48,336,240,10002,0,0,0,0
987654321
MwAjEUArQ2loMi1IOlleLhQgfk5LEn4CPGt9F0dxWB07OXk5djRhJCcxIA0+AA==
EwclQggjQi0lPm9ac14KMVojbA==

