UVx6TlN0AGU9Z1lpalJ3GXYPf2BkEAp6MDg7P1I+fhd+enVgKSQ9ZmRjbV9+SQ==
158,48,112,0,1,16777215,0,1,0,1,23,0
160,552,112,0,0,16777215,0,0,0,1,2,0
123,312,312,0,128,16777215,0,0,0,1,22,0
174,512,112,0,1,0,0,0,0,0,21,1
157,288,128,0,32,32,0,0,0,1,20,0
157,232,128,0,32,32,0,0,0,1,19,0
157,264,128,0,32,32,0,0,0,1,18,0
157,320,128,0,32,32,0,0,0,1,17,0
157,168,128,0,32,32,0,0,0,1,16,0
157,200,128,0,32,32,0,0,0,1,15,0
157,72,128,0,32,32,0,0,0,1,14,0
157,104,128,0,32,32,0,0,0,1,13,0
157,136,128,0,32,32,0,0,0,1,12,0
157,416,128,0,32,32,0,0,0,1,11,0
157,40,128,0,32,32,0,0,0,1,10,0
157,384,128,0,32,32,0,0,0,1,9,0
157,352,128,0,32,32,0,0,0,1,8,0
157,448,128,0,32,32,0,0,0,1,7,0
157,480,128,0,32,32,0,0,0,1,6,0
157,576,128,0,32,32,0,0,0,1,5,0
157,544,128,0,32,32,0,0,0,1,4,0
157,512,128,0,32,32,0,0,0,1,3,0
1234567890
37,144,176,96,96,16,32,10000,0,0,0,0
37,144,176,96,96,112,32,10000,0,0,0,0
37,144,176,96,96,208,32,10000,0,0,0,0
37,144,176,96,96,304,32,10000,0,0,0,0
37,144,176,96,96,400,32,10000,0,0,0,0
37,144,176,96,96,496,32,10000,0,0,0,0
25,176,32,128,64,208,64,10002,0,0,0,0
25,176,32,128,64,448,0,10002,0,0,0,0
25,176,32,128,64,384,64,10002,0,0,0,0
25,176,32,128,64,320,144,10002,0,0,0,0
25,176,32,128,64,48,128,10002,0,0,0,0
25,176,32,128,64,144,0,10002,0,0,0,0
38,144,288,32,32,416,80,9998,0,0,0,0
38,144,288,32,32,480,0,9998,0,0,0,0
38,224,0,64,64,16,304,9998,0,0,0,0
38,224,0,64,64,240,272,9998,0,0,0,0
38,224,0,64,64,144,272,9998,0,0,0,0
38,224,0,64,64,592,240,9998,0,0,0,0
38,224,0,64,64,544,128,9998,0,0,0,0
38,224,0,64,64,480,96,9998,0,0,0,0
38,224,0,64,64,416,0,9998,0,0,0,0
38,224,0,64,64,368,304,9998,0,0,0,0
38,224,0,64,64,320,176,9998,0,0,0,0
38,224,0,64,64,256,0,9998,0,0,0,0
38,224,0,64,64,144,16,9998,0,0,0,0
38,224,0,64,64,0,0,9998,0,0,0,0
38,224,0,64,64,16,160,9998,0,0,0,0
38,224,0,64,64,160,176,9998,0,0,0,0
38,224,0,64,64,256,128,9998,0,0,0,0
38,224,0,64,64,352,112,9998,0,0,0,0
38,224,0,64,64,480,224,9998,0,0,0,0
987654321
IAQlEAJs

