UVx6TlN0AGU9Z1oeYl1/HAQrTlVoSAp6M0F0FXg8aDEAD3UEYGdlGykjbV9+STsqAHQ4J0Mqcic=
160,368,168,0,0,16777215,0,0,0,1,5,0
158,168,176,0,1,16777215,0,1,0,1,2,0
224,328,62,0,128,16777215,0,0,0,1,10,0
123,273,88,0,128,16777215,0,0,0,1,6,0
123,136,48,0,128,16777215,0,0,0,1,11,0
189,48,88,0,0,128,0,0,0,1,8,0
157,501,120,0,32,208,0,0,0,1,115,0
157,501,120,0,32,208,0,0,0,1,114,0
157,501,120,0,32,208,0,0,0,1,113,0
157,517,137,0,32,208,0,0,0,1,112,0
157,501,121,0,32,208,0,0,0,1,111,0
157,485,104,0,32,208,0,0,0,1,110,0
157,365,253,0,320,48,0,0,0,1,109,0
157,412,307,0,320,48,0,0,0,1,108,0
157,396,291,0,320,48,0,0,0,1,107,0
157,412,308,0,320,48,0,0,0,1,106,0
157,396,292,0,320,48,0,0,0,1,105,0
157,380,275,0,320,48,0,0,0,1,104,0
157,517,138,0,32,208,0,0,0,1,103,0
157,549,170,0,32,208,0,0,0,1,102,0
157,533,154,0,32,208,0,0,0,1,101,0
157,517,138,0,32,208,0,0,0,1,100,0
157,500,123,0,32,208,0,0,0,1,99,0
157,363,261,0,320,48,0,0,0,1,98,0
157,349,234,0,320,48,0,0,0,1,97,0
157,345,248,0,320,48,0,0,0,1,96,0
157,345,248,0,320,48,0,0,0,1,95,0
157,345,248,0,320,48,0,0,0,1,94,0
157,361,266,0,320,48,0,0,0,1,93,0
157,361,266,0,320,48,0,0,0,1,92,0
157,361,266,0,320,48,0,0,0,1,91,0
157,345,250,0,320,48,0,0,0,1,90,0
157,345,250,0,320,48,0,0,0,1,89,0
157,333,227,0,320,48,0,0,0,1,88,0
157,326,236,0,320,48,0,0,0,1,87,0
157,348,268,0,320,48,0,0,0,1,86,0
157,348,268,0,320,48,0,0,0,1,85,0
157,332,252,0,320,48,0,0,0,1,84,0
157,316,236,0,320,48,0,0,0,1,83,0
157,315,218,0,320,48,0,0,0,1,82,0
157,469,87,0,32,208,0,0,0,1,81,0
157,485,106,0,32,208,0,0,0,1,80,0
157,489,112,0,32,208,0,0,0,1,79,0
157,489,112,0,32,208,0,0,0,1,78,0
157,488,110,0,32,208,0,0,0,1,77,0
157,502,121,0,32,208,0,0,0,1,76,0
157,486,105,0,32,208,0,0,0,1,75,0
157,473,96,0,32,208,0,0,0,1,74,0
157,486,105,0,32,208,0,0,0,1,73,0
157,468,93,0,32,208,0,0,0,1,72,0
157,470,89,0,32,208,0,0,0,1,71,0
157,486,105,0,32,208,0,0,0,1,70,0
157,470,89,0,32,208,0,0,0,1,69,0
157,486,105,0,32,208,0,0,0,1,68,0
157,470,89,0,32,208,0,0,0,1,67,0
157,502,121,0,32,208,0,0,0,1,66,0
157,486,105,0,32,208,0,0,0,1,65,0
157,502,121,0,32,208,0,0,0,1,64,0
157,486,105,0,32,208,0,0,0,1,63,0
157,502,121,0,32,208,0,0,0,1,62,0
157,550,169,0,32,208,0,0,0,1,61,0
157,534,153,0,32,208,0,0,0,1,60,0
157,518,137,0,32,208,0,0,0,1,59,0
157,566,185,0,32,208,0,0,0,1,58,0
157,550,169,0,32,208,0,0,0,1,57,0
157,640,313,0,32,208,0,0,0,1,56,0
157,640,297,0,32,208,0,0,0,1,55,0
157,640,281,0,32,208,0,0,0,1,54,0
157,640,265,0,32,208,0,0,0,1,53,0
157,630,249,0,32,208,0,0,0,1,52,0
157,614,233,0,32,208,0,0,0,1,51,0
157,598,217,0,32,208,0,0,0,1,50,0
157,582,201,0,32,208,0,0,0,1,49,0
157,566,185,0,32,208,0,0,0,1,48,0
157,640,360,0,224,208,0,0,0,1,47,0
157,640,360,0,224,208,0,0,0,1,46,0
157,640,360,0,224,208,0,0,0,1,45,0
157,640,360,0,224,208,0,0,0,1,44,0
157,640,360,0,224,208,0,0,0,1,43,0
157,640,360,0,224,208,0,0,0,1,42,0
157,640,360,0,224,208,0,0,0,1,41,0
157,640,360,0,224,208,0,0,0,1,40,0
157,640,360,0,224,208,0,0,0,1,39,0
157,640,360,0,224,208,0,0,0,1,38,0
157,640,360,0,32,208,0,0,0,1,37,0
157,640,360,0,32,208,0,0,0,1,36,0
157,640,360,0,32,208,0,0,0,1,35,0
157,640,360,0,32,208,0,0,0,1,34,0
157,640,360,0,32,208,0,0,0,1,33,0
157,640,360,0,32,208,0,0,0,1,32,0
157,640,360,0,32,208,0,0,0,1,31,0
157,640,345,0,32,208,0,0,0,1,30,0
157,640,329,0,32,208,0,0,0,1,29,0
157,640,313,0,32,208,0,0,0,1,28,0
157,640,297,0,32,208,0,0,0,1,27,0
157,640,281,0,32,208,0,0,0,1,26,0
157,640,265,0,32,208,0,0,0,1,25,0
157,630,249,0,32,208,0,0,0,1,24,0
157,614,233,0,32,208,0,0,0,1,23,0
157,598,217,0,32,208,0,0,0,1,22,0
157,582,201,0,32,208,0,0,0,1,21,0
157,566,185,0,32,208,0,0,0,1,20,0
157,550,169,0,32,208,0,0,0,1,19,0
157,534,153,0,32,208,0,0,0,1,18,0
157,518,137,0,32,208,0,0,0,1,17,0
157,502,121,0,32,208,0,0,0,1,16,0
157,486,105,0,32,208,0,0,0,1,15,0
157,470,89,0,32,208,0,0,0,1,14,0
157,453,76,0,32,208,0,0,0,1,13,0
157,438,57,0,32,208,0,0,0,1,12,0
157,295,209,0,320,48,0,0,0,1,4,0
166,369,69,0,0,0,0,0,0,1,9,1
166,96,144,0,0,0,0,0,0,1,7,1
1234567890
25,192,144,16,16,224,144,10002,0,0,0,0
25,192,144,16,16,288,176,10002,0,0,0,0
25,192,144,16,16,304,176,10002,0,0,0,0
25,192,144,16,16,416,176,10002,0,0,0,0
25,192,144,16,16,400,160,10002,0,0,0,0
25,192,144,16,16,400,144,10002,0,0,0,0
25,192,144,16,16,320,48,10002,0,0,0,0
25,192,144,16,16,304,48,10002,0,0,0,0
25,192,144,16,16,272,176,10002,0,0,0,0
25,192,144,16,16,320,112,10002,0,0,0,0
25,192,144,16,16,288,112,10002,0,0,0,0
25,192,144,16,16,304,80,10002,0,0,0,0
25,192,144,16,16,288,80,10002,0,0,0,0
25,192,144,16,16,288,96,10002,0,0,0,0
25,192,144,16,16,272,96,10002,0,0,0,0
25,192,144,16,16,272,112,10002,0,0,0,0
25,192,144,16,16,272,128,10002,0,0,0,0
25,192,144,16,16,304,112,10002,0,0,0,0
25,192,144,16,16,304,96,10002,0,0,0,0
25,192,144,16,16,320,96,10002,0,0,0,0
25,192,144,16,16,320,80,10002,0,0,0,0
25,192,144,16,16,320,64,10002,0,0,0,0
25,192,144,16,16,304,64,10002,0,0,0,0
25,192,144,16,16,336,64,10002,0,0,0,0
25,192,144,16,16,336,48,10002,0,0,0,0
25,192,144,16,16,336,32,10002,0,0,0,0
25,192,144,16,16,352,48,10002,0,0,0,0
25,192,144,16,16,352,64,10002,0,0,0,0
25,192,144,16,16,352,80,10002,0,0,0,0
25,192,144,16,16,336,80,10002,0,0,0,0
25,192,144,16,16,256,176,10002,0,0,0,0
25,192,144,16,16,304,144,10002,0,0,0,0
25,192,144,16,16,320,128,10002,0,0,0,0
25,192,144,16,16,288,128,10002,0,0,0,0
25,192,144,16,16,288,144,10002,0,0,0,0
25,192,144,16,16,272,160,10002,0,0,0,0
25,192,144,16,16,256,128,10002,0,0,0,0
25,192,144,16,16,256,144,10002,0,0,0,0
25,192,144,16,16,240,160,10002,0,0,0,0
25,192,144,16,16,208,192,10002,0,0,0,0
25,192,144,16,16,224,176,10002,0,0,0,0
25,192,144,16,16,256,160,10002,0,0,0,0
25,192,144,16,16,272,144,10002,0,0,0,0
25,192,144,16,16,304,128,10002,0,0,0,0
25,192,144,16,16,352,96,10002,0,0,0,0
25,192,144,16,16,352,128,10002,0,0,0,0
25,192,144,16,16,336,96,10002,0,0,0,0
25,192,144,16,16,336,112,10002,0,0,0,0
25,192,144,16,16,336,128,10002,0,0,0,0
25,192,144,16,16,320,144,10002,0,0,0,0
25,192,144,16,16,320,192,10002,0,0,0,0
25,192,144,16,16,336,144,10002,0,0,0,0
25,192,144,16,16,352,112,10002,0,0,0,0
25,192,144,16,16,368,64,10002,0,0,0,0
25,192,144,16,16,384,48,10002,0,0,0,0
25,192,144,16,16,368,48,10002,0,0,0,0
25,192,144,16,16,368,80,10002,0,0,0,0
25,192,144,16,16,368,96,10002,0,0,0,0
25,192,144,16,16,368,112,10002,0,0,0,0
25,192,144,16,16,368,144,10002,0,0,0,0
25,192,144,16,16,368,128,10002,0,0,0,0
25,192,144,16,16,384,96,10002,0,0,0,0
25,192,144,16,16,384,112,10002,0,0,0,0
25,192,144,16,16,384,128,10002,0,0,0,0
25,192,144,16,16,336,160,10002,0,0,0,0
25,192,144,16,16,352,160,10002,0,0,0,0
25,192,144,16,16,368,160,10002,0,0,0,0
25,192,144,16,16,384,144,10002,0,0,0,0
25,192,144,16,16,384,160,10002,0,0,0,0
25,192,144,16,16,368,192,10002,0,0,0,0
25,192,144,16,16,384,176,10002,0,0,0,0
25,192,144,16,16,368,176,10002,0,0,0,0
25,192,144,16,16,352,176,10002,0,0,0,0
25,192,144,16,16,336,176,10002,0,0,0,0
25,192,144,16,16,320,176,10002,0,0,0,0
25,192,144,16,16,320,160,10002,0,0,0,0
25,192,144,16,16,304,160,10002,0,0,0,0
25,192,144,16,16,288,160,10002,0,0,0,0
25,192,144,16,16,240,176,10002,0,0,0,0
25,192,144,16,16,224,192,10002,0,0,0,0
987654321
Mw05Fg0jQA==

