UVx6TlN0AGU9Z2x5ZlF3An58Qm9aFnxuGGdFGUp9PFliZml8NTghenh/cQ==
160,600,352,0,0,16777215,0,0,0,1,12,0
158,40,64,0,1,16777215,0,1,0,1,6,0
218,320,208,0,256,16777215,0,0,0,1,108,0
218,432,176,0,256,13523455,0,181,0,1,114,0
100,264,168,0,256,7714632,0,169,0,1,49,0
100,384,256,0,256,13418291,0,345,0,1,146,0
224,608,144,0,92,2517721,0,0,0,1,168,0
218,488,24,0,236,6596981,0,0,0,1,172,0
224,240,344,0,96,16777215,0,0,0,1,86,0
218,312,16,0,256,14917374,0,232,0,1,87,0
218,368,8,0,256,3371468,0,270,0,1,112,0
218,560,352,0,256,11231651,0,155,0,1,147,0
311,104,104,1,176,48,5849279,0,0,1,34,0
218,16,64,0,256,13486499,0,39,0,1,96,0
218,48,248,0,256,5089459,0,280,0,1,84,0
197,328,184,0,2,0,0,0,0,1,13,0
197,624,64,0,2,0,0,0,0,1,14,0
197,80,352,0,2,0,0,0,0,1,15,0
174,296,184,0,1,131,123,0,0,0,128,0
174,240,48,0,1,39,51,52,0,0,50,0
174,32,352,0,1,57,0,0,0,0,74,1
174,248,240,0,1,90,92,0,0,0,78,1
174,504,352,0,1,17,0,0,0,0,148,1
174,488,232,0,1,110,0,0,0,0,109,0
174,344,128,0,1,97,0,0,0,0,122,0
205,470.71,232,0,1,0,0.50,0,0,1,105,0
205,136,304,0,1,0,0.50,0,0,1,71,0
205,104,120,0,-1,0,0.50,0,0,1,30,0
186,576,128,0,0,0,0,0,0,1,150,0
186,168,240,0,0,0,0,0,0,1,93,0
186,224,176,0,0,0,0,0,0,1,60,0
188,256,304,0,0,69,0,0,0,1,67,0
188,104,120,0,0,29,32,0,0,1,31,0
188,24,120,0,0,33,0,0,0,1,35,0
185,408,32,0,0,16,1,0,0,1,117,0
185,384,136,0,0,16,1,0,0,1,115,0
242,592,48,0,16,32,0,0,0,1,167,0
242,496,48,0,16,32,0,0,0,1,132,0
242,272,168,0,16,32,0,0,0,1,124,0
242,328,280,0,16,32,0,0,0,1,77,0
242,200,32,0,16,32,0,0,0,1,76,0
154,608,143.42,0,2,0.50,32,16,1,1,155,1
154,610.06,264,0,1,0.50,16,16,-1,1,142,1
181,609.48,264,0,142,128,0,142,0,1,138,0
157,504,104,0,16,48,0,0,0,1,165,0
157,512,240,0,32,16,0,0,0,1,159,0
157,632,112,0,16,64,0,0,0,1,158,0
157,512,72,0,48,16,0,0,0,1,157,0
157,576,224,0,32,16,0,0,0,1,152,0
157,592,240,0,64,16,0,0,0,1,149,0
157,568,136,0,48,16,0,0,0,1,135,0
157,504,128,0,16,32,0,0,0,1,134,0
157,528,296,0,208,16,0,0,0,1,133,0
157,488,16,0,16,32,0,0,0,1,130,0
157,488,72,0,16,16,0,0,0,1,129,0
157,352,144,0,16,16,0,0,0,1,126,0
157,432,192,0,16,16,0,0,0,1,125,0
157,424,192,0,16,16,0,0,0,1,121,0
157,480,72,0,16,16,0,0,0,1,120,0
157,432,72,0,16,16,0,0,0,1,119,0
157,352,136,0,48,16,0,0,0,1,118,0
157,392,72,0,64,16,0,0,0,1,116,0
157,480,184,0,16,32,0,0,0,1,111,0
157,504,200,0,16,80,0,0,0,1,104,0
157,480,88,0,16,32,0,0,0,1,103,0
157,432,168,0,16,48,0,0,0,1,102,0
157,432,112,0,16,32,0,0,0,1,101,0
157,480,136,0,16,32,0,0,0,1,100,0
157,424,128,0,16,128,0,0,0,1,99,0
157,488,136,0,16,128,0,0,0,1,98,0
157,352,328,0,64,64,0,0,0,1,94,0
157,136,248,0,32,32,0,0,0,1,89,0
157,144,336,0,80,32,0,0,0,1,75,0
157,56,304,0,16,16,0,0,0,1,73,0
157,88,200,0,80,16,0,0,0,1,72,0
157,304,312,0,64,32,0,0,0,1,70,0
157,144,312,0,80,16,0,0,0,1,68,0
157,80,312,0,64,16,0,0,0,1,66,0
157,280,328,0,112,48,0,0,0,1,65,0
157,192,248,0,16,16,0,0,0,1,64,0
157,248,248,0,48,16,0,0,0,1,63,0
157,328,120,0,16,48,0,0,0,1,62,0
157,296,192,0,64,16,0,0,0,1,61,0
157,272,128,0,16,48,0,0,0,1,59,0
157,224,184,0,32,16,0,0,0,1,58,0
157,320,224,0,16,80,0,0,0,1,56,0
157,56,240,0,80,32,0,0,0,1,55,0
157,136,216,0,32,48,0,0,0,1,54,0
157,376,264,0,16,64,0,0,0,1,53,0
157,136,184,0,176,16,0,0,0,1,46,0
157,288,104,0,80,16,0,0,0,1,45,0
157,256,112,0,32,32,0,0,0,1,44,0
157,432,240,0,128,16,0,0,0,1,42,0
157,240,56,0,64,16,0,0,0,1,41,0
157,320,56,0,32,96,0,0,0,1,40,0
157,200,88,0,16,80,0,0,0,1,36,0
157,112,72,0,32,16,0,0,0,1,27,0
157,192,328,0,16,48,0,0,0,1,25,0
157,160,128,0,96,16,0,0,0,1,24,0
157,96,128,0,32,16,0,0,0,1,23,0
157,32,128,0,32,16,0,0,0,1,22,0
157,136,72,0,16,16,0,0,0,1,21,0
157,208,184,0,16,16,0,0,0,1,20,0
157,376,192,0,96,16,0,0,0,1,19,0
157,576,16,0,16,32,0,0,0,1,18,0
157,608,72,0,80,16,0,0,0,1,16,0
157,48,72,0,64,16,0,0,0,1,5,0
157,632,288,0,16,144,0,0,0,1,4,0
157,328,360,0,624,16,0,0,0,1,3,0
157,328,8,0,624,16,0,0,0,1,2,0
157,8,176,0,16,368,0,0,0,1,11,0
169,480,32,0,0,0,0,0,0,1,131,1
169,264,152,0,0,0,0,0,0,1,123,1
172,440,64,0,0,0,0,0,0,1,110,0
169,344,152,0,0,0,0,0,0,1,97,1
172,200,240,0,0,0,0,0,0,0,92,0
172,152,240,0,0,0,0,0,0,1,90,0
172,16,304,0,0,0,0,0,0,1,69,0
169,312,264,0,0,0,0,0,0,1,57,1
169,248,64,0,0,0,0,0,0,0,52,0
172,16,176,0,0,0,0,0,0,1,51,1
169,192,16,0,0,0,0,0,0,1,39,0
172,48,120,0,0,0,0,0,0,1,33,0
169,568,32,0,0,0,0,0,0,1,17,1
166,632,152,0,0,0,180,0,0,1,163,1
166,632,168,0,0,0,180,0,0,1,161,1
166,632,184,0,0,0,180,0,0,1,160,1
166,152,72,0,0,0,270,0,0,1,32,0
166,88,72,0,0,0,90,0,0,1,29,0
155,608,224,0,2,2,0,0,0,1,154,0
155,608,136,0,1,2,0,0,0,1,153,0
155,560,328,0,4,1,0,0,0,1,145,0
155,400,328,0,3,1,0,0,0,1,144,0
155,400,264,0,2,1,0,0,0,1,141,0
155,616,264,0,1,1,0,0,0,1,140,0
1234567890
35,192,304,48,48,16,304,10002,0,0,0,0
35,192,304,48,48,64,304,10002,0,0,0,0
35,208,304,32,48,192,304,10002,0,0,0,0
25,592,304,32,32,112,224,10002,0,0,0,0
25,592,304,32,32,80,224,10002,0,0,0,0
25,592,304,32,32,80,192,10002,0,0,0,0
25,592,304,32,32,48,192,10002,0,0,0,0
25,592,304,32,32,16,192,10002,0,0,0,0
25,592,304,32,32,112,192,10002,0,0,0,0
37,496,64,32,32,160,96,10000,0,0,0,0
37,464,64,32,32,16,96,10000,0,0,0,0
37,464,96,32,32,16,256,10000,0,0,0,0
37,112,304,32,32,192,320,10000,0,0,0,0
37,288,192,32,64,288,192,10000,0,0,0,0
37,464,96,32,32,144,192,10000,0,0,0,0
37,464,96,32,32,16,128,10000,0,0,0,0
37,224,96,64,32,80,128,10000,0,0,0,0
37,96,96,64,32,144,128,10000,0,0,0,0
37,416,0,32,32,240,128,10000,0,0,0,0
37,496,64,32,32,288,64,10000,0,0,0,0
37,464,96,32,32,208,64,10000,0,0,0,0
37,496,128,64,16,176,192,10000,0,0,0,0
37,272,16,112,16,64,288,10000,0,0,0,0
37,368,160,64,64,96,0,10000,0,0,0,0
37,464,96,32,32,336,16,10000,0,0,0,0
37,288,192,32,64,288,112,10000,0,0,0,0
37,496,64,32,32,336,272,10000,0,0,0,0
37,496,96,32,32,592,80,10000,0,0,0,0
37,288,192,32,64,560,144,10000,0,0,0,0
37,0,272,16,32,544,144,10000,0,0,0,0
37,288,16,112,16,512,272,10000,0,0,0,0
37,0,96,32,32,384,240,10000,0,0,0,0
37,160,96,64,32,368,192,10000,0,0,0,0
38,176,288,32,32,368,32,10000,0,0,0,0
38,176,288,32,32,368,96,10000,0,0,0,0
38,48,288,16,32,400,128,10000,0,0,0,0
38,0,256,16,32,400,80,10000,0,0,0,0
38,192,256,16,32,416,16,10000,0,0,0,0
38,320,128,16,64,400,16,10000,0,0,0,0
38,320,128,16,64,368,128,10000,0,0,0,0
24,128,160,32,32,432,32,10000,0,0,0,0
37,304,128,128,16,432,304,10000,0,0,0,0
37,352,96,112,16,416,240,10000,0,0,0,0
37,272,64,48,32,592,16,10000,0,0,0,0
38,0,256,16,32,512,176,9998,0,0,0,0
38,16,288,32,32,512,144,9998,0,0,0,0
38,48,288,16,32,512,112,9998,0,0,0,0
987654321
CwkoQhIjRGlsJS1Pc0hYKEcp

