UVx6TlN0AGU9Z1d2HVF3DQBxN1lNFjlHD2B6HVAlex1+enVgKSQ9ZmRjbV9+SQ==
160,360,256,0,0,16777215,0,0,0,1,3,0
158,208,264,0,1,16777215,0,1,0,1,2,0
123,288,192,0,128,16777215,0,0,0,1,61,0
197,280,264,0,2,0,0,0,0,1,58,0
174,296,264,0,1,0,0,0,0,0,59,1
316,264,360,0,0,1,0,0,0,1,23,0
316,248,352,0,0,1,0,0,0,1,22,0
316,232,336,0,0,1,0,0,0,1,21,0
316,216,320,0,0,1,0,0,0,1,20,0
316,200,304,0,0,1,0,0,0,1,19,0
316,184,288,0,0,1,0,0,0,1,18,0
316,168,272,0,0,1,0,0,0,1,17,0
316,152,256,0,0,1,0,0,0,1,16,0
316,136,240,0,0,1,0,0,0,1,15,0
316,120,224,0,0,1,0,0,0,1,14,0
316,104,208,0,0,1,0,0,0,1,13,0
316,88,192,0,0,1,0,0,0,1,12,0
316,104,208,0,0,1,0,0,0,1,11,0
316,88,192,0,0,1,0,0,0,1,10,0
316,72,176,0,0,1,0,0,0,1,9,0
316,56,160,0,0,1,0,0,0,1,8,0
316,40,144,0,0,1,0,0,0,1,7,0
308,454,82,0,0,128,0,0,0,1,48,0
308,438,66,0,0,128,0,0,0,1,47,0
308,422,50,0,0,128,0,0,0,1,46,0
308,336,94,0,0,128,0,0,0,1,41,0
308,347,41,0,0,128,0,0,0,1,42,0
308,395,89,0,0,128,0,0,0,1,45,0
308,470,98,0,0,128,0,0,0,1,49,0
308,611,92,0,0,128,0,0,0,1,57,0
308,595,76,0,0,128,0,0,0,1,56,0
308,525,69,0,0,128,0,0,0,1,52,0
308,579,60,0,0,128,0,0,0,1,55,0
308,563,44,0,0,128,0,0,0,1,54,0
308,541,85,0,0,128,0,0,0,1,53,0
308,509,53,0,0,128,0,0,0,1,51,0
308,493,37,0,0,128,0,0,0,1,50,0
308,379,73,0,0,128,0,0,0,1,44,0
308,363,57,0,0,128,0,0,0,1,43,0
308,320,78,0,0,128,0,0,0,1,40,0
308,304,62,0,0,128,0,0,0,1,39,0
308,288,46,0,0,128,0,0,0,1,38,0
308,272,80,0,0,128,0,0,0,1,37,0
308,256,64,0,0,128,0,0,0,1,36,0
308,240,48,0,0,128,0,0,0,1,35,0
308,224,32,0,0,128,0,0,0,1,34,0
308,216,88,0,0,128,0,0,0,1,33,0
308,200,72,0,0,128,0,0,0,1,32,0
308,184,56,0,0,128,0,0,0,1,31,0
308,168,40,0,0,128,0,0,0,1,24,0
308,161,98,0,0,128,0,0,0,1,30,0
308,145,82,0,0,128,0,0,0,1,29,0
308,129,66,0,0,128,0,0,0,1,28,0
308,113,50,0,0,128,0,0,0,1,27,0
308,103,95,0,0,128,0,0,0,1,26,0
308,87,79,0,0,128,0,0,0,1,25,0
216,192,176,0,0,0,0,96,PFRFWFQ+,1,60,0
157,504,251,0,32,32,0,0,0,1,66,0
157,521,191,0,32,32,0,0,0,1,65,0
157,491,153,0,32,32,0,0,0,1,64,0
157,484,202,0,32,32,0,0,0,1,63,0
157,448,272,0,32,320,0,0,0,1,62,0
157,284,279,0,304,32,0,0,0,1,6,0
1234567890
25,288,192,160,64,256,144,10002,0,0,0,0
25,288,192,160,64,256,208,10002,0,0,0,0
25,288,192,160,64,416,144,10002,0,0,0,0
25,288,192,160,64,416,208,10002,0,0,0,0
25,288,192,160,64,416,80,10002,0,0,0,0
25,288,192,160,64,256,80,10002,0,0,0,0
25,288,192,160,64,96,80,10002,0,0,0,0
25,288,192,160,64,256,272,10002,0,0,0,0
25,288,192,160,64,416,272,10002,0,0,0,0
25,288,192,160,64,96,272,10002,0,0,0,0
25,80,176,128,80,0,176,10002,0,0,0,0
25,80,176,128,80,128,176,10002,0,0,0,0
25,192,272,16,16,224,112,9998,0,0,0,0
25,192,272,16,16,224,128,9998,0,0,0,0
25,192,272,16,16,240,128,9998,0,0,0,0
25,192,272,16,16,256,128,9998,0,0,0,0
25,192,272,16,16,272,32,9998,0,0,0,0
25,192,272,16,16,288,48,9998,0,0,0,0
25,192,272,16,16,304,48,9998,0,0,0,0
25,192,272,16,16,320,48,9998,0,0,0,0
25,192,272,16,16,336,48,9998,0,0,0,0
25,192,272,16,16,368,48,9998,0,0,0,0
25,192,272,16,16,432,48,9998,0,0,0,0
25,192,272,16,16,416,48,9998,0,0,0,0
25,192,272,16,16,400,48,9998,0,0,0,0
25,192,272,16,16,384,48,9998,0,0,0,0
25,192,272,16,16,512,32,9998,0,0,0,0
25,192,272,16,16,528,48,9998,0,0,0,0
25,192,272,16,16,560,48,9998,0,0,0,0
25,192,272,16,16,576,48,9998,0,0,0,0
25,192,272,16,16,576,64,9998,0,0,0,0
25,192,272,16,16,576,80,9998,0,0,0,0
25,192,272,16,16,576,96,9998,0,0,0,0
25,192,272,16,16,592,96,9998,0,0,0,0
987654321
IQc4QhQqVWlkKGVHNl1IN1Eibxk=

