UVx6TlN0AGU9Z1gcalhICwlxN35HDCNWVTU7SBJhIEV+enVgKSQ=
160,336,216,0,0,16777215,0,0,0,1,10,0
158,224,224,0,1,16777215,0,1,0,1,8,0
123,288,168,0,160,1966335,0,0,0,0,12,0
100,176,208,0,256,16777215,0,0,0,1,6,0
174,256,224,0,1,0,0,7,0,0,9,1
174,304,224,0,1,12,0,0,0,0,13,1
157,344,240,0,32,32,0,0,0,1,5,0
157,312,240,0,32,32,0,0,0,1,4,0
157,280,240,0,32,32,0,0,0,1,3,0
157,248,240,0,32,32,0,0,0,1,2,0
157,216,240,0,32,32,0,0,0,1,24,0
301,305,120,0,0,0,270,0,0,1,11,1
166,168,216,0,0,0,0,0,0,0,7,0
1234567890
25,0,0,624,352,0,0,10002,0,0,0,0
38,400,144,48,32,224,160,10000,0,0,0,0
38,288,112,32,48,272,128,10000,0,0,0,0
38,272,160,48,16,368,144,10000,0,0,0,0
38,160,160,48,32,96,224,10000,0,0,0,0
38,192,192,16,32,96,176,10000,0,0,0,0
38,192,224,16,32,112,176,10000,0,0,0,0
38,448,176,32,48,368,96,10000,0,0,0,0
38,480,192,48,32,384,176,10000,0,0,0,0
38,480,96,48,32,432,64,10000,0,0,0,0
38,464,0,32,48,528,48,10000,0,0,0,0
38,368,0,32,48,288,80,10000,0,0,0,0
38,48,256,48,32,144,272,10000,0,0,0,0
38,416,224,48,32,464,176,10000,0,0,0,0
37,592,32,48,48,368,256,10000,0,0,0,0
37,592,32,48,48,32,288,10000,0,0,0,0
37,592,32,48,48,432,0,10000,0,0,0,0
24,256,176,32,32,272,224,9998,0,0,0,0
24,256,176,32,32,272,272,9998,0,0,0,0
24,0,160,32,32,256,192,9998,0,0,0,0
24,288,144,32,32,496,144,9998,0,0,0,0
24,288,144,32,32,576,112,9998,0,0,0,0
24,288,144,32,32,576,208,9998,0,0,0,0
24,288,144,32,32,528,272,9998,0,0,0,0
24,288,144,32,32,480,272,9998,0,0,0,0
24,288,144,32,32,464,208,9998,0,0,0,0
24,288,144,32,32,544,176,9998,0,0,0,0
24,288,144,32,32,496,224,9998,0,0,0,0
24,288,144,32,32,368,272,9998,0,0,0,0
24,288,144,32,32,272,304,9998,0,0,0,0
24,288,144,32,32,192,304,9998,0,0,0,0
24,288,144,32,32,32,288,9998,0,0,0,0
24,288,144,32,32,48,240,9998,0,0,0,0
24,288,144,32,32,48,208,9998,0,0,0,0
24,288,144,32,32,112,208,9998,0,0,0,0
24,288,144,32,32,112,256,9998,0,0,0,0
24,288,144,32,32,128,304,9998,0,0,0,0
24,288,144,32,32,160,288,9998,0,0,0,0
24,288,144,32,32,160,240,9998,0,0,0,0
987654321
Mw05FgksV2lxI2gONk9ELls+

