X1t4TlV0AGU9Z1lmBUFMaV8rTX9GDjNMK2lNLwpsIDMzKTA8bGBoDC0hLkNiVSc2HGgkO182bjs3
158,248,152,0,1,16777215,0,1,0,1,117,0
160,120,80,0,0,16777215,0,0,0,1,121,0
195,384,224,0,0,100,217,0,0,1,142,0
100,392,216,0,256,5542782,0,227,0,1,160,0
100,496,192,0,256,158,0,315,0,1,130,0
195,168,160,0,0,100,217,0,0,1,138,0
100,248,96,0,260,5542782,0,270,0,1,116,0
100,464,96,0,256,5542782,0,227,0,1,156,0
100,208,184,0,256,5542782,0,227,0,1,134,0
100,240,216,0,256,5542782,0,313,0,1,133,0
100,560,248,0,256,158,0,227,0,1,159,0
100,560,32,0,256,158,0,227,0,1,129,0
100,176,32,0,256,5542782,0,313,0,1,158,0
195,184,40,0,0,100,296,0,0,1,123,0
195,456,104,0,0,200,196,0,0,1,136,0
197,544,336,0,2,145,0,0,0,1,146,0
193,448,64,0,1,119,0,0,0,1,120,1
193,312,256,1,1,152,150,151,0,0,153,1
185,368,184,0,0,32,1,0,0,1,149,0
314,368,176,0,0,64,48,0,0,1,155,0
216,360,128,0,6,1,0,96,PFRFWFQ+,1,139,0
216,304,47,0,7,1,0,96,PFRFWFQ+,1,140,0
216,56,136,0,8,1,0,96,PFRFWFQ+,1,143,0
157,112,104,0,32,32,0,0,0,1,122,0
157,248,80,0,16,16,0,0,0,1,115,0
157,80,40,0,32,32,0,0,0,1,113,0
157,48,80,0,32,32,0,0,0,1,112,0
157,48,48,0,32,32,0,0,0,1,111,0
157,144,16,0,32,32,0,0,0,1,110,0
157,112,16,0,32,32,0,0,0,1,109,0
157,80,16,0,32,32,0,0,0,1,108,0
157,48,16,0,32,32,0,0,0,1,107,0
157,16,16,0,32,32,0,0,0,1,106,0
157,16,40,0,32,32,0,0,0,1,105,0
157,16,72,0,32,32,0,0,0,1,104,0
157,16,104,0,32,32,0,0,0,1,103,0
157,8,104,0,32,32,0,0,0,1,102,0
157,128,104,0,32,32,0,0,0,1,101,0
157,96,136,0,32,32,0,0,0,1,100,0
157,128,136,0,32,32,0,0,0,1,99,0
157,16,136,0,32,32,0,0,0,1,98,0
157,16,168,0,32,32,0,0,0,1,97,0
157,16,200,0,32,32,0,0,0,1,96,0
157,48,200,0,32,32,0,0,0,1,95,0
157,80,200,0,32,32,0,0,0,1,94,0
157,112,232,0,32,32,0,0,0,1,93,0
157,80,232,0,32,32,0,0,0,1,92,0
157,80,264,0,32,32,0,0,0,1,91,0
157,112,264,0,32,32,0,0,0,1,90,0
157,144,264,0,32,32,0,0,0,1,89,0
157,144,296,0,32,32,0,0,0,1,88,0
157,176,296,0,32,32,0,0,0,1,87,0
157,208,296,0,32,32,0,0,0,1,86,0
157,224,232,0,32,32,0,0,0,1,85,0
157,224,200,0,32,32,0,0,0,1,84,0
157,240,296,0,32,32,0,0,0,1,83,0
157,264,296,0,32,32,0,0,0,1,82,0
157,296,296,0,32,32,0,0,0,1,81,0
157,320,296,0,32,32,0,0,0,1,80,0
157,312,272,0,32,32,0,0,0,1,79,0
157,432,232,0,32,32,0,0,0,1,78,0
157,439,230,0,32,32,0,0,0,1,77,0
157,456,232,0,32,32,0,0,0,1,76,0
157,408,248,0,32,32,0,0,0,1,75,0
157,408,232,0,32,32,0,0,0,1,74,0
157,352,296,0,32,32,0,0,0,1,73,0
157,424,320,0,32,32,0,0,0,1,72,0
157,384,296,0,32,32,0,0,0,1,71,0
157,416,296,0,32,32,0,0,0,1,70,0
157,448,296,0,32,32,0,0,0,1,69,0
157,448,328,0,32,32,0,0,0,1,68,0
157,448,352,0,32,32,0,0,0,1,67,0
157,464,352,0,32,32,0,0,0,1,66,0
157,496,360,0,32,32,0,0,0,1,65,0
157,456,328,0,32,32,0,0,0,1,64,0
157,480,328,0,32,32,0,0,0,1,63,0
157,512,328,0,32,32,0,0,0,1,62,0
157,512,352,0,32,32,0,0,0,1,61,0
157,544,352,0,32,32,0,0,0,1,60,0
157,576,344,0,32,32,0,0,0,1,59,0
157,576,320,0,32,32,0,0,0,1,58,0
157,480,232,0,32,32,0,0,0,1,57,0
157,576,288,0,32,32,0,0,0,1,56,0
157,576,264,0,32,32,0,0,0,1,55,0
157,576,232,0,32,32,0,0,0,1,54,0
157,544,232,0,32,32,0,0,0,1,53,0
157,576,208,0,32,32,0,0,0,1,52,0
157,576,176,0,32,32,0,0,0,1,51,0
157,512,176,0,32,32,0,0,0,1,50,0
157,576,144,0,32,32,0,0,0,1,49,0
157,544,128,0,32,32,0,0,0,1,48,0
157,576,112,0,32,32,0,0,0,1,47,0
157,576,80,0,32,32,0,0,0,1,46,0
157,504,80,0,32,32,0,0,0,1,45,0
157,576,48,0,32,32,0,0,0,1,44,0
157,576,16,0,32,32,0,0,0,1,43,0
157,544,16,0,32,32,0,0,0,1,42,0
157,512,16,0,32,32,0,0,0,1,41,0
157,480,16,0,32,32,0,0,0,1,40,0
157,448,16,0,32,32,0,0,0,1,39,0
157,416,16,0,32,32,0,0,0,1,38,0
157,384,16,0,32,32,0,0,0,1,37,0
157,352,16,0,32,32,0,0,0,1,36,0
157,320,16,0,32,32,0,0,0,1,35,0
157,288,16,0,32,32,0,0,0,1,34,0
157,256,16,0,32,32,0,0,0,1,33,0
157,224,16,0,32,32,0,0,0,1,32,0
157,192,16,0,32,32,0,0,0,1,31,0
157,160,8,0,32,32,0,0,0,1,30,0
157,160,40,0,32,32,0,0,0,1,29,0
157,160,72,0,32,32,0,0,0,1,28,0
157,160,104,0,32,32,0,0,0,1,27,0
157,160,136,0,32,32,0,0,0,1,26,0
157,232,80,0,32,32,0,0,0,1,25,0
157,264,80,0,32,32,0,0,0,1,24,0
157,192,144,0,32,16,0,0,0,1,23,0
157,192,168,0,32,32,0,0,0,1,22,0
157,224,168,0,32,32,0,0,0,1,21,0
157,256,168,0,32,32,0,0,0,1,20,0
157,256,200,0,80,32,0,0,0,1,19,0
157,288,200,0,32,32,0,0,0,1,18,0
157,320,200,0,32,32,0,0,0,1,17,0
157,352,200,0,32,32,0,0,0,1,16,0
157,376,200,0,32,32,0,0,0,1,15,0
157,400,200,0,32,32,0,0,0,1,14,0
157,424,200,0,32,32,0,0,0,1,13,0
157,448,200,0,32,32,0,0,0,1,12,0
157,480,200,0,32,32,0,0,0,1,11,0
157,480,168,0,32,32,0,0,0,1,10,0
157,480,144,0,32,32,0,0,0,1,9,0
157,480,112,0,32,32,0,0,0,1,8,0
157,480,80,0,32,32,0,0,0,1,7,0
157,456,80,0,32,32,0,0,0,1,6,0
157,424,80,0,32,32,0,0,0,1,5,0
157,392,80,0,32,32,0,0,0,1,4,0
157,360,80,0,32,32,0,0,0,1,3,0
157,328,80,0,32,32,0,0,0,1,2,0
157,296,80,0,32,32,0,0,0,1,117,0
169,488,32,0,0,0,0,0,0,1,119,1
169,448,248,0,0,0,0,0,0,1,145,1
253,472,32,0,16777215,0,7,0,0,1,128,0
253,248,32,0,16777215,0,7,0,0,1,126,0
253,408,264,0,136,0,1,0,0,1,137,0
253,80,136,0,16777215,90,7,0,0,1,141,0
253,80,56,0,16777215,180,7,0,0,1,144,0
253,32,176,0,16777215,270,7,0,0,1,147,0
253,32,104,0,16777215,270,7,0,0,1,148,0
166,128,240,0,0,0,0,0,0,1,150,1
166,96,208,0,0,0,0,0,0,1,151,1
166,160,272,0,0,0,0,0,0,1,152,1
1234567890
38,48,240,64,48,272,112,10000,0,0,0,0
38,320,128,48,64,336,128,10000,0,0,0,0
35,0,48,32,96,272,96,10002,0,0,0,0
35,0,48,32,96,304,96,10002,0,0,0,0
35,0,48,32,96,336,96,10002,0,0,0,0
35,0,48,32,96,368,96,10002,0,0,0,0
35,0,48,32,96,400,96,10002,0,0,0,0
35,0,48,32,96,432,96,10002,0,0,0,0
35,32,48,32,96,208,0,10002,0,0,0,0
35,32,48,32,96,240,0,10002,0,0,0,0
35,32,48,32,96,272,0,10002,0,0,0,0
35,32,48,32,96,304,0,10002,0,0,0,0
35,32,48,32,96,336,0,10002,0,0,0,0
35,32,48,32,96,368,0,10002,0,0,0,0
35,32,48,32,96,400,0,10002,0,0,0,0
35,32,48,32,96,432,0,10002,0,0,0,0
35,32,48,32,96,464,0,10002,0,0,0,0
35,32,48,32,96,208,96,10002,0,0,0,0
35,32,48,32,96,240,96,10002,0,0,0,0
35,336,16,32,80,496,32,10002,0,0,0,0
35,336,16,32,80,528,32,10002,0,0,0,0
35,336,16,32,80,496,112,10002,0,0,0,0
35,336,16,32,80,496,192,10002,0,0,0,0
35,336,16,32,80,528,144,10002,0,0,0,0
35,336,16,32,80,528,240,10002,0,0,0,0
35,336,16,32,80,496,272,10002,0,0,0,0
35,336,16,32,80,464,240,10002,0,0,0,0
35,336,16,32,80,528,320,10002,0,0,0,0
35,32,48,32,96,368,208,10002,0,0,0,0
35,32,48,32,96,336,208,10002,0,0,0,0
35,32,48,32,96,304,208,10002,0,0,0,0
35,32,48,32,96,272,208,10002,0,0,0,0
35,32,48,32,96,240,208,10002,0,0,0,0
35,32,48,32,96,208,224,10002,0,0,0,0
35,32,48,32,96,16,96,10002,0,0,0,0
35,32,48,32,96,48,96,10002,0,0,0,0
35,32,48,32,96,48,0,10002,0,0,0,0
35,32,48,32,96,400,240,10002,0,0,0,0
35,32,48,32,96,432,240,10002,0,0,0,0
24,128,32,64,16,512,320,9998,0,0,0,0
24,128,32,64,16,496,144,9998,0,0,0,0
24,128,32,64,16,496,192,9998,0,0,0,0
24,128,32,64,16,496,96,9998,0,0,0,0
24,0,288,32,32,288,208,9998,0,0,0,0
35,0,48,32,96,176,0,10002,0,0,0,0
35,0,48,32,96,176,96,10002,0,0,0,0
35,0,48,32,96,176,192,10002,0,0,0,0
35,0,48,32,96,144,192,10002,0,0,0,0
35,0,48,32,96,144,96,10002,0,0,0,0
35,0,48,32,96,112,192,10002,0,0,0,0
35,0,48,32,96,112,96,10002,0,0,0,0
35,0,48,32,96,80,192,10002,0,0,0,0
35,0,48,32,96,80,96,10002,0,0,0,0
35,0,48,32,96,80,0,10002,0,0,0,0
35,0,48,32,96,112,0,10002,0,0,0,0
24,496,0,64,32,368,160,9998,0,0,0,0
24,496,0,64,32,304,160,9998,0,0,0,0
24,496,0,64,32,336,128,9998,0,0,0,0
24,432,32,32,16,256,240,9998,0,0,0,0
24,416,32,16,16,528,48,9998,0,0,0,0
24,400,32,16,16,512,272,9998,0,0,0,0
24,320,0,16,16,496,272,9998,0,0,0,0
24,160,288,64,32,352,32,9998,0,0,0,0
24,160,288,64,32,208,32,9998,0,0,0,0
987654321
Jkg5Cg8wRGUlI2xcPkdIKUdsd11YGzwCH2plWEo5aVUhKzI1JXt3djw7JE8=
BgsiCwU0VSRgJXkOaQI=

