UVx6TlN0AGU9Z14cFRh0AkR9N3pCHzNJGGtzL1Y4eBB+enVgKSQ9ZmRjbV9+SQ==
158,8,80,0,1,16777215,0,1,0,1,10,0
160,608,288,0,0,16777215,0,0,0,1,26,0
123,224,192,0,128,16777215,0,0,0,1,17,0
123,408,248,0,128,16777215,0,0,0,1,18,0
123,80,160,0,128,16777215,0,0,0,1,19,0
197,512,192,0,2,0,0,0,0,1,36,0
194,8.50,344,0,0,128,0,0,0,1,20,0
194,624,344,0,0,128,0,0,0,1,16,0
194,320,344,0,0,128,0,0,0,1,21,0
186,544,64,0,0,0,0,0,0,1,29,0
185,104,152,0,0,32,1,0,0,1,40,0
185,416,176,0,0,32,1,0,0,1,39,0
185,264,168,0,0,32,1,0,0,1,38,0
210,496,64,0,0,0,0,0,0,1,34,0
210,624,120,0,34,0,0,0,0,1,37,0
157,328,120,0,32,32,0,0,0,1,9,0
157,504,208,0,32,32,0,0,0,1,3,0
157,192,184,0,32,32,0,0,0,1,11,0
157,16,96,0,32,32,0,0,0,1,12,0
157,616,136,0,32,32,0,0,0,1,22,0
157,608,312,0,32,32,0,0,0,1,25,0
157,608,216,0,32,32,0,0,0,1,28,0
157,560,80,0,32,32,0,0,0,1,30,0
157,528,80,0,32,32,0,0,0,1,31,0
157,496,80,0,32,32,0,0,0,1,32,0
166,624,200,0,0,0,180,0,0,1,23,1
1234567890
35,368,256,32,48,320,256,10002,0,0,0,0
35,464,304,32,48,400,256,10002,0,0,0,0
35,432,304,32,48,240,256,10002,0,0,0,0
24,416,160,16,16,0,0,9998,0,0,0,0
24,416,160,16,16,16,0,9998,0,0,0,0
24,416,160,16,16,32,0,9998,0,0,0,0
24,416,160,16,16,48,0,9998,0,0,0,0
24,416,160,16,16,64,0,9998,0,0,0,0
24,416,160,16,16,80,0,9998,0,0,0,0
24,416,160,16,16,96,0,9998,0,0,0,0
24,416,160,16,16,112,0,9998,0,0,0,0
24,416,160,16,16,128,0,9998,0,0,0,0
24,416,160,16,16,144,0,9998,0,0,0,0
24,416,160,16,16,160,0,9998,0,0,0,0
24,416,160,16,16,176,0,9998,0,0,0,0
24,416,160,16,16,192,0,9998,0,0,0,0
24,416,160,16,16,208,0,9998,0,0,0,0
24,416,160,16,16,224,0,9998,0,0,0,0
24,416,160,16,16,240,0,9998,0,0,0,0
24,416,160,16,16,256,0,9998,0,0,0,0
24,416,160,16,16,272,0,9998,0,0,0,0
24,416,160,16,16,288,0,9998,0,0,0,0
24,416,160,16,16,304,0,9998,0,0,0,0
24,416,160,16,16,320,0,9998,0,0,0,0
24,416,160,16,16,336,0,9998,0,0,0,0
24,416,160,16,16,352,0,9998,0,0,0,0
24,416,160,16,16,368,0,9998,0,0,0,0
24,416,160,16,16,384,0,9998,0,0,0,0
24,416,160,16,16,400,0,9998,0,0,0,0
24,416,160,16,16,416,0,9998,0,0,0,0
24,416,160,16,16,432,0,9998,0,0,0,0
24,416,160,16,16,448,0,9998,0,0,0,0
24,416,160,16,16,464,0,9998,0,0,0,0
24,416,160,16,16,480,0,9998,0,0,0,0
24,416,160,16,16,496,0,9998,0,0,0,0
24,416,160,16,16,512,0,9998,0,0,0,0
24,416,160,16,16,528,0,9998,0,0,0,0
24,416,160,16,16,544,0,9998,0,0,0,0
24,416,160,16,16,560,0,9998,0,0,0,0
24,416,160,16,16,576,0,9998,0,0,0,0
24,416,160,16,16,592,0,9998,0,0,0,0
24,416,160,16,16,608,0,9998,0,0,0,0
24,416,160,16,16,624,0,9998,0,0,0,0
24,416,160,16,16,0,352,9998,0,0,0,0
24,416,160,16,16,16,352,9998,0,0,0,0
24,416,160,16,16,32,352,9998,0,0,0,0
24,416,160,16,16,48,352,9998,0,0,0,0
24,416,160,16,16,64,352,9998,0,0,0,0
24,416,160,16,16,80,352,9998,0,0,0,0
24,416,160,16,16,96,352,9998,0,0,0,0
24,416,160,16,16,112,352,9998,0,0,0,0
24,416,160,16,16,128,352,9998,0,0,0,0
24,416,160,16,16,144,352,9998,0,0,0,0
24,416,160,16,16,160,352,9998,0,0,0,0
24,416,160,16,16,176,352,9998,0,0,0,0
24,416,160,16,16,192,352,9998,0,0,0,0
24,416,160,16,16,208,352,9998,0,0,0,0
24,416,160,16,16,224,352,9998,0,0,0,0
24,416,160,16,16,240,352,9998,0,0,0,0
24,416,160,16,16,256,352,9998,0,0,0,0
24,416,160,16,16,272,352,9998,0,0,0,0
24,416,160,16,16,288,352,9998,0,0,0,0
24,416,160,16,16,304,352,9998,0,0,0,0
24,416,160,16,16,320,352,9998,0,0,0,0
24,416,160,16,16,336,352,9998,0,0,0,0
24,416,160,16,16,352,352,9998,0,0,0,0
24,416,160,16,16,368,352,9998,0,0,0,0
24,416,160,16,16,384,352,9998,0,0,0,0
24,416,160,16,16,400,352,9998,0,0,0,0
24,416,160,16,16,416,352,9998,0,0,0,0
24,416,160,16,16,432,352,9998,0,0,0,0
24,416,160,16,16,448,352,9998,0,0,0,0
24,416,160,16,16,464,352,9998,0,0,0,0
24,416,160,16,16,480,352,9998,0,0,0,0
24,416,160,16,16,496,352,9998,0,0,0,0
24,416,160,16,16,512,352,9998,0,0,0,0
24,416,160,16,16,528,352,9998,0,0,0,0
24,416,160,16,16,544,352,9998,0,0,0,0
24,416,160,16,16,560,352,9998,0,0,0,0
24,416,160,16,16,576,352,9998,0,0,0,0
24,416,160,16,16,592,352,9998,0,0,0,0
24,416,160,16,16,608,352,9998,0,0,0,0
24,416,160,16,16,624,352,9998,0,0,0,0
987654321
IgYgDRls

