VVh6UkxzBXkxZzUCC0FFD1ULTl97TAZXHUJ7DWQGe0h+AhgGSldyOSUjLQomHHM2HGgkO182bjs3Bil2Jg==
259,1072,440,0,576,432,0,0,0,1,463,0
259,1072,488,0,64,32,0,0,0,1,378,0
259,0,88,0,32,144,0,0,0,1,105,0
259,240,240,0,464,160,0,0,0,1,104,0
158,40,64,0,1,16777215,0,1,0,1,5,0
160,888,208,0,0,16448250,0,0,0,1,174,0
123,608,112,0,168,12533888,0,0,0,1,12,0
100,768,32,0,412,16777215,0,325,0,1,205,0
100,400,16,0,488,16777215,0,235,0,1,6,0
100,8,8,0,312,16777215,0,335,0,1,464,0
218,320,240,0,256,16777215,0,268,0,1,169,0
311,360,192,1,128,64,13523455,0,0,1,166,0
218,680,128,0,272,16777215,0,270,0,1,170,0
100,577,299,0,496,16777215,0,270,0,1,113,0
224,685,334,0,128,16777215,0,0,0,1,149,0
123,1576,432,0,148,16777215,0,0,0,1,406,0
100,832,448,0,276,16777215,0,270,0,1,457,0
100,1336,312,0,652,16777215,0,233,0,1,267,0
123,1056,664,0,200,16777215,0,0,0,1,449,0
123,752,464,0,36,16777215,446,0,0,1,539,0
311,1200,256,1,272,64,16777215,0,0,1,538,0
123,1776,192,0,272,16777215,0,0,0,1,251,0
311,1520,80,1,128,64,16777215,0,0,1,220,0
100,88,392,0,344,16777215,0,324,0,1,114,0
224,1120,64,0,172,16777215,0,0,0,1,183,0
224,56,320,0,128,15618833,0,0,0,1,52,0
197,608,272,0,1,207,0,0,0,1,67,0
197,480,544,0,4,207,0,0,0,1,172,0
197,760,408,0,2,207,0,0,0,1,440,0
197,1472,552,0,4,207,0,0,0,1,271,0
174,648,208,1,1,147,144,0,0,0,146,1
174,1152,504,0,1,441,495,0,0,0,393,1
174,1544,112,0,1,223,222,0,0,0,221,1
174,1776,344,0,1,255,284,435,0,0,337,1
205,95,544,0,1,200,0.80,0,0,1,109,0
308,1360,17,0,0,128,270,0,0,1,186,0
308,1216,16,0,0,128,270,0,0,1,185,0
308,1088,17,0,0,128,270,0,0,1,184,0
189,648,16,0,0,156,232,0,0,1,153,0
189,192,16,0,0,140,329,0,0,1,42,0
205,948,208,0,1,200,0.50,0,0,1,175,0
181,1008,88,0,0,124,0,0,0,1,216,0
181,605.12,450.55,0,446,196,0,0,0,1,442,0
181,1549,171,0,0,144,180,0,0,1,268,0
194,24,320,0,0,152,0,0,0,1,139,0
167,1776,192,0,268,270,0,0,0,1,241,0
205,1648.50,552,0,1,0,0.50,0,0,1,353,0
308,952,16,0,0,128,270,0,0,1,181,0
220,839,329,0,32,64,0,0,0,1,455,1
220,1112,264,0,80,80,0,0,0,0,495,1
186,1248,288,0,0,0,0,0,0,1,537,0
219,1024,344,0,32,80,0,0,0,1,441,1
219,544,248,0,80,32,0,0,0,1,147,1
219,464,496,0,176,32,0,0,0,1,136,1
219,16,496,0,32,64,0,0,0,1,133,1
186,1736,552,0,0,0,0,0,0,1,354,0
186,1648,47,0,0,0,0,0,0,1,224,0
186,336,464,0,0,0,0,0,0,1,120,0
304,40,288,0,0,0,0,0,0,1,100,0
304,56,432,0,0,0,0,0,0,1,93,0
304,48,376,0,0,0,0,0,0,1,88,0
186,608,208,0,0,0,0,0,0,1,17,0
188,736,424,0,90,137,133,0,0,1,138,0
188,8,280,0,270,136,0,0,0,1,135,0
188,1408,288,0,0,280,279,0,0,1,235,0
188,1304,280,0,90,512,0,0,0,1,536,0
188,8,424,0,270,84,85,0,0,1,94,0
188,8,368,0,270,86,87,0,0,1,90,0
188,568,280,0,90,0,0,0,0,1,101,0
185,1024,440,0,0,16,1,0,0,1,520,0
185,1752,288,0,261,32,1,0,0,1,257,0
185,704,320,0,0,64,1,0,0,1,73,0
185,144,120,0,0,48,1,0,0,1,8,0
242,781,392,0,64,32,0,0,0,1,453,0
242,1472,536,0,64,32,0,0,0,1,407,0
242,1464,95,0,80,32,0,0,0,1,272,0
242,888,160,0,80,96,0,0,0,1,207,0
242,400,528,0,144,32,0,0,0,1,173,0
242,608,256,0,32,32,0,0,0,1,70,0
313,440,216,0,146,64,32,0,0,1,478,0
216,1000,344,0,66,0,0,96,PFRFWFQ+,1,494,0
216,456,296,0,62,0,0,96,PFRFWFQ+,1,493,0
216,488,496,0,25,0,0,96,PFRFWFQ+,1,411,0
216,296,360,0,13,0,0,96,PFRFWFQ+,1,410,0
210,632,272,0,323,0,0,0,0,1,322,0
216,560,128,0,-1,0,1,104,WU9VIHdpbGwgI05FRUQgI1RoaXMhIA==,1,112,0
216,472,208,0,5,0,0,96,PFRFWFQ+,1,409,0
216,616,232,0,25,0,0,96,PFRFWFQ+,1,412,0
210,688,144,0,0,180,0,0,0,1,157,0
216,1368,112,0,62,0,0,96,PFRFWFQ+,1,551,0
216,176,64,0,-1,0,1,124,SlVNUCAjUVVJQ0s=,1,163,0
210,888,136,0,0,0,0,0,0,1,211,0
210,1040,808,0,287,0,0,0,0,1,274,0
216,1056,576,0,5,0,0,96,PFRFWFQ+,1,549,0
210,312,256,0,156,180,0,0,0,1,154,0
210,328,256,0,157,180,0,0,0,1,155,0
216,888,64,0,7,0,0,96,PFRFWFQ+,1,550,0
210,656,104,0,0,180,0,0,0,1,439,0
210,0,160,0,211,0,0,0,0,1,210,0
210,1088,504,0,0,0,0,0,0,1,323,0
210,1072,808,0,288,0,0,0,0,1,275,0
210,1056,808,0,288,0,0,0,0,1,273,0
154,916,336,0,18,0.50,32,48,1,1,543,1
154,1208,328,0,17,2,32,32,1,1,518,1
154,936,416,0,16,10,16,32,1,1,461,1
154,752,464,0,15,0.70,16,16,-1,1,446,1
154,1302,464,0,12,0.75,192,80,1,1,374,1
154,976,409,0,14,0.75,64,96,1,1,369,1
154,848,568,1,13,0.50,32,32,1,0,341,1
154,1631.55,307.10,0,11,0.50,32,16,1,1,304,1
154,1437.67,125.45,0,10,0.50,32,16,1,1,300,1
154,1648,173.50,0,9,0.50,32,32,1,1,284,1
154,1752,288,0,8,0.90,16,16,-1,1,261,1
154,1992,120,1,7,0.50,16,32,1,0,255,1
154,1952,352,0,6,0.50,32,32,1,1,244,1
154,237.50,48,0,5,0.50,48,16,1,1,161,1
154,533.50,384,0,4,0.50,48,16,1,1,127,1
154,533.50,400,0,3,0.50,32,16,-1,1,81,1
154,349.60,312,0,2,0.80,64,16,1,1,47,1
154,488,112,0,1,9,128,80,1,0,34,0
216,1480,488,0,25,0,0,96,PFRFWFQ+,1,413,0
216,1760,88,0,19,0,0,96,PFRFWFQ+,1,492,0
210,1360,552,0,439,0,0,0,0,1,438,0
210,368,168,0,0,180,0,0,0,1,132,0
210,352,168,0,0,180,0,0,0,1,131,0
216,328,72,0,7,0,0,96,PFRFWFQ+,1,408,0
210,24,544,0,132,0,0,0,0,1,129,0
210,672,144,0,0,180,0,0,0,1,156,0
210,728,40,0,0,270,0,0,0,1,289,0
210,728,24,0,0,270,0,0,0,1,287,0
210,728,56,0,0,270,0,0,0,1,288,0
210,8,544,0,131,0,0,0,0,1,130,0
157,1096,736,0,16,176,0,0,0,1,548,0
157,1016,736,0,16,176,0,0,0,1,547,0
157,1128,360,0,48,32,0,0,0,1,514,0
157,800,312,0,48,32,0,0,0,1,513,0
157,832,384,0,64,48,0,0,0,1,511,0
157,1320,272,0,32,32,0,0,0,1,510,0
157,1240,296,0,176,16,0,0,0,1,509,0
157,816,424,0,96,32,0,0,0,1,456,0
157,1808,496,0,16,144,0,0,0,1,454,0
157,1272,592,0,112,16,0,0,0,1,434,0
157,1024,456,0,32,32,0,0,0,1,428,0
157,936,536,0,176,16,0,0,0,1,427,0
157,1216,512,0,416,16,0,0,0,1,379,0
157,1072,408,0,64,128,0,0,0,1,376,0
157,1848,320,0,16,64,0,0,0,1,338,0
157,928,264,0,288,80,0,0,0,1,336,0
157,1056,816,0,64,16,0,0,0,1,276,0
157,1576,560,0,448,16,0,0,0,1,270,0
157,1472,512,0,96,16,0,0,0,1,269,0
157,1785,351,0,64,16,0,0,0,1,250,0
157,1864,416,0,256,16,0,0,0,1,238,0
157,1808,120,0,256,16,0,0,0,1,237,0
157,1600,440,0,16,16,0,0,0,1,234,0
157,1520,216,0,32,16,0,0,0,1,232,0
157,1816,24,0,288,80,0,0,0,1,231,0
157,1536,24,0,144,80,0,0,0,1,230,0
157,1568,120,0,224,16,0,0,0,1,219,0
157,1296,72,0,80,16,0,0,0,1,218,0
157,1160,56,0,16,16,0,0,0,1,217,0
157,1104,112,0,16,16,0,0,0,1,209,0
157,984,80,0,16,16,0,0,0,1,208,0
157,888,144,0,64,16,0,0,0,1,206,0
157,200,408,0,32,16,0,0,0,1,204,0
157,648,96,0,32,16,0,0,0,1,199,0
157,1432,304,0,64,32,0,0,0,1,194,0
157,1392,288,0,16,64,0,1,0,1,193,0
157,1376,272,0,16,64,0,1,0,1,192,0
157,1360,256,0,16,64,0,1,0,1,191,0
157,1344,240,0,16,64,0,1,0,1,190,0
157,1328,224,0,16,64,0,1,0,1,189,0
157,1312,208,0,16,64,0,1,0,1,188,0
157,1296,192,0,16,64,0,1,0,1,187,0
157,1136,184,0,304,80,0,1,0,1,180,0
157,144,472,0,32,16,0,0,0,1,165,0
157,784,536,0,32,16,0,0,0,1,143,0
157,304,528,0,48,32,0,0,0,1,119,0
157,48,520,0,32,48,0,0,0,1,116,0
157,336,472,0,80,16,0,0,0,1,115,0
157,752,424,0,32,32,0,0,0,1,99,0
157,400,560,0,800,32,0,0,0,1,92,0
157,96,336,0,32,32,0,0,0,1,91,0
157,0,368,0,16,416,0,0,0,1,89,0
157,696,72,0,64,144,0,0,0,1,83,0
157,368,296,0,32,16,0,0,0,1,77,0
157,288,296,0,16,16,0,0,0,1,76,0
157,608,280,0,80,16,0,0,0,1,66,0
157,328,240,0,240,32,0,0,0,1,15,0
157,744,216,0,480,16,0,0,0,1,13,0
157,64,72,0,96,16,0,0,0,1,2,0
157,312,160,0,224,16,0,0,0,1,4,0
169,808,328,0,0,0,0,0,0,1,512,1
169,1504,520,0,0,0,0,0,0,1,280,1
169,1424,520,0,0,0,0,0,0,1,279,1
172,1640,48,0,1,0,0,0,0,1,223,1
172,1608,48,0,0,0,0,0,0,1,222,1
169,696,144,0,0,0,0,0,0,1,87,1
169,696,176,0,1,0,0,0,0,1,86,1
169,712,144,0,0,0,0,0,0,1,85,1
169,712,176,0,1,0,0,0,0,1,84,1
301,864,376,0,0,0,0,495,0,1,521,1
301,752,440,0,0,0,270,455,0,1,452,1
301,800,560,0,0,0,0,341,0,1,335,1
301,192,144,0,0,0,0,34,0,1,40,1
301,488,112,0,34,0,0,0,0,1,36,1
301,488,112,0,34,0,0,0,0,0,20,1
253,1464,296,0,16777215,0,4,0,0,1,414,0
253,976,80,0,16777215,0,5,0,0,1,229,0
253,1256,72,0,16777215,0,5,0,0,1,227,0
253,648,280,0,16777215,0,4,0,0,1,69,0
253,568,280,0,16777215,180,4,0,0,1,68,0
253,424,160,0,16777215,0,4,0,0,1,62,0
166,1248,520,0,0,0,271,0,0,1,545,1
166,1600,448,0,0,0,271,0,0,1,435,1
166,768,536,0,0,0,180,0,0,0,144,1
166,232,256,0,0,0,270,0,0,0,137,1
166,533.50,400,0,81,0,270,0,0,1,98,0
155,936,416,0,3,16,80,0,0,1,546,0
155,928,336,0,2,18,0,0,0,1,542,0
155,872,336,0,1,18,0,0,0,1,541,0
155,1264,328,0,2,17,100,0,0,1,517,0
155,1056,328,0,1,17,100,0,0,1,516,0
155,936,504,0,2,16,80,0,0,1,460,0
155,791,504,0,1,16,80,0,0,1,459,0
155,912,384,0,5,15,100,0,0,1,451,0
155,912,464,0,4,15,0,0,0,1,450,0
155,752,464,0,3,15,300,0,0,1,448,0
155,656,464,0,2,15,0,0,0,1,445,0
155,432,464,0,1,15,0,0,0,1,444,0
155,1424,464,0,2,12,70,0,0,1,373,0
155,1200,464,0,1,12,70,0,0,1,372,0
155,976,488,0,2,14,70,0,0,1,368,0
155,976,352,0,1,14,20,0,0,1,367,0
155,1320,568,0,2,13,0,0,0,1,340,0
155,848,568,0,1,13,0,0,0,1,339,1
155,1639,306,0,2,11,0,0,0,1,303,0
155,1544,320,0,1,11,0,0,0,1,302,0
155,1440,120,0,2,10,450,0,0,1,299,0
155,1416,176,0,1,10,150,0,0,1,298,0
155,1776,240,0,3,9,0,0,0,1,286,0
155,1648,240,0,2,9,0,0,0,1,283,0
155,1648,144,0,1,9,0,0,0,1,282,0
155,480,344,0,4,2,0,0,0,1,266,0
155,1936,208,0,5,8,150,0,0,1,265,0
155,1752,288,0,4,8,150,0,0,1,264,0
155,1680,409,0,3,8,150,0,0,1,263,0
155,1496,376,0,2,8,0,0,0,1,260,0
155,1312,376,0,1,8,150,0,0,1,259,0
155,1992,288,0,2,7,200,0,0,1,254,1
155,1992,120,0,1,7,0,0,0,1,253,0
155,1952,352,0,2,6,250,0,0,1,243,0
155,1873,280,0,1,6,0,0,0,1,242,0
155,344,48,0,2,5,0,0,0,1,160,0
155,208,48,0,1,5,0,0,0,1,159,0
155,656,384,0,2,4,0,0,0,1,126,0
155,440,384,0,1,4,0,0,0,1,125,0
155,656,400,0,2,3,0,0,0,1,80,0
155,440,400,0,1,3,0,0,0,1,79,0
155,480,312,0,3,2,15,0,0,1,49,0
155,128,312,0,2,2,0,0,0,1,46,0
155,128,224,0,1,2,0,0,0,1,45,0
155,256,112,0,2,1,0,0,0,1,33,0
155,488,112,0,1,1,0,0,0,1,32,0
1234567890
25,560,304,32,32,240,96,10002,0,0,0,0
25,560,304,32,32,208,96,10002,0,0,0,0
25,560,304,32,32,176,96,10002,0,0,0,0
25,560,304,32,32,144,96,10002,0,0,0,0
25,0,0,144,96,0,0,10002,0,0,0,0
25,0,0,144,96,144,0,10002,0,0,0,0
25,0,0,144,96,288,0,10002,0,0,0,0
25,0,0,144,96,432,0,10002,0,0,0,0
25,0,0,144,96,576,0,10002,0,0,0,0
25,0,0,144,96,720,0,10002,0,0,0,0
25,0,0,144,96,864,0,10002,0,0,0,0
25,0,0,144,96,1008,0,10002,0,0,0,0
25,0,0,144,96,1152,0,10002,0,0,0,0
25,0,0,144,96,1296,0,10002,0,0,0,0
25,0,0,144,96,1440,16,10002,0,0,0,0
25,0,0,144,96,1584,16,10002,0,0,0,0
25,0,0,144,96,1728,16,10002,0,0,0,0
25,0,0,144,96,1872,16,10002,0,0,0,0
25,0,0,144,96,1856,112,10002,0,0,0,0
25,0,0,144,96,1712,112,10002,0,0,0,0
25,0,0,144,96,1568,112,10002,0,0,0,0
25,0,0,144,96,1424,112,10002,0,0,0,0
25,0,0,144,96,1280,96,10002,0,0,0,0
25,0,0,144,96,1136,96,10002,0,0,0,0
25,0,0,144,96,992,96,10002,0,0,0,0
25,0,0,144,96,848,96,10002,0,0,0,0
25,0,0,144,96,704,96,10002,0,0,0,0
25,0,0,144,96,544,112,10002,0,0,0,0
25,0,0,528,352,1472,208,10002,0,0,0,0
25,0,0,528,352,512,416,10002,0,0,0,0
25,0,0,144,144,1040,432,10002,0,0,0,0
25,0,0,144,144,1200,352,10002,0,0,0,0
25,0,0,144,144,1056,224,10002,0,0,0,0
987654321
Mw05FkA7Xzx3a3pHJ1gNO1MtclZdCnBWEWxkWFMwdR03J3k9cHV5NyA=

