UVx6Tll7AmU9Z1hpO0N3An46N2xLDSRhEWR6GlsjPEVjZml8NTghenh/cUNiVSc=
158,184,184,0,1,16777215,0,1,0,1,8,0
160,584,144,0,0,16777215,0,0,0,1,74,0
100,160,80,0,256,16777215,0,0,0,1,75,0
100,576,40,0,256,16777215,0,268,0,1,113,0
100,480,72,0,256,16777215,0,0,0,1,76,0
197,496,88,0,2,0,0,0,0,1,52,0
174,176,88,0,1,32,0,0,0,0,31,1
316,112,72,0,0,1,0,0,0,1,96,0
205,307,152,0,1,0,0.50,0,0,1,20,0
188,309,154,0,0,21,0,0,0,1,22,0
188,368,152,0,0,0,39,0,0,1,37,0
188,416,152,0,0,21,0,0,0,1,38,0
188,528,88,0,0,98,0,0,0,1,99,0
210,112,32,0,0,180,0,0,0,1,97,0
210,112,328,0,97,0,0,0,0,1,79,0
210,113,20,0,0,0,0,0,0,1,78,0
157,81,288,0,32,32,0,0,0,1,115,0
157,80,64,0,32,32,0,0,0,1,114,0
157,144,264,0,32,32,0,0,0,1,111,0
157,144,280,0,32,32,0,0,0,1,110,0
157,144,312,0,32,32,0,0,0,1,109,0
157,144,344,0,32,32,0,0,0,1,107,0
157,112,344,0,32,32,0,0,0,1,104,0
157,80,344,0,32,32,0,0,0,1,103,0
157,80,327,0,32,32,0,0,0,1,102,0
157,80,297,0,32,32,0,0,0,1,101,0
157,80,264,0,32,32,0,0,0,1,100,0
157,176,200,0,32,32,0,0,0,1,63,0
157,208,200,0,32,32,0,0,0,1,5,0
157,240,200,0,32,32,0,0,0,1,6,0
157,272,200,0,32,32,0,0,0,1,7,0
157,272,168,0,32,32,0,0,0,1,9,0
157,144,200,0,32,32,0,0,0,1,10,0
157,144,168,0,32,32,0,0,0,1,11,0
157,112,16,0,32,32,0,0,0,1,12,0
157,144,104,0,32,32,0,0,0,1,13,0
157,176,104,0,32,32,0,0,0,1,14,0
157,208,104,0,32,32,0,0,0,1,15,0
157,304,168,0,32,32,0,0,0,1,16,0
157,336,168,0,32,32,0,0,0,1,17,0
157,368,168,0,32,32,0,0,0,1,18,0
157,400,168,0,32,32,0,0,0,1,19,0
157,144,72,0,32,32,0,0,0,1,25,0
157,144,40,0,32,32,0,0,0,1,26,0
157,144,8,0,32,32,0,0,0,1,27,0
157,177,16,0,32,32,0,0,0,1,28,0
157,208,16,0,32,32,0,0,0,1,29,0
157,432,168,0,32,32,0,0,0,1,33,0
157,464,168,0,32,32,0,0,0,1,34,0
157,496,168,0,32,32,0,0,0,1,35,0
157,496,104,0,32,32,0,0,0,1,40,0
157,464,104,0,32,32,0,0,0,1,41,0
157,464,72,0,32,32,0,0,0,1,42,0
157,464,40,0,32,32,0,0,0,1,43,0
157,432,40,0,32,32,0,0,0,1,44,0
157,400,40,0,32,32,0,0,0,1,45,0
157,368,41,0,32,32,0,0,0,1,46,0
157,336,40,0,32,32,0,0,0,1,47,0
157,304,40,0,32,32,0,0,0,1,48,0
157,304,16,0,32,32,0,0,0,1,49,0
157,272,16,0,32,32,0,0,0,1,50,0
157,240,16,0,32,32,0,0,0,1,51,0
157,528,168,0,32,32,0,0,0,1,53,0
157,560,168,0,32,32,0,0,0,1,54,0
157,528,104,0,32,32,0,0,0,1,55,0
157,464,8,0,32,32,0,0,0,1,56,0
157,432,8,0,32,32,0,0,0,1,57,0
157,407,8,0,32,32,0,0,0,1,58,0
157,376,8,0,32,32,0,0,0,1,59,0
157,344,8,0,32,32,0,0,0,1,60,0
157,328,8,0,32,32,0,0,0,1,61,0
157,496,16,0,32,32,0,0,0,1,62,0
157,528,16,0,32,32,0,0,0,1,63,0
157,592,168,0,32,32,0,0,0,1,65,0
157,624,168,0,32,32,0,0,0,1,66,0
157,560,16,0,32,32,0,0,0,1,67,0
157,592,16,0,32,32,0,0,0,1,68,0
157,624,16,0,32,32,0,0,0,1,69,0
157,624,48,0,32,32,0,0,0,1,70,0
157,624,80,0,32,32,0,0,0,1,71,0
157,624,112,0,32,32,0,0,0,1,72,0
157,624,144,0,32,32,0,0,0,1,73,0
157,143,136,0,32,32,0,0,0,1,77,0
157,80,16,0,32,32,0,0,0,1,83,0
157,80,48,0,32,32,0,0,0,1,84,0
157,80,81,0,32,32,0,0,0,1,85,0
157,80,112,0,32,32,0,0,0,1,86,0
157,80,144,0,32,32,0,0,0,1,87,0
157,80,176,0,32,32,0,0,0,1,88,0
157,80,208,0,32,32,0,0,0,1,89,0
157,80,233,0,32,32,0,0,0,1,90,0
157,144,232,0,32,32,0,0,0,1,91,0
157,176,232,0,32,32,0,0,0,1,92,0
157,208,232,0,32,32,0,0,0,1,93,0
157,240,232,0,32,32,0,0,0,1,94,0
157,272,232,0,32,32,0,0,0,1,95,0
169,448,120,0,0,0,0,0,0,1,32,1
166,224,104,0,0,0,0,0,0,1,21,1
166,216,32,0,0,0,270,0,0,1,39,1
166,96,184,0,0,0,0,0,0,0,98,1
1234567890
25,256,176,16,16,0,0,10000,0,0,0,0
25,256,176,16,16,32,32,10000,0,0,0,0
25,256,176,16,16,48,48,10000,0,0,0,0
25,256,176,16,16,96,112,10000,0,0,0,0
38,48,64,16,16,0,0,10002,0,0,0,0
25,160,64,176,192,272,176,10002,0,0,0,0
25,448,32,160,160,448,192,10002,0,0,0,0
25,400,144,224,192,0,192,10002,0,0,0,0
38,96,64,48,32,16,256,10000,0,0,0,0
38,96,112,48,64,16,192,10000,0,0,0,0
38,144,192,16,48,32,128,10000,0,0,0,0
38,160,224,48,64,160,272,10000,0,0,0,0
38,288,176,48,32,224,240,10000,0,0,0,0
38,304,256,48,32,224,272,10000,0,0,0,0
38,304,256,48,32,336,208,10000,0,0,0,0
38,336,208,48,64,240,304,10000,0,0,0,0
38,336,208,48,64,400,208,10000,0,0,0,0
38,384,208,32,16,432,288,10000,0,0,0,0
38,384,208,32,16,416,272,10000,0,0,0,0
38,416,256,16,32,400,304,10000,0,0,0,0
38,400,288,32,32,432,320,10000,0,0,0,0
38,416,288,32,32,608,208,10000,0,0,0,0
38,480,192,144,32,496,256,10000,0,0,0,0
38,448,208,64,64,560,288,10000,0,0,0,0
38,464,192,64,32,544,32,10000,0,0,0,0
38,480,288,64,32,560,64,10000,0,0,0,0
38,480,288,64,32,576,176,10000,0,0,0,0
38,480,320,64,32,480,32,10000,0,0,0,0
38,432,96,48,48,512,64,10000,0,0,0,0
24,0,160,160,32,272,128,10000,0,0,0,0
24,64,32,256,80,192,48,10000,0,0,0,0
987654321
AQE4ERRiRDt8a3pHJ0MNLlwpO11KFyRNCys3FlElZRs1aiogYHd4NyRzIxom
BhwmBwExRGlrJC0cc1hIOVsifxhNFjFOFWB5H1txNjE=
CgkzAAViXSZ3Li1HPQtZMlFsfU1aCyJH

