UVx6TlN0AGU9Z1gdN11ON2YLemBkEh1jRDg7OlI4YhEGLyokKSQ9ZmRjbV9+STsqAHQ=
158,112,248,0,1,16777215,0,1,0,1,8,0
197,184,248,0,2,0,0,0,0,1,16,0
308,184,184,0,0,128,272,0,0,1,5,0
216,456,144,0,-1,1,0,96,PEhlbGxvIGFuZCBHb29kYnllIT4=,1,19,0
157,160,48,0,32,32,0,0,0,1,13,0
157,104,56,0,32,32,0,0,0,1,12,0
157,264,264,0,32,32,0,0,0,1,11,0
157,232,264,0,32,32,0,0,0,1,10,0
157,200,264,0,32,32,0,0,0,1,9,0
157,168,264,0,32,32,0,0,0,1,6,0
157,136,264,0,32,32,0,0,0,1,2,0
157,104,264,0,32,32,0,0,0,1,1,0
237,320,0,0,16777215,300,0,0,0,1,4,0
160,256,248,0,0,16777215,0,0,0,1,15,0
1234567890
37,192,224,16,16,0,0,9998,0,0,0,0
37,192,224,16,16,224,144,9998,0,0,0,0
37,192,224,16,16,240,160,9998,0,0,0,0
37,192,224,16,16,224,160,9998,0,0,0,0
37,192,224,16,16,208,144,9998,0,0,0,0
37,192,224,16,16,128,80,9998,0,0,0,0
37,192,224,16,16,192,112,9998,0,0,0,0
37,192,224,16,16,208,128,9998,0,0,0,0
37,192,224,16,16,160,96,9998,0,0,0,0
37,192,224,16,16,96,64,9998,0,0,0,0
37,192,224,16,16,80,48,9998,0,0,0,0
37,192,224,16,16,48,48,9998,0,0,0,0
37,192,224,16,16,48,32,9998,0,0,0,0
37,192,224,16,16,112,64,9998,0,0,0,0
37,192,224,16,16,144,96,9998,0,0,0,0
37,192,224,16,16,176,128,9998,0,0,0,0
37,192,224,16,16,192,144,9998,0,0,0,0
37,192,224,16,16,192,160,9998,0,0,0,0
37,192,224,16,16,192,192,9998,0,0,0,0
37,192,224,16,16,64,80,9998,0,0,0,0
37,192,224,16,16,16,48,9998,0,0,0,0
37,192,224,16,16,112,80,9998,0,0,0,0
37,192,224,16,16,96,80,9998,0,0,0,0
37,192,224,16,16,80,80,9998,0,0,0,0
37,192,224,16,16,64,64,9998,0,0,0,0
37,192,224,16,16,48,64,9998,0,0,0,0
37,192,224,16,16,0,64,9998,0,0,0,0
37,192,224,16,16,16,64,9998,0,0,0,0
37,192,224,16,16,32,64,9998,0,0,0,0
37,192,224,16,16,64,96,9998,0,0,0,0
37,192,224,16,16,80,112,9998,0,0,0,0
37,192,224,16,16,96,128,9998,0,0,0,0
37,192,224,16,16,128,128,9998,0,0,0,0
37,192,224,16,16,112,128,9998,0,0,0,0
37,192,224,16,16,112,112,9998,0,0,0,0
37,192,224,16,16,96,96,9998,0,0,0,0
37,192,224,16,16,80,64,9998,0,0,0,0
37,192,224,16,16,64,48,9998,0,0,0,0
37,192,224,16,16,64,32,9998,0,0,0,0
37,192,224,16,16,32,0,9998,0,0,0,0
37,192,224,16,16,16,-16,9998,0,0,0,0
37,192,224,16,16,320,128,9998,0,0,0,0
37,192,224,16,16,272,96,9998,0,0,0,0
37,192,224,16,16,272,80,9998,0,0,0,0
37,192,224,16,16,336,144,9998,0,0,0,0
37,192,224,16,16,368,192,9998,0,0,0,0
37,192,224,16,16,336,192,9998,0,0,0,0
37,192,224,16,16,288,160,9998,0,0,0,0
37,192,224,16,16,256,144,9998,0,0,0,0
37,192,224,16,16,224,112,9998,0,0,0,0
37,192,224,16,16,208,96,9998,0,0,0,0
37,192,224,16,16,192,80,9998,0,0,0,0
37,192,224,16,16,384,256,9998,0,0,0,0
37,192,224,16,16,368,224,9998,0,0,0,0
37,192,224,16,16,240,96,9998,0,0,0,0
37,192,224,16,16,224,80,9998,0,0,0,0
37,192,224,16,16,208,64,9998,0,0,0,0
37,192,224,16,16,224,96,9998,0,0,0,0
37,192,224,16,16,208,80,9998,0,0,0,0
37,192,224,16,16,176,48,9998,0,0,0,0
37,192,224,16,16,144,32,9998,0,0,0,0
37,192,224,16,16,160,32,9998,0,0,0,0
37,192,224,16,16,208,48,9998,0,0,0,0
37,192,224,16,16,256,112,9998,0,0,0,0
37,192,224,16,16,272,128,9998,0,0,0,0
37,192,224,16,16,240,80,9998,0,0,0,0
37,192,224,16,16,224,64,9998,0,0,0,0
37,192,224,16,16,192,32,9998,0,0,0,0
37,192,224,16,16,176,16,9998,0,0,0,0
37,192,224,16,16,176,32,9998,0,0,0,0
37,192,224,16,16,192,48,9998,0,0,0,0
37,192,224,16,16,192,64,9998,0,0,0,0
37,192,224,16,16,144,48,9998,0,0,0,0
37,192,224,16,16,160,48,9998,0,0,0,0
37,192,224,16,16,160,64,9998,0,0,0,0
37,192,224,16,16,176,64,9998,0,0,0,0
37,192,224,16,16,176,80,9998,0,0,0,0
37,192,224,16,16,160,80,9998,0,0,0,0
37,192,224,16,16,144,80,9998,0,0,0,0
37,192,224,16,16,112,48,9998,0,0,0,0
37,192,224,16,16,96,32,9998,0,0,0,0
37,192,224,16,16,128,32,9998,0,0,0,0
37,192,224,16,16,128,64,9998,0,0,0,0
37,192,224,16,16,144,64,9998,0,0,0,0
37,192,224,16,16,128,48,9998,0,0,0,0
37,192,224,16,16,112,32,9998,0,0,0,0
37,192,224,16,16,96,16,9998,0,0,0,0
37,192,224,16,16,96,0,9998,0,0,0,0
37,192,224,16,16,96,-16,9998,0,0,0,0
37,192,224,16,16,496,272,9998,0,0,0,0
37,192,224,16,16,512,272,9998,0,0,0,0
37,192,224,16,16,480,288,9998,0,0,0,0
37,192,224,16,16,336,176,9998,0,0,0,0
37,192,224,16,16,320,112,9998,0,0,0,0
37,192,224,16,16,368,128,9998,0,0,0,0
37,192,224,16,16,384,144,9998,0,0,0,0
37,192,224,16,16,400,176,9998,0,0,0,0
37,192,224,16,16,416,192,9998,0,0,0,0
37,192,224,16,16,432,224,9998,0,0,0,0
37,192,224,16,16,432,240,9998,0,0,0,0
37,192,224,16,16,432,256,9998,0,0,0,0
37,192,224,16,16,400,240,9998,0,0,0,0
37,192,224,16,16,368,240,9998,0,0,0,0
37,192,224,16,16,352,224,9998,0,0,0,0
37,192,224,16,16,336,208,9998,0,0,0,0
37,192,224,16,16,320,192,9998,0,0,0,0
37,192,224,16,16,304,176,9998,0,0,0,0
37,192,224,16,16,368,176,9998,0,0,0,0
37,192,224,16,16,400,224,9998,0,0,0,0
37,608,48,16,16,384,48,9998,0,0,0,0
37,592,32,16,16,368,32,9998,0,0,0,0
37,624,48,16,16,400,48,9998,0,0,0,0
37,624,64,16,16,400,64,9998,0,0,0,0
37,608,64,16,16,384,64,9998,0,0,0,0
37,592,64,16,16,368,64,9998,0,0,0,0
37,592,48,16,16,368,48,9998,0,0,0,0
37,528,80,16,16,304,128,9998,0,0,0,0
37,528,80,16,16,304,144,9998,0,0,0,0
37,528,80,16,16,320,176,9998,0,0,0,0
37,528,80,16,16,288,144,9998,0,0,0,0
37,528,80,16,16,256,96,9998,0,0,0,0
37,528,80,16,16,256,80,9998,0,0,0,0
37,528,80,16,16,272,112,9998,0,0,0,0
37,528,80,16,16,288,128,9998,0,0,0,0
37,528,80,16,16,320,160,9998,0,0,0,0
37,528,80,16,16,352,192,9998,0,0,0,0
37,528,80,16,16,384,224,9998,0,0,0,0
37,528,80,16,16,416,256,9998,0,0,0,0
37,528,80,16,16,432,272,9998,0,0,0,0
37,528,80,16,16,448,288,9998,0,0,0,0
37,528,80,16,16,432,288,9998,0,0,0,0
37,528,80,16,16,368,256,9998,0,0,0,0
37,528,80,16,16,336,224,9998,0,0,0,0
37,528,80,16,16,288,208,9998,0,0,0,0
37,528,80,16,16,240,192,9998,0,0,0,0
37,528,80,16,16,192,176,9998,0,0,0,0
37,528,80,16,16,160,160,9998,0,0,0,0
37,528,80,16,16,128,160,9998,0,0,0,0
37,528,80,16,16,112,160,9998,0,0,0,0
37,528,80,16,16,96,160,9998,0,0,0,0
37,528,80,16,16,112,144,9998,0,0,0,0
37,528,80,16,16,144,128,9998,0,0,0,0
37,528,80,16,16,192,128,9998,0,0,0,0
37,528,80,16,16,256,128,9998,0,0,0,0
37,528,80,16,16,384,192,9998,0,0,0,0
37,528,80,16,16,416,224,9998,0,0,0,0
37,528,80,16,16,448,272,9998,0,0,0,0
37,528,80,16,16,464,288,9998,0,0,0,0
37,528,80,16,16,464,304,9998,0,0,0,0
37,528,80,16,16,432,304,9998,0,0,0,0
37,528,80,16,16,352,272,9998,0,0,0,0
37,528,80,16,16,272,256,9998,0,0,0,0
37,528,80,16,16,176,240,9998,0,0,0,0
37,528,80,16,16,96,224,9998,0,0,0,0
37,528,80,16,16,64,208,9998,0,0,0,0
37,528,80,16,16,32,192,9998,0,0,0,0
37,528,80,16,16,16,176,9998,0,0,0,0
37,528,80,16,16,0,160,9998,0,0,0,0
37,528,80,16,16,0,144,9998,0,0,0,0
37,528,80,16,16,0,128,9998,0,0,0,0
37,528,80,16,16,16,112,9998,0,0,0,0
37,528,80,16,16,48,112,9998,0,0,0,0
37,528,80,16,16,96,112,9998,0,0,0,0
37,528,80,16,16,176,112,9998,0,0,0,0
37,528,80,16,16,240,144,9998,0,0,0,0
37,528,80,16,16,272,176,9998,0,0,0,0
37,528,80,16,16,304,208,9998,0,0,0,0
37,528,80,16,16,320,256,9998,0,0,0,0
37,528,80,16,16,336,288,9998,0,0,0,0
37,528,80,16,16,336,320,9998,0,0,0,0
37,528,80,16,16,336,336,9998,0,0,0,0
37,528,80,16,16,320,352,9998,0,0,0,0
37,528,80,16,16,288,352,9998,0,0,0,0
37,528,80,16,16,240,320,9998,0,0,0,0
37,528,80,16,16,192,272,9998,0,0,0,0
37,528,80,16,16,160,240,9998,0,0,0,0
37,528,80,16,16,112,192,9998,0,0,0,0
37,528,80,16,16,80,160,9998,0,0,0,0
37,528,80,16,16,64,144,9998,0,0,0,0
37,528,80,16,16,32,112,9998,0,0,0,0
37,528,80,16,16,32,96,9998,0,0,0,0
37,528,80,16,16,32,80,9998,0,0,0,0
37,528,80,16,16,32,48,9998,0,0,0,0
37,528,80,16,16,48,16,9998,0,0,0,0
37,528,80,16,16,128,16,9998,0,0,0,0
37,528,80,16,16,224,48,9998,0,0,0,0
37,528,80,16,16,352,128,9998,0,0,0,0
37,528,80,16,16,384,160,9998,0,0,0,0
37,528,80,16,16,400,208,9998,0,0,0,0
37,528,80,16,16,416,240,9998,0,0,0,0
37,528,80,16,16,416,272,9998,0,0,0,0
37,528,80,16,16,400,304,9998,0,0,0,0
37,528,80,16,16,368,336,9998,0,0,0,0
37,528,80,16,16,336,352,9998,0,0,0,0
37,528,80,16,16,608,320,9998,0,0,0,0
37,528,80,16,16,576,272,9998,0,0,0,0
37,528,80,16,16,560,192,9998,0,0,0,0
37,528,80,16,16,544,96,9998,0,0,0,0
37,528,80,16,16,544,80,9998,0,0,0,0
37,528,80,16,16,544,48,9998,0,0,0,0
37,528,80,16,16,560,48,9998,0,0,0,0
37,528,80,16,16,608,32,9998,0,0,0,0
37,528,80,16,16,624,32,9998,0,0,0,0
37,528,80,16,16,624,48,9998,0,0,0,0
37,528,80,16,16,624,80,9998,0,0,0,0
37,528,80,16,16,624,112,9998,0,0,0,0
37,528,80,16,16,624,144,9998,0,0,0,0
37,528,80,16,16,624,176,9998,0,0,0,0
37,528,80,16,16,624,208,9998,0,0,0,0
37,528,80,16,16,624,240,9998,0,0,0,0
37,528,80,16,16,576,288,9998,0,0,0,0
37,528,80,16,16,560,288,9998,0,0,0,0
37,528,80,16,16,528,304,9998,0,0,0,0
37,528,80,16,16,480,320,9998,0,0,0,0
37,528,80,16,16,400,272,9998,0,0,0,0
37,528,80,16,16,384,240,9998,0,0,0,0
37,528,80,16,16,352,208,9998,0,0,0,0
37,528,80,16,16,336,160,9998,0,0,0,0
37,528,80,16,16,320,144,9998,0,0,0,0
37,528,80,16,16,304,112,9998,0,0,0,0
37,528,80,16,16,288,96,9998,0,0,0,0
37,528,80,16,16,288,64,9998,0,0,0,0
37,528,80,16,16,320,32,9998,0,0,0,0
37,528,80,16,16,384,32,9998,0,0,0,0
37,528,80,16,16,448,32,9998,0,0,0,0
37,528,80,16,16,512,48,9998,0,0,0,0
37,528,80,16,16,544,64,9998,0,0,0,0
37,528,80,16,16,592,96,9998,0,0,0,0
37,528,80,16,16,608,128,9998,0,0,0,0
37,528,80,16,16,608,176,9998,0,0,0,0
37,528,80,16,16,592,208,9998,0,0,0,0
37,528,80,16,16,560,256,9998,0,0,0,0
37,528,80,16,16,528,288,9998,0,0,0,0
37,528,80,16,16,496,304,9998,0,0,0,0
37,528,80,16,16,448,320,9998,0,0,0,0
37,528,80,16,16,400,320,9998,0,0,0,0
37,528,80,16,16,368,288,9998,0,0,0,0
37,528,80,16,16,336,240,9998,0,0,0,0
37,528,80,16,16,320,208,9998,0,0,0,0
37,528,80,16,16,304,160,9998,0,0,0,0
37,528,80,16,16,288,112,9998,0,0,0,0
37,528,80,16,16,288,80,9998,0,0,0,0
37,528,80,16,16,288,48,9998,0,0,0,0
37,528,80,16,16,304,32,9998,0,0,0,0
37,528,80,16,16,336,16,9998,0,0,0,0
37,528,80,16,16,400,32,9998,0,0,0,0
37,528,80,16,16,448,48,9998,0,0,0,0
37,528,80,16,16,496,80,9998,0,0,0,0
37,528,80,16,16,528,128,9998,0,0,0,0
37,528,80,16,16,544,160,9998,0,0,0,0
37,528,80,16,16,544,208,9998,0,0,0,0
37,528,80,16,16,528,272,9998,0,0,0,0
37,528,80,16,16,496,288,9998,0,0,0,0
37,528,80,16,16,480,304,9998,0,0,0,0
37,528,80,16,16,448,304,9998,0,0,0,0
37,528,80,16,16,416,288,9998,0,0,0,0
37,528,80,16,16,400,256,9998,0,0,0,0
37,528,80,16,16,368,208,9998,0,0,0,0
37,528,80,16,16,352,160,9998,0,0,0,0
37,528,80,16,16,352,144,9998,0,0,0,0
37,528,80,16,16,352,112,9998,0,0,0,0
37,528,80,16,16,352,96,9998,0,0,0,0
37,528,80,16,16,368,80,9998,0,0,0,0
37,528,80,16,16,400,80,9998,0,0,0,0
37,528,80,16,16,448,112,9998,0,0,0,0
37,528,80,16,16,480,128,9998,0,0,0,0
37,528,80,16,16,512,160,9998,0,0,0,0
37,528,80,16,16,528,208,9998,0,0,0,0
37,528,80,16,16,544,240,9998,0,0,0,0
37,528,80,16,16,544,304,9998,0,0,0,0
37,528,80,16,16,544,336,9998,0,0,0,0
37,528,80,16,16,544,352,9998,0,0,0,0
37,528,80,16,16,576,320,9998,0,0,0,0
37,528,80,16,16,544,288,9998,0,0,0,0
37,528,80,16,16,496,240,9998,0,0,0,0
37,528,80,16,16,464,208,9998,0,0,0,0
37,528,80,16,16,448,176,9998,0,0,0,0
37,528,80,16,16,432,144,9998,0,0,0,0
37,528,80,16,16,432,128,9998,0,0,0,0
37,528,80,16,16,432,112,9998,0,0,0,0
37,528,80,16,16,432,96,9998,0,0,0,0
37,528,80,16,16,448,80,9998,0,0,0,0
37,528,80,16,16,464,80,9998,0,0,0,0
37,528,80,16,16,512,112,9998,0,0,0,0
37,528,80,16,16,544,128,9998,0,0,0,0
37,528,80,16,16,576,176,9998,0,0,0,0
37,528,80,16,16,592,224,9998,0,0,0,0
37,528,80,16,16,608,256,9998,0,0,0,0
37,528,80,16,16,608,288,9998,0,0,0,0
37,528,80,16,16,624,320,9998,0,0,0,0
37,528,80,16,16,624,336,9998,0,0,0,0
37,528,80,16,16,624,352,9998,0,0,0,0
37,528,80,16,16,608,352,9998,0,0,0,0
37,528,80,16,16,592,352,9998,0,0,0,0
37,528,80,16,16,560,320,9998,0,0,0,0
37,528,80,16,16,512,288,9998,0,0,0,0
37,528,80,16,16,480,256,9998,0,0,0,0
37,528,80,16,16,432,208,9998,0,0,0,0
37,528,80,16,16,416,160,9998,0,0,0,0
37,528,80,16,16,400,144,9998,0,0,0,0
37,528,80,16,16,400,128,9998,0,0,0,0
37,528,80,16,16,384,112,9998,0,0,0,0
37,528,80,16,16,384,96,9998,0,0,0,0
37,528,80,16,16,400,96,9998,0,0,0,0
37,528,80,16,16,416,96,9998,0,0,0,0
37,528,80,16,16,416,112,9998,0,0,0,0
987654321
MwAjEUArQ2lkJS1LMlhUelgpbV1CXhkCFGRzHR4lY1U1Ly1wcXx0dg==
BgsiCwU0VSRgJXkOJEJZMls5bxhdDjVMHWx5Hx4lYxpyJywzbTQ=
EwEnB0AtXmloKmZHPUwNOxQgfk5LEg==

