UVx6TlN0AGU9Z1dpBUZ0DUx8Vmx7CR1jRDg7OlEifxg9AhgCQTghenh/cUNiVSc2HGgk
160,346,346,0,0,16777215,0,0,0,1,21,0
158,276,344,0,1,16777215,0,1,0,1,20,0
197,195,211,0,2,0,0,0,0,1,22,0
197,280,208,0,2,0,0,0,0,1,48,0
197,352,208,0,2,0,0,0,0,1,47,0
197,448,211,0,2,0,0,0,0,1,23,0
174,48,208,0,1,54,0,0,0,0,50,1
167,320,112,0,576,270,0,0,0,1,7,0
304,316,247,0,0,0,0,0,0,1,19,0
186,192,80,0,0,0,0,0,0,1,14,0
186,448,64,0,0,0,0,0,0,1,13,0
185,512,88,0,0,32,1,0,0,1,10,0
185,128,88,0,0,32,1,0,0,1,9,0
185,608,344,0,0,48,1,0,0,1,3,0
185,32,344,0,0,48,1,0,0,1,2,0
154,80,24,0,1,0.50,96,16,1,0,54,1
157,48,216,0,48,16,0,0,0,1,49,0
157,280,216,0,16,16,0,0,0,1,18,0
157,352,216,0,16,16,0,0,0,1,17,0
157,396,296,0,16,16,0,0,0,1,16,0
157,242,295,0,16,16,0,0,0,1,15,0
157,442,225,0,48,32,0,0,0,1,12,0
157,199,226,0,48,32,0,0,0,1,11,0
157,512,280,0,32,32,0,0,0,1,6,0
157,317,272,0,64,32,0,0,0,1,5,0
157,128,280,0,32,32,0,0,0,1,4,0
157,320,352,0,512,16,0,0,0,1,45,0
237,320,0,0,16777215,300,0,0,0,1,8,0
155,216,24,0,2,1,0,0,0,1,53,0
155,80,24,0,1,1,0,0,0,1,52,0
1234567890
37,160,192,64,64,480,288,9998,0,0,0,0
37,160,192,64,64,96,304,9998,0,0,0,0
37,160,192,64,64,96,240,9998,0,0,0,0
37,160,192,64,64,96,176,9998,0,0,0,0
37,160,192,64,64,96,112,9998,0,0,0,0
37,160,192,64,64,96,48,9998,0,0,0,0
37,160,192,64,64,480,224,9998,0,0,0,0
37,160,192,64,64,480,160,9998,0,0,0,0
37,160,192,64,64,480,96,9998,0,0,0,0
37,160,192,64,64,480,32,9998,0,0,0,0
37,160,208,64,32,96,16,9998,0,0,0,0
37,160,208,64,32,480,0,9998,0,0,0,0
37,160,224,48,16,112,0,9998,0,0,0,0
37,192,224,16,16,96,0,9998,0,0,0,0
39,128,48,96,96,272,64,9998,0,0,0,0
39,96,80,32,32,240,96,9998,0,0,0,0
39,96,80,32,32,208,96,9998,0,0,0,0
39,96,80,32,32,368,96,9998,0,0,0,0
39,96,80,32,32,400,96,9998,0,0,0,0
39,544,0,48,64,176,0,9998,0,0,0,0
39,544,0,48,64,416,0,9998,0,0,0,0
39,16,96,32,48,176,96,9998,0,0,0,0
39,16,96,32,48,432,96,9998,0,0,0,0
39,160,144,32,16,432,144,9998,0,0,0,0
39,160,144,32,16,432,160,9998,0,0,0,0
39,160,144,32,16,432,176,9998,0,0,0,0
39,160,144,32,16,432,192,9998,0,0,0,0
39,160,144,32,16,432,208,9998,0,0,0,0
39,160,144,32,16,432,224,9998,0,0,0,0
39,160,144,32,16,432,240,9998,0,0,0,0
39,160,144,32,16,432,256,9998,0,0,0,0
39,160,144,32,16,432,272,9998,0,0,0,0
39,160,144,32,16,432,288,9998,0,0,0,0
39,160,144,32,16,432,304,9998,0,0,0,0
39,160,144,32,16,432,320,9998,0,0,0,0
39,160,144,32,16,176,144,9998,0,0,0,0
39,160,144,32,16,176,160,9998,0,0,0,0
39,160,144,32,16,176,176,9998,0,0,0,0
39,160,144,32,16,176,192,9998,0,0,0,0
39,160,144,32,16,176,208,9998,0,0,0,0
39,160,144,32,16,176,224,9998,0,0,0,0
39,160,144,32,16,176,240,9998,0,0,0,0
39,160,144,32,16,176,256,9998,0,0,0,0
39,160,144,32,16,176,272,9998,0,0,0,0
39,160,144,32,16,176,288,9998,0,0,0,0
39,160,144,32,16,176,304,9998,0,0,0,0
39,160,144,32,16,176,320,9998,0,0,0,0
39,288,16,112,112,208,240,9998,0,0,0,0
39,288,16,112,112,320,240,9998,0,0,0,0
987654321
EwAjEUAvUTklIn4OI0ReKV0ud10OHThDF2ZyWEo+LAUzOSpwNToyZ2hwZE8=

