X1F8TlN0AGU9Z1QcFV50DWZ9QU8TQ3xkFml7F0kFZBABLzcjamZTMyk+bV9+STsqAHQ4J0Mqcic=
160,880,352,0,0,16777215,0,0,0,1,34,0
158,40,352,0,1,16777215,0,1,0,1,2,0
123,320,0,0,784,32906,0,0,0,1,9,0
157,848,304,0,16,32,0,0,0,1,36,0
157,872,296,0,48,16,0,0,0,1,33,0
157,480,344,0,16,16,0,0,0,1,21,0
157,464,328,0,16,16,0,0,0,1,20,0
157,432,296,0,16,16,0,0,0,1,19,0
157,448,312,0,16,16,0,0,0,1,18,0
157,384,280,0,80,16,0,0,0,1,17,0
157,336,280,0,16,16,0,0,0,1,10,0
157,424,360,0,992,16,0,0,0,1,1,0
169,840,320,0,0,0,0,0,0,1,35,1
301,496,344,0,0,0,0,35,0,0,32,1
301,792,225,0,0,0,227,32,0,0,31,1
301,680,216,0,0,0,269,31,0,0,30,1
301,656,216,0,0,0,269,28,0,0,29,1
301,664,216,0,0,0,269,25,0,0,28,1
301,648,216,0,0,0,269,29,0,0,27,1
301,640,216,0,0,0,269,27,0,0,26,1
301,672,216,0,0,0,269,30,0,0,25,1
301,624,216,0,0,0,269,22,0,0,24,1
301,616,216,0,0,0,269,24,0,0,23,1
301,632,216,0,0,0,269,26,0,0,22,1
301,400,208,0,0,0,269,12,0,0,16,1
301,608,216,0,0,0,269,23,0,0,15,1
301,544,112,0,0,0,0,0,0,0,14,1
301,352,200,0,0,0,317,11,0,0,12,1
301,632,344,0,0,0,180,15,0,0,11,1
301,256,261,0,0,0,0,16,0,0,7,1
301,344,336,0,0,0,180,5,0,0,6,1
301,315,151,0,0,0,269,7,0,0,5,1
301,120,232,0,0,0,270,6,0,1,3,1
1234567890
24,16,16,16,16,320,16,9998,0,0,0,0
24,16,16,16,16,320,32,9998,0,0,0,0
24,16,16,16,16,304,32,9998,0,0,0,0
24,16,16,16,16,304,16,9998,0,0,0,0
24,16,16,16,16,480,16,9998,0,0,0,0
24,16,16,16,16,480,32,9998,0,0,0,0
24,16,16,16,16,496,32,9998,0,0,0,0
24,16,16,16,16,496,16,9998,0,0,0,0
24,16,16,16,16,272,96,9998,0,0,0,0
24,16,16,16,16,272,112,9998,0,0,0,0
24,16,16,16,16,288,112,9998,0,0,0,0
24,16,16,16,16,288,128,9998,0,0,0,0
24,16,16,16,16,304,128,9998,0,0,0,0
24,16,16,16,16,304,144,9998,0,0,0,0
24,16,16,16,16,320,144,9998,0,0,0,0
24,16,16,16,16,320,160,9998,0,0,0,0
24,16,16,16,16,336,160,9998,0,0,0,0
24,16,16,16,16,352,160,9998,0,0,0,0
24,16,16,16,16,368,160,9998,0,0,0,0
24,16,16,16,16,384,160,9998,0,0,0,0
24,16,16,16,16,400,160,9998,0,0,0,0
24,16,16,16,16,416,160,9998,0,0,0,0
24,16,16,16,16,432,160,9998,0,0,0,0
24,16,16,16,16,432,144,9998,0,0,0,0
24,16,16,16,16,448,144,9998,0,0,0,0
24,16,16,16,16,464,128,9998,0,0,0,0
24,16,16,16,16,480,128,9998,0,0,0,0
24,16,16,16,16,480,112,9998,0,0,0,0
24,16,16,16,16,496,112,9998,0,0,0,0
24,16,16,16,16,496,96,9998,0,0,0,0
24,16,16,16,16,512,96,9998,0,0,0,0
24,16,16,16,16,512,80,9998,0,0,0,0
24,16,16,16,16,528,80,9998,0,0,0,0
987654321
MwAjEUAuVT9gJy1HIAtGM1ooO1dIXjVDCnw5WHwkeFULBQxwVlxeAwQXYQ==
NyQLO0ALZGlnLm5PJlhIel04O1FdXjFVHHZ4FVt/

