UVx6TlN0AGU9Z1QcFV50DWZ9QU8TQ3xlFmpzNEsyZ1liZml8NTghenh/cUNi
259,16,296,0,64,112,0,0,0,1,90,0
158,224,184,0,1,16777215,0,1,0,1,8,0
160,40,72,0,0,16777215,0,0,0,1,96,0
100,248,136,0,336,16777215,0,269,0,1,5,0
100,368,136,0,336,16777215,0,269,0,1,7,0
311,304,312,1,864,176,615689,0,0,1,11,0
100,304,136,0,336,16777215,0,269,0,1,6,0
311,344,48,1,336,128,16777215,0,0,1,72,0
197,24,352,0,2,0,0,0,0,1,91,0
174,264,112,0,1,76,79,78,72,0,82,1
205,282,112,0,1,0,0.50,0,0,1,74,0
181,355,304,0,16,128,0,0,0,1,24,0
181,325.50,304,0,68,128,0,0,0,1,70,0
181,80,304,0,21,128,0,0,0,1,23,0
186,424,112,0,0,0,0,0,0,1,73,0
242,504,48,0,16,128,0,0,0,1,101,0
242,184,40,0,16,144,0,0,0,1,98,0
210,73,72,0,92,0,0,0,0,1,97,0
210,8,352,0,97,0,0,0,0,1,92,0
154,360.59,285.02,0,3,0.50,16,16,-1,1,68,1
154,176.60,279.94,0,2,0.50,16,16,-1,1,21,1
154,436.34,302.81,0,1,0.50,16,16,-1,1,16,1
157,488,208,0,384,32,0,0,0,1,100,0
157,48,80,0,112,16,0,0,0,1,95,0
157,96,32,0,16,80,0,0,0,1,94,0
157,8,40,0,16,96,0,0,0,1,93,0
157,8,232,0,48,16,0,0,0,1,89,0
157,104,192,0,16,16,0,0,0,1,83,0
157,184,104,0,16,16,0,0,0,1,80,0
157,528,176,0,112,32,0,0,0,1,71,0
157,640,304,0,16,160,0,0,0,1,10,0
157,40,280,0,16,112,0,0,0,1,9,0
157,184,152,0,16,80,0,0,0,1,4,0
157,344,120,0,336,16,0,0,0,1,3,0
157,296,192,0,240,16,0,0,0,1,2,0
157,128,360,0,1152,16,0,0,0,1,64,0
169,176,32,0,0,0,0,0,0,1,79,1
169,176,0,0,0,0,0,0,0,1,78,1
169,176,64,0,0,0,0,0,0,1,76,1
155,104,264,0,4,2,0,0,0,1,87,0
155,480,232,0,3,1,0,0,0,1,86,0
155,232,240,0,3,2,0,0,0,1,85,0
155,192,320,0,3,3,0,0,0,1,84,0
155,416,303,0,2,3,0,0,0,1,67,0
155,265,254,0,1,3,0,0,0,1,66,0
155,181,279,0,2,2,0,0,0,1,20,0
155,64,304,0,1,2,0,0,0,1,19,0
155,570,266,0,2,1,0,0,0,1,15,0
155,432,304,0,1,1,0,0,0,1,14,0
1234567890
38,480,224,48,32,128,320,10000,0,0,0,0
38,480,224,48,32,544,320,10000,0,0,0,0
38,480,224,48,32,400,320,10000,0,0,0,0
38,480,224,48,32,240,256,10000,0,0,0,0
38,480,224,48,32,208,304,10000,0,0,0,0
38,480,224,48,32,352,256,10000,0,0,0,0
38,480,224,48,32,416,240,10000,0,0,0,0
38,480,224,48,32,112,256,10000,0,0,0,0
38,480,224,48,32,80,224,10000,0,0,0,0
38,480,224,48,32,80,304,10000,0,0,0,0
38,480,224,48,32,480,272,10000,0,0,0,0
38,480,224,48,32,320,224,10000,0,0,0,0
38,480,224,48,32,304,288,10000,0,0,0,0
38,480,224,48,32,336,320,10000,0,0,0,0
38,480,224,48,32,560,288,10000,0,0,0,0
38,480,224,48,32,464,304,10000,0,0,0,0
38,480,224,48,32,368,288,10000,0,0,0,0
38,480,224,48,32,192,224,10000,0,0,0,0
38,480,224,48,32,256,320,10000,0,0,0,0
38,480,224,48,32,176,272,10000,0,0,0,0
38,480,224,48,32,288,256,10000,0,0,0,0
38,480,224,48,32,256,224,10000,0,0,0,0
38,480,224,48,32,256,288,10000,0,0,0,0
38,480,224,48,32,144,224,10000,0,0,0,0
38,480,224,48,32,48,272,10000,0,0,0,0
38,480,224,48,32,480,224,10000,0,0,0,0
38,480,224,48,32,368,224,10000,0,0,0,0
38,480,224,48,32,416,272,10000,0,0,0,0
38,480,224,48,32,560,224,10000,0,0,0,0
38,480,224,48,32,528,256,10000,0,0,0,0
39,240,112,16,112,192,0,9998,0,0,0,0
39,240,112,16,112,208,0,9998,0,0,0,0
39,240,112,16,112,224,0,9998,0,0,0,0
39,240,112,16,112,240,0,9998,0,0,0,0
39,240,112,16,112,256,0,9998,0,0,0,0
39,240,112,16,112,272,0,9998,0,0,0,0
39,240,112,16,112,288,0,9998,0,0,0,0
39,240,112,16,112,304,0,9998,0,0,0,0
39,240,112,16,112,320,0,9998,0,0,0,0
39,240,112,16,112,336,0,9998,0,0,0,0
39,240,112,16,112,352,0,9998,0,0,0,0
39,240,112,16,112,368,0,9998,0,0,0,0
39,240,112,16,112,384,0,9998,0,0,0,0
39,240,112,16,112,400,0,9998,0,0,0,0
39,240,112,16,112,416,0,9998,0,0,0,0
39,240,112,16,112,432,0,9998,0,0,0,0
39,240,112,16,112,448,0,9998,0,0,0,0
39,240,112,16,112,464,0,9998,0,0,0,0
39,240,112,16,112,480,0,9998,0,0,0,0
39,240,112,16,112,496,0,9998,0,0,0,0
987654321
MwAjEUAuVT9gJy1HIAtGM1ooO1dIXjVDCnw5WHwkeFULBQxwVlxeAwQXYQ==
NyQLO0ALZGlnLm5PJlhIel04O1FdXjFVHHZ4FVt/

