X15+TlN0AGU9Z1QcFV50DWZ9QU8TQ3xyFndjGVIFYyI7JHVgKSQ9ZmRjbV9+STsq
259,232,224,0,16,32,0,0,0,1,516,0
259,216,240,0,32,240,0,0,0,1,515,0
160,720,352,0,0,16777215,0,0,0,1,519,0
158,32,352,0,1,16777215,0,1,0,1,3,0
224,340,184,0,1856,222211,0,0,0,1,6,0
197,680,280,0,2,0,0,0,0,1,524,0
193,350,96,1,1,47,0,0,0,1,46,0
174,760,280,0,1,523,0,0,0,0,520,1
174,589,279,0,1,523,0,0,0,0,521,1
205,32,287,0,-1,0,0.30,0,0,0,19,0
176,624,48,0,53,384,128,0,0,1,56,0
176,336,56,0,45,192,112,0,0,1,44,0
176,688,160,0,60,384,96,0,0,1,62,0
176,80,136,0,41,48,112,0,0,1,38,0
176,40,256,0,19,128,64,0,0,1,23,0
176,129,255,0,20,48,64,0,0,1,22,0
273,672,224,0,66,0,0,0,0,1,523,0
216,288,56,0,-1,0,0,96,R28gaGVyZSMtPg==,0,45,0
210,144,80,0,0,180,0,0,0,1,73,0
210,80,64,0,0,0,0,0,0,1,75,0
210,301,151,0,0,180,13,0,0,1,79,0
210,80,80,0,75,180,0,0,0,1,74,0
210,80,224,0,73,180,0,0,0,1,72,0
210,176,288,0,0,0,0,0,0,1,526,0
210,216,352,0,518,0,0,0,0,1,517,0
210,351,352,0,526,0,0,0,0,1,512,0
210,144,352,0,79,0,0,0,0,1,511,0
210,720,0,0,0,180,0,0,0,1,518,0
154,676.50,288,0,6,0.50,32,16,1,1,66,1
154,656,168,0,5,0.50,32,16,1,0,60,1
154,584,96,0,4,0.50,32,16,1,0,54,1
154,352,104,0,3,0.60,32,16,1,0,49,1
154,79,200,0,2,0.50,48,16,1,0,41,1
154,442.50,144,0,1,0.50,32,16,1,1,13,1
157,232,168,0,16,80,0,0,0,1,514,0
157,232,296,0,16,112,0,0,0,1,513,0
157,192,80,0,8,8,0,0,0,1,32,0
157,232,112,0,8,8,0,0,0,1,31,0
157,192,72,0,8,8,0,0,0,1,30,0
157,200,80,0,8,8,0,0,0,1,29,0
157,216,96,0,8,8,0,0,0,1,28,0
157,224,104,0,8,8,0,0,0,1,27,0
157,208,88,0,8,8,0,0,0,1,26,0
157,192,96,0,16,32,0,0,0,1,25,0
157,96,72,0,192,16,0,0,0,1,24,0
157,96,216,0,192,16,0,0,0,1,18,0
157,192,240,0,16,224,0,0,0,1,17,0
157,344,120,0,320,16,0,0,0,1,16,0
157,496,240,0,16,224,0,0,0,1,15,0
157,176,328,0,16,64,0,0,0,1,7,0
157,89,295,0,192,16,0,0,0,1,4,0
157,608,360,0,1408,16,0,0,0,1,503,0
169,104,224,0,0,0,0,0,0,1,21,1
169,104,256,0,0,0,0,0,0,1,20,1
166,384,344,0,0,0,0,0,0,1,10,1
166,320,344,0,0,0,180,0,0,1,9,1
155,768,288,0,2,6,0,0,0,1,65,0
155,576,288,0,1,6,0,0,0,1,64,0
155,856,168,0,2,5,0,0,0,1,59,0
155,656,168,0,1,5,0,0,0,0,58,0
155,784,96,0,2,4,0,0,0,1,53,0
155,584,96,0,1,4,0,0,0,1,52,0
155,624,104,0,2,3,0,0,0,1,48,0
155,352,104,0,1,3,0,0,0,0,47,0
155,79,200,0,2,2,0,0,0,1,40,0
155,80,96,0,1,2,0,0,0,1,39,0
155,456,144,0,2,1,0,0,0,1,12,0
155,280,144,0,1,1,0,0,0,1,11,0
1234567890
25,16,16,16,16,192,112,10002,0,0,0,0
25,16,16,16,16,208,112,10002,0,0,0,0
25,16,16,16,16,240,112,10002,0,0,0,0
25,16,16,16,16,256,112,10002,0,0,0,0
25,16,16,16,16,272,112,10002,0,0,0,0
25,16,16,16,16,288,112,10002,0,0,0,0
25,16,16,16,16,304,112,10002,0,0,0,0
25,16,16,16,16,320,112,10002,0,0,0,0
25,16,16,16,16,336,112,10002,0,0,0,0
25,16,16,16,16,352,112,10002,0,0,0,0
25,16,16,16,16,368,112,10002,0,0,0,0
25,16,16,16,16,384,112,10002,0,0,0,0
25,16,16,16,16,400,112,10002,0,0,0,0
25,16,16,16,16,416,112,10002,0,0,0,0
25,16,16,16,16,432,112,10002,0,0,0,0
25,16,16,16,16,448,112,10002,0,0,0,0
25,16,16,16,16,464,112,10002,0,0,0,0
25,16,16,16,16,480,112,10002,0,0,0,0
25,16,16,16,16,224,336,10002,0,0,0,0
25,16,16,16,16,224,320,10002,0,0,0,0
25,16,16,16,16,224,304,10002,0,0,0,0
25,16,16,16,16,224,288,10002,0,0,0,0
25,16,16,16,16,224,272,10002,0,0,0,0
25,16,16,16,16,224,256,10002,0,0,0,0
25,16,16,16,16,224,240,10002,0,0,0,0
25,16,16,16,16,224,192,10002,0,0,0,0
25,16,16,16,16,224,176,10002,0,0,0,0
25,16,16,16,16,224,160,10002,0,0,0,0
25,16,16,16,16,224,144,10002,0,0,0,0
25,16,16,16,16,224,128,10002,0,0,0,0
25,16,16,16,16,224,112,10002,0,0,0,0
987654321
MwAjEUAuVT9gJy1HIAtGM1ooO1dIXjVDCnw5WHwkeFULBQxwVlxeAwQXYQ==
NyQLO0ALZGlnLm5PJlhIel04O1FdXjFVHHZ4FVt/

