X1h6TlN0AGU9Z19rYm9jH2YkeVZ8EjMRN387LEwoRBQgLnVgKSQ9ZmRjbV9+STsq
259,536,64,0,32,32,0,0,0,1,287,0
259,408,40,0,64,64,0,0,0,1,280,0
259,344,40,0,64,64,0,0,0,1,279,0
259,280,40,0,64,64,0,0,0,1,278,0
259,216,32,0,64,64,0,0,0,1,277,0
259,152,32,0,64,64,0,0,0,1,276,0
259,88,32,0,64,64,0,0,0,1,275,0
259,464,176,0,32,32,0,0,0,1,274,0
259,752,168,0,32,32,0,0,0,1,267,0
259,672,232,0,64,32,0,0,0,1,266,0
259,720,200,0,160,32,0,0,0,1,265,0
259,720,288,0,160,130,0,0,0,1,264,0
259,528,88,0,32,32,0,0,0,1,263,0
259,672,72,0,270,200,0,0,0,1,262,0
259,488,152,0,80,32,0,0,0,1,261,0
259,320,272,0,620,180,0,0,0,1,260,0
259,24,120,0,64,32,0,0,0,1,259,0
259,224,152,0,450,64,0,0,0,1,258,0
259,224,88,0,450,40,0,0,0,1,257,0
259,800,224,0,16,16,0,0,0,1,252,0
259,784,224,0,16,16,0,0,0,1,250,0
259,768,224,0,16,16,0,0,0,1,249,0
259,480,24,0,96,64,0,0,0,1,50,0
158,24,56,0,1,16777215,0,1,0,1,49,0
160,776,344,0,0,16777215,0,0,0,1,160,0
195,248,120,0,0,80,271,96,107,1,80,0
195,344,120,0,0,80,271,101,105,1,81,0
311,232,152,1,400,64,16777215,0,0,0,104,0
178,575,88,0,16,16,0,0,0,0,219,0
195,160,120,0,0,80,271,91,105,1,78,0
224,728,272,0,128,11108964,0,0,0,1,255,0
224,672,72,0,128,32906,0,0,161,1,195,0
311,320,272,1,648,176,255,0,0,0,143,0
195,80,120,0,0,80,270,86,107,1,76,0
123,479,28,0,68,16777215,0,0,0,0,13,0
178,424,23,0,16,64,0,0,0,0,12,0
197,356,55,0,2,6,0,0,0,1,9,0
197,640,168,0,1,180,0,0,0,1,189,0
194,344,288,0,0,200,271,0,0,1,150,0
167,544,272,0,128,270,0,0,0,1,132,0
194,224,288,0,0,200,90,0,0,1,149,0
194,112,288,0,0,200,180,0,0,1,148,0
186,760,72,0,0,0,0,0,0,1,176,0
188,360,168,0,0,104,0,0,0,1,73,0
188,720,168,0,0,203,181,0,0,1,202,0
188,296,168,0,0,104,0,0,0,1,75,0
188,240,168,0,0,104,0,0,0,1,72,0
188,184,168,0,0,104,0,0,0,1,71,0
188,128,168,0,0,104,0,0,0,1,70,0
188,72,168,0,0,104,0,0,0,1,69,0
185,400,88,0,64,16,1,0,0,1,59,0
242,352,336,0,32,32,0,0,0,1,294,0
242,496,152,0,32,32,0,0,0,1,156,0
242,400,208,0,32,32,0,0,0,1,154,0
176,400,208,0,143,32,16,0,0,1,152,0
176,400,208,0,121,32,16,0,0,1,151,0
176,440,23,0,22,16,64,0,0,1,30,0
176,440,23,0,13,16,64,0,0,1,15,0
176,440,24,0,12,16,64,0,0,1,21,0
176,440,24,0,20,16,64,0,0,1,31,0
176,440,24,0,50,16,64,0,0,1,51,0
176,496,152,0,163,32,32,0,0,1,256,0
176,240,88,0,62,32,32,0,0,1,68,0
176,784,168,0,230,32,32,0,0,1,248,0
176,712,152,0,219,32,32,0,0,1,220,0
216,224,88,0,-1,0,0,96,UnVu,1,60,0
154,720.70,264,0,12,0.10,16,16,1,1,244,1
154,784,176,0,11,0.20,40,16,1,1,232,1
154,664,144,0,10,0.20,32,48,1,1,205,1
154,704,72,0,9,0.20,48,16,1,1,182,1
154,536,136,0,8,0.10,16,64,1,1,165,1
154,400,232,0,7,0.50,32,16,1,1,123,1
154,341.30,160,0,6,0.35,16,16,-1,1,101,1
154,234.75,160,0,5,0.35,16,16,-1,1,96,1
154,157.30,160,0,4,0.35,16,16,-1,1,91,1
154,84.70,160,0,3,0.35,16,16,-1,1,86,1
154,400,88,0,2,3,16,16,-1,1,64,1
154,440,8,0,1,0.25,16,16,-1,1,24,1
157,688,224,0,16,16,0,0,0,1,237,0
157,704,224,0,16,16,0,0,0,1,236,0
157,720,224,0,16,16,0,0,0,1,235,0
157,736,224,0,16,16,0,0,0,1,234,0
157,752,224,0,16,16,0,0,0,1,229,0
157,760,352,0,80,16,0,0,0,1,228,0
157,680,352,0,80,16,0,0,0,1,227,0
157,744,176,0,16,16,0,0,0,1,200,0
157,744,144,0,32,48,0,0,0,1,199,0
157,800,88,0,48,16,0,0,0,1,188,0
157,752,88,0,48,16,0,0,0,1,179,0
157,552,48,0,16,16,0,0,0,1,178,0
157,656,88,0,48,16,0,0,0,1,175,0
157,552,24,0,16,32,0,0,0,1,174,0
157,552,64,0,16,16,0,0,0,1,171,0
157,552,96,0,16,16,0,0,0,1,169,0
157,552,128,0,16,16,0,0,0,1,168,0
157,592,88,0,16,16,0,0,0,1,167,0
157,488,104,0,80,72,0,0,0,1,162,0
157,632,344,0,16,64,0,0,0,1,146,0
157,632,248,0,16,128,0,0,0,1,135,0
157,476,278,0,16,16,0,0,0,1,134,0
157,8,360,0,16,96,0,0,0,1,116,0
157,8,248,0,16,128,0,0,0,1,115,0
157,440,248,0,16,128,0,0,0,1,112,0
157,672,176,0,128,16,0,0,0,1,110,0
157,544,176,0,128,16,0,0,0,1,109,0
157,424,176,0,16,16,0,0,0,1,106,0
157,320,176,0,128,16,0,0,0,1,74,0
157,192,176,0,128,16,0,0,0,1,58,0
157,64,176,0,128,16,0,0,0,1,57,0
157,112,112,0,128,16,0,0,0,1,56,0
157,240,112,0,128,16,0,0,0,1,55,0
157,368,112,0,128,16,0,0,0,1,54,0
157,440,120,0,16,128,0,0,0,1,53,0
157,536,23,0,16,64,0,0,0,1,11,0
157,512,64,0,64,16,0,0,0,1,10,0
157,448,63,0,64,16,0,0,0,1,8,0
157,384,63,0,64,16,0,0,0,1,7,0
157,320,63,0,64,16,0,0,0,1,5,0
157,224,63,0,64,16,0,0,0,1,4,0
157,160,63,0,64,16,0,0,0,1,3,0
157,96,63,0,64,16,0,0,0,1,2,0
157,32,63,0,64,16,0,0,0,1,48,0
172,384,168,0,0,0,0,0,0,0,105,1
172,256,55,0,0,0,0,0,0,1,6,1
301,616,216,0,0,0,179,143,0,1,142,1
301,488,192,0,0,0,270,143,0,1,133,1
301,16,344,0,0,0,0,143,0,1,117,1
301,40,184,0,0,0,270,143,0,1,114,1
301,432,208,0,0,0,180,143,0,1,113,1
166,752,232,0,0,0,271,0,0,1,240,1
166,720,232,0,0,0,271,0,0,1,239,1
166,688,232,0,0,0,271,0,0,1,238,1
166,432,160,0,0,0,180,0,0,0,107,1
166,520,6,0,0,24,0,0,0,0,20,1
155,768,264,0,4,12,0,0,0,1,247,0
155,728,264,0,3,12,60,0,0,1,246,0
155,704,264,0,2,12,30,0,0,1,243,0
155,688,264,0,1,12,0,0,0,1,242,0
155,784,224,0,2,11,0,0,0,0,231,0
155,784,176,0,1,11,0,0,0,0,230,0
155,704,8,0,3,9,0,0,0,0,214,0
155,712,56,0,4,10,0,0,0,0,208,0
155,712,120,0,3,10,0,0,0,1,207,0
155,664,120,0,2,10,0,0,0,1,204,0
155,664,144,0,1,10,0,0,0,0,203,0
155,704,88,0,2,9,0,0,0,0,181,0
155,704,72,0,1,9,0,0,0,0,180,0
155,536,104,0,2,8,0,0,0,0,164,0
155,536,136,0,1,8,0,0,0,0,163,0
155,464,176,0,15,7,0,0,0,0,141,0
155,464,208,0,14,7,0,0,0,1,140,0
155,496,248,0,13,7,0,0,0,1,139,0
155,600,224,0,12,7,0,0,0,1,138,0
155,600,320,0,11,7,0,0,0,1,137,0
155,536,336,0,10,7,0,0,0,1,136,0
155,496,304,0,9,7,0,0,0,1,131,0
155,472,360,0,8,7,0,0,0,1,130,0
155,48,360,0,7,7,0,0,0,1,129,0
155,48,312,0,6,7,20,0,0,1,128,0
155,40,288,0,5,7,5,0,0,1,127,0
155,56,232,0,4,7,18,0,0,1,126,0
155,144,232,0,3,7,15,0,0,1,125,0
155,264,232,0,2,7,20,0,0,1,122,0
155,400,232,0,1,7,0,0,0,0,121,0
155,384,160,0,2,6,0,0,0,1,100,0
155,328,160,0,1,6,0,0,0,1,99,0
155,296,160,0,2,5,0,0,0,1,95,0
155,232,160,0,1,5,0,0,0,1,94,0
155,200,160,0,2,4,0,0,0,1,90,0
155,144,160,0,1,4,0,0,0,1,89,0
155,104,160,0,2,3,0,0,0,1,85,0
155,56,160,0,1,3,0,0,0,1,84,0
155,24,88,0,4,2,0,0,0,0,67,0
155,160,88,0,3,2,20,0,0,1,66,0
155,272,88,0,2,2,10,0,0,1,63,0
155,400,88,0,1,2,0,0,0,0,62,0
155,520,47,0,4,1,0,0,0,0,28,0
155,480,48,0,3,1,0,0,0,1,26,0
155,440,48,0,2,1,0,0,0,1,23,0
155,440,8,0,1,1,0,0,0,0,22,0
1234567890
25,144,112,16,16,672,64,10002,0,0,0,0
25,144,112,16,16,720,64,10002,0,0,0,0
38,272,160,48,16,448,144,10000,0,0,0,0
25,48,256,48,48,0,0,10002,0,0,0,0
25,48,256,48,48,48,0,10002,0,0,0,0
25,48,256,48,48,96,0,10002,0,0,0,0
25,48,256,48,48,144,0,10002,0,0,0,0
25,48,256,48,48,192,0,10002,0,0,0,0
25,48,256,48,48,240,0,10002,0,0,0,0
25,48,256,48,48,288,0,10002,0,0,0,0
25,48,256,48,48,336,0,10002,0,0,0,0
25,48,256,48,48,384,0,10002,0,0,0,0
25,48,256,48,48,432,0,10002,0,0,0,0
25,48,256,48,48,480,0,10002,0,0,0,0
25,64,272,16,16,0,48,10002,0,0,0,0
25,64,272,16,16,16,48,10002,0,0,0,0
25,64,272,16,16,32,48,10002,0,0,0,0
25,64,272,16,16,48,48,10002,0,0,0,0
25,64,272,16,16,64,48,10002,0,0,0,0
25,64,272,16,16,80,48,10002,0,0,0,0
25,64,272,16,16,96,48,10002,0,0,0,0
25,64,272,16,16,112,48,10002,0,0,0,0
25,64,272,16,16,128,48,10002,0,0,0,0
25,64,272,16,16,144,48,10002,0,0,0,0
25,64,272,16,16,160,48,10002,0,0,0,0
25,64,272,16,16,176,48,10002,0,0,0,0
25,64,272,16,16,192,48,10002,0,0,0,0
25,64,272,16,16,208,48,10002,0,0,0,0
25,64,272,16,16,224,48,10002,0,0,0,0
25,64,272,16,16,240,48,10002,0,0,0,0
25,64,272,16,16,256,48,10002,0,0,0,0
25,64,272,16,16,272,48,10002,0,0,0,0
25,64,272,16,16,288,48,10002,0,0,0,0
25,64,272,16,16,304,48,10002,0,0,0,0
25,64,272,16,16,320,48,10002,0,0,0,0
25,64,272,16,16,336,48,10002,0,0,0,0
25,64,272,16,16,352,48,10002,0,0,0,0
25,64,272,16,16,368,48,10002,0,0,0,0
25,64,272,16,16,384,48,10002,0,0,0,0
25,64,272,16,16,400,48,10002,0,0,0,0
25,64,272,16,16,416,48,10002,0,0,0,0
25,64,272,16,16,432,48,10002,0,0,0,0
25,64,272,16,16,448,48,10002,0,0,0,0
25,64,272,16,16,464,48,10002,0,0,0,0
25,64,272,16,16,480,48,10002,0,0,0,0
25,64,272,16,16,496,48,10002,0,0,0,0
25,64,272,16,16,512,48,10002,0,0,0,0
25,48,48,48,48,384,64,10002,0,0,0,0
25,48,48,48,48,336,64,10002,0,0,0,0
25,48,48,48,48,288,64,10002,0,0,0,0
25,48,48,48,48,240,64,10002,0,0,0,0
25,48,48,48,48,192,64,10002,0,0,0,0
25,48,48,48,48,144,64,10002,0,0,0,0
25,48,48,48,48,96,64,10002,0,0,0,0
25,48,48,48,48,48,64,10002,0,0,0,0
25,48,48,48,48,0,64,10002,0,0,0,0
25,48,48,48,48,0,112,10002,0,0,0,0
25,48,48,48,48,48,112,10002,0,0,0,0
25,48,48,48,48,96,112,10002,0,0,0,0
25,48,48,48,48,144,112,10002,0,0,0,0
25,48,48,48,48,192,112,10002,0,0,0,0
25,48,48,48,48,240,112,10002,0,0,0,0
25,48,48,48,48,288,112,10002,0,0,0,0
25,48,48,48,48,336,112,10002,0,0,0,0
25,48,48,48,48,384,112,10002,0,0,0,0
25,64,64,16,16,0,160,10002,0,0,0,0
25,64,64,16,16,16,160,10002,0,0,0,0
25,64,64,16,16,32,160,10002,0,0,0,0
25,64,64,16,16,48,160,10002,0,0,0,0
25,64,64,16,16,64,160,10002,0,0,0,0
25,64,64,16,16,80,160,10002,0,0,0,0
25,64,64,16,16,96,160,10002,0,0,0,0
25,64,64,16,16,112,160,10002,0,0,0,0
25,64,64,16,16,128,160,10002,0,0,0,0
25,64,64,16,16,144,160,10002,0,0,0,0
25,64,64,16,16,160,160,10002,0,0,0,0
25,64,64,16,16,176,160,10002,0,0,0,0
25,64,64,16,16,192,160,10002,0,0,0,0
25,64,64,16,16,208,160,10002,0,0,0,0
25,64,64,16,16,224,160,10002,0,0,0,0
25,64,64,16,16,240,160,10002,0,0,0,0
25,64,64,16,16,256,160,10002,0,0,0,0
25,64,64,16,16,272,160,10002,0,0,0,0
25,64,64,16,16,288,160,10002,0,0,0,0
25,64,64,16,16,304,160,10002,0,0,0,0
25,64,64,16,16,320,160,10002,0,0,0,0
25,64,64,16,16,336,160,10002,0,0,0,0
25,64,64,16,16,352,160,10002,0,0,0,0
25,64,64,16,16,368,160,10002,0,0,0,0
25,64,64,16,16,384,160,10002,0,0,0,0
25,64,64,16,16,400,160,10002,0,0,0,0
25,64,64,16,16,416,160,10002,0,0,0,0
35,288,240,16,16,368,224,10002,0,0,0,0
35,288,240,16,16,336,224,10002,0,0,0,0
35,288,240,16,16,304,224,10002,0,0,0,0
35,288,240,16,16,272,224,10002,0,0,0,0
35,288,240,16,16,240,224,10002,0,0,0,0
35,288,240,16,16,208,224,10002,0,0,0,0
35,288,240,16,16,176,224,10002,0,0,0,0
35,288,240,16,16,144,224,10002,0,0,0,0
35,288,240,16,16,112,224,10002,0,0,0,0
35,288,240,16,16,80,224,10002,0,0,0,0
35,352,240,16,16,48,224,10002,0,0,0,0
35,256,240,16,16,64,336,10002,0,0,0,0
35,256,240,16,16,160,336,10002,0,0,0,0
35,256,240,16,16,240,336,10002,0,0,0,0
35,256,240,16,16,320,336,10002,0,0,0,0
35,256,240,16,16,416,336,10002,0,0,0,0
39,80,48,176,144,448,224,10000,0,0,0,0
987654321

