VVh6UkxxBnkpcyF3YW1YA2MeKmJZQ20ONHxHGVAlf1liZml8NTghenh/cUNi
259,928,344,0,240,16,0,0,0,1,79,0
160,1936,352,0,0,16777215,0,0,0,1,89,0
158,24,352,0,1,16777215,0,1,0,1,2,0
178,945,175,0,112,16,0,0,0,0,64,0
178,992,128,0,16,80,0,0,0,0,51,0
178,896,128,0,16,80,0,0,0,0,60,0
178,945,81,0,112,16,0,0,0,0,56,0
100,256,296,0,256,16777215,0,271,0,1,8,0
100,208,296,0,256,16777215,0,271,0,1,7,0
100,152,296,0,256,16777215,0,271,0,1,6,0
100,96,296,0,256,16777215,0,271,0,1,5,0
100,48,296,0,256,16777215,0,271,0,1,4,0
197,1760,352,0,1,0,0,0,0,1,88,0
197,544,352,0,2,0,0,0,0,1,42,0
174,1080,352,0,1,64,51,60,56,0,66,1
174,1248,353,0,1,84,82,87,86,0,81,1
194,24,24,0,0,132,270,0,0,0,25,0
194,1392,184,0,0,128,0,0,0,0,86,0
194,1353,185,0,0,128,0,0,0,0,87,0
194,1328,184,0,0,128,0,0,0,0,84,0
167,944,128,0,308,270,0,0,0,1,43,0
185,464,144,0,0,16,1,0,0,1,18,0
185,464,344,0,0,16,1,0,0,1,17,0
185,376,248,0,0,16,1,0,0,1,16,0
185,448,248,0,0,16,1,0,0,1,15,0
185,368,344,0,0,16,1,0,0,1,14,0
185,376,144,0,0,16,1,0,0,1,13,0
185,416,200,0,0,64,1,0,0,1,12,0
185,416,304,0,0,64,1,0,0,1,10,0
242,608,232,0,16,32,0,0,0,1,80,0
176,304,168,0,25,48,48,0,0,1,37,0
157,1256,248,0,48,144,0,0,0,1,83,0
157,928,328,0,240,16,0,0,0,1,65,0
157,480,312,0,16,96,0,0,0,1,34,0
157,608,256,0,16,16,0,0,0,1,33,0
157,552,184,0,16,16,0,0,0,1,31,0
157,496,128,0,16,16,0,0,0,1,30,0
157,424,112,0,16,16,0,0,0,1,29,0
157,360,120,0,16,16,0,0,0,1,28,0
157,320,200,0,16,16,0,0,0,1,27,0
157,336,336,0,8,8,0,0,0,1,21,0
157,336,312,0,8,8,0,0,0,1,20,0
157,336,288,0,8,8,0,0,0,1,19,0
157,128,280,0,336,16,0,0,0,1,3,0
157,1000,360,0,2000,16,0,0,0,1,78,0
169,1264,320,0,0,0,0,0,0,1,82,1
237,320,0,0,16777215,300,0,0,0,1,24,0
166,464,256,0,0,0,0,0,0,1,32,1
1234567890
37,288,304,16,16,272,80,9998,0,0,0,0
37,288,304,16,16,272,64,9998,0,0,0,0
37,288,304,16,16,272,48,9998,0,0,0,0
37,288,304,16,16,272,16,9998,0,0,0,0
37,288,304,16,16,272,0,9998,0,0,0,0
37,288,304,16,16,288,0,9998,0,0,0,0
37,288,304,16,16,304,0,9998,0,0,0,0
37,288,304,16,16,320,0,9998,0,0,0,0
37,288,304,16,16,320,16,9998,0,0,0,0
37,288,304,16,16,320,32,9998,0,0,0,0
37,288,304,16,16,304,32,9998,0,0,0,0
37,288,304,16,16,288,32,9998,0,0,0,0
37,288,304,16,16,272,32,9998,0,0,0,0
37,288,304,16,16,336,80,9998,0,0,0,0
37,288,304,16,16,352,64,9998,0,0,0,0
37,288,304,16,16,352,48,9998,0,0,0,0
37,288,304,16,16,368,32,9998,0,0,0,0
37,288,304,16,16,368,16,9998,0,0,0,0
37,288,304,16,16,384,0,9998,0,0,0,0
37,288,304,16,16,400,16,9998,0,0,0,0
37,288,304,16,16,400,32,9998,0,0,0,0
37,288,304,16,16,416,48,9998,0,0,0,0
37,288,304,16,16,416,64,9998,0,0,0,0
37,288,304,16,16,432,80,9998,0,0,0,0
37,288,304,16,16,368,48,9998,0,0,0,0
37,288,304,16,16,384,48,9998,0,0,0,0
37,288,304,16,16,400,48,9998,0,0,0,0
37,288,304,16,16,480,80,9998,0,0,0,0
37,288,304,16,16,480,64,9998,0,0,0,0
37,288,304,16,16,480,48,9998,0,0,0,0
37,288,304,16,16,480,32,9998,0,0,0,0
37,288,304,16,16,480,16,9998,0,0,0,0
37,288,304,16,16,480,0,9998,0,0,0,0
37,288,304,16,16,496,0,9998,0,0,0,0
37,288,304,16,16,496,16,9998,0,0,0,0
37,288,304,16,16,496,32,9998,0,0,0,0
37,288,304,16,16,512,32,9998,0,0,0,0
37,288,304,16,16,512,48,9998,0,0,0,0
37,288,304,16,16,528,64,9998,0,0,0,0
37,288,304,16,16,528,48,9998,0,0,0,0
37,288,304,16,16,528,32,9998,0,0,0,0
37,288,304,16,16,528,16,9998,0,0,0,0
37,288,304,16,16,528,0,9998,0,0,0,0
37,288,304,16,16,528,80,9998,0,0,0,0
37,288,304,16,16,592,16,9998,0,0,0,0
37,288,304,16,16,592,32,9998,0,0,0,0
37,288,304,16,16,592,48,9998,0,0,0,0
37,288,304,16,16,592,64,9998,0,0,0,0
37,288,304,16,16,592,80,9998,0,0,0,0
37,288,304,16,16,560,0,9998,0,0,0,0
37,288,304,16,16,576,0,9998,0,0,0,0
37,288,304,16,16,592,0,9998,0,0,0,0
37,288,304,16,16,608,0,9998,0,0,0,0
37,288,304,16,16,624,0,9998,0,0,0,0
37,288,304,16,16,736,0,9998,0,0,0,0
37,288,304,16,16,720,0,9998,0,0,0,0
37,288,304,16,16,704,0,9998,0,0,0,0
37,288,304,16,16,688,0,9998,0,0,0,0
37,288,304,16,16,672,0,9998,0,0,0,0
37,288,304,16,16,656,0,9998,0,0,0,0
37,288,304,16,16,656,16,9998,0,0,0,0
37,288,304,16,16,672,32,9998,0,0,0,0
37,288,304,16,16,672,48,9998,0,0,0,0
37,288,304,16,16,688,48,9998,0,0,0,0
37,288,304,16,16,704,48,9998,0,0,0,0
37,288,304,16,16,720,48,9998,0,0,0,0
37,288,304,16,16,736,48,9998,0,0,0,0
37,288,304,16,16,736,64,9998,0,0,0,0
37,288,304,16,16,736,80,9998,0,0,0,0
37,288,304,16,16,736,96,9998,0,0,0,0
37,288,304,16,16,720,96,9998,0,0,0,0
37,288,304,16,16,720,112,9998,0,0,0,0
37,288,304,16,16,704,112,9998,0,0,0,0
37,288,304,16,16,688,112,9998,0,0,0,0
37,288,304,16,16,672,112,9998,0,0,0,0
37,288,304,16,16,656,112,9998,0,0,0,0
37,288,304,16,16,656,96,9998,0,0,0,0
25,0,16,16,16,1232,304,10002,0,0,0,0
25,0,16,16,16,1248,304,10002,0,0,0,0
25,0,16,16,16,1264,304,10002,0,0,0,0
25,0,16,16,16,1264,288,10002,0,0,0,0
25,0,16,16,16,1248,288,10002,0,0,0,0
25,0,16,16,16,1232,288,10002,0,0,0,0
25,0,16,16,16,1232,272,10002,0,0,0,0
25,0,16,16,16,1248,272,10002,0,0,0,0
25,0,16,16,16,1264,272,10002,0,0,0,0
25,0,16,16,16,1264,256,10002,0,0,0,0
25,0,16,16,16,1248,256,10002,0,0,0,0
25,0,16,16,16,1248,240,10002,0,0,0,0
25,0,16,16,16,1248,224,10002,0,0,0,0
25,0,16,16,16,1232,224,10002,0,0,0,0
25,0,16,16,16,1232,208,10002,0,0,0,0
25,0,16,16,16,1248,208,10002,0,0,0,0
25,0,16,16,16,1248,192,10002,0,0,0,0
25,0,16,16,16,1264,192,10002,0,0,0,0
25,0,16,16,16,1264,176,10002,0,0,0,0
25,0,16,16,16,1248,176,10002,0,0,0,0
987654321
MwAjEUAuVT9gJy1HIAtGM1ooO1dIXjVDCnw5WHwkeFULBQxwVlxeAwQXYQ==
NyQLO0ALZGlnLm5PJlhIel04O1FdXjFVHHZ4FVt/

