VVh6UkxwAHk1ZzUCChlrL20bSQl0CW0fVUZ/GVI9aRs1Lyt8NTghenh/cUNiVSc2HA==
259,712,912,0,16,16,0,0,0,1,178,0
259,472,1256,0,48,16,0,0,0,1,116,0
259,448,1280,0,288,32,0,0,0,1,115,0
259,728,928,0,16,16,0,0,0,1,194,0
160,112,1464,0,0,16777215,0,0,0,1,236,0
158,48,1968,0,1,16777215,0,1,0,1,6,0
100,408,1040,0,344,16777215,0,269,0,1,122,0
178,464,888,0,96,16,0,0,0,0,166,0
178,408,840,0,24,8,0,0,0,0,159,0
100,504,1040,0,344,16777215,0,269,0,0,123,0
197,112,1400,0,2,228,0,0,0,1,231,0
197,120,832,0,1,207,0,0,0,1,204,0
174,352,1480,0,1,248,0,0,0,0,249,1
174,376,1480,0,1,98,0,0,0,0,87,1
174,336,1120,0,1,122,123,0,0,0,126,1
174,79,1192,0,1,225,0,0,0,0,217,1
174,72,976,0,1,210,0,0,0,0,209,1
174,456,1120,0,1,122,123,0,0,0,127,1
174,409,872,0,1,159,160,0,0,0,152,1
174,512,872,0,1,160,159,0,0,0,153,1
174,328,1480,0,1,89,0,0,0,0,88,1
205,432,1480,0,1,0,0.50,0,0,0,89,0
189,408,1040,0,0,152,270,0,0,1,125,0
308,136,1576,0,0,200,270,0,0,1,60,0
308,264,1576,0,0,200,270,0,0,1,62,0
189,504,1040,0,0,152,270,0,0,1,124,0
308,200,1576,0,0,200,270,0,0,1,61,0
186,264,1720,0,0,0,0,0,0,1,24,0
219,288,1792,0,16,112,0,0,0,1,28,1
188,416,1384,0,0,106,0,0,0,1,101,0
188,144,1848,0,0,22,23,0,0,1,19,0
188,184,1848,0,0,26,0,0,0,1,20,0
188,224,1848,0,0,22,23,0,0,1,21,0
188,264,1848,0,0,28,0,0,0,1,27,0
185,856,928,0,0,64,1,0,0,1,192,0
185,120,1952,0,0,16,1,0,0,1,7,0
185,184,1928,0,0,16,1,0,0,1,8,0
185,248,1952,0,0,16,1,0,0,1,9,0
242,80,1216,0,48,16,0,0,0,1,235,0
242,288,952,0,32,48,0,0,0,1,234,0
242,328,1096,0,32,48,0,0,0,1,233,0
242,328,1224,0,32,48,0,0,0,1,232,0
242,320,1456,0,32,48,0,0,0,1,83,0
242,80,1616,0,32,64,0,0,0,1,70,0
242,72,1808,0,32,80,0,0,0,1,53,0
242,616,1936,0,32,48,0,0,0,1,52,0
176,456,840,0,147,272,80,0,0,1,141,0
176,472,1264,0,119,48,16,0,0,1,118,0
176,464,880,0,166,80,16,0,0,1,167,0
176,72,952,0,211,32,48,0,0,1,221,0
210,384,1408,0,109,90,0,0,0,1,108,0
216,504,1440,0,-1,0,0,192,MXN0IHN3aXRjaD1yb2JvdCMybmQgc3dpdGNoPXBvcnRhbCBkb29yIzNyZCBzd2l0Y2g9ZG9vcg==,1,97,0
154,336,816,0,2,0.50,16,16,-1,1,150,1
154,8,1104,0,3,0.50,16,16,-1,1,213,1
216,72,856,0,5,0,0,96,PFRFWFQ+,0,207,0
210,328,1648,0,82,0,0,0,0,1,67,0
210,552,1480,0,247,0,0,0,0,1,246,0
210,552,1384,0,0,0,0,0,0,1,247,0
210,576,1120,0,0,0,0,0,0,1,128,0
210,648,1896,0,0,0,0,0,0,1,50,0
216,688,1872,0,30,0,0,96,PFRFWFQ+,1,49,0
216,704,1936,0,31,0,0,96,PFRFWFQ+,1,47,0
216,648,1936,0,30,0,0,96,PFRFWFQ+,1,46,0
216,472,1192,0,20,0,0,96,PFRFWFQ+,0,119,0
210,328,928,0,0,0,0,0,0,1,137,0
210,312,792,0,0,0,0,0,0,1,170,0
210,320,1120,0,0,0,0,0,0,1,121,0
210,576,1248,0,121,0,0,0,0,1,120,0
210,64,1848,0,0,0,0,0,0,1,18,0
210,72,1648,0,0,0,0,0,0,1,66,0
210,704,1912,0,51,180,0,0,0,1,45,0
210,320,1848,0,43,0,0,0,0,1,29,0
210,288,1968,0,18,0,0,0,0,1,10,0
210,320,1248,0,0,0,0,0,0,1,109,0
210,648,1912,0,50,180,0,0,0,1,44,0
210,312,1480,0,0,0,0,0,0,1,82,0
210,616,1960,0,0,0,0,0,0,1,43,0
216,680,1808,0,31,0,0,96,PFRFWFQ+,1,48,0
210,648,1833,0,0,0,0,0,0,1,51,0
210,904,1960,0,66,0,0,0,0,1,65,0
210,616,976,0,0,0,0,0,0,1,201,0
210,736,1304,0,201,0,0,0,0,1,197,0
210,752,1304,0,201,0,0,0,0,1,199,0
210,768,1304,0,201,0,0,0,0,1,198,0
210,784,1304,0,201,0,0,0,0,1,200,0
210,320,856,0,170,270,0,0,0,1,169,0
157,112,1408,0,192,16,0,0,0,1,228,0
157,152,1448,0,16,64,0,0,0,1,239,0
157,72,1448,0,16,64,0,0,0,1,238,0
157,112,1472,0,64,16,0,0,0,1,237,0
157,208,1368,0,16,96,0,0,0,1,229,0
157,17,1368,0,16,96,0,0,0,1,230,0
157,80,1200,0,48,16,0,0,0,1,225,0
157,184,904,0,16,16,0,0,0,1,190,0
157,216,936,0,16,16,0,0,0,1,189,0
157,280,984,0,32,16,0,0,0,1,188,0
157,664,936,0,144,8,0,0,0,1,187,0
157,656,984,0,128,16,0,0,0,1,182,0
157,768,976,0,16,16,0,0,0,1,181,0
157,696,896,0,16,16,0,0,0,1,179,0
157,680,880,0,16,16,0,0,0,1,175,0
157,664,864,0,16,16,0,0,0,1,174,0
157,648,848,0,16,16,0,0,0,1,173,0
157,632,832,0,16,16,0,0,0,1,172,0
157,616,816,0,16,16,0,0,0,1,171,0
157,360,872,0,80,16,0,0,0,1,168,0
157,536,896,0,16,16,0,0,0,1,161,0
157,512,840,0,24,8,0,0,0,1,160,0
157,336,832,0,8,8,0,0,0,1,155,0
157,408,880,0,24,8,0,0,0,1,143,0
157,512,880,0,24,8,0,0,0,1,139,0
157,560,912,0,24,8,0,0,0,1,138,0
157,312,872,0,16,128,0,0,0,1,132,0
157,456,944,0,304,24,0,0,0,1,131,0
157,456,800,0,304,16,0,0,0,1,130,0
157,600,872,0,16,128,0,0,0,1,129,0
157,544,1256,0,96,16,0,0,0,1,114,0
157,592,1280,0,16,32,0,0,0,1,112,0
157,304,1280,0,16,32,0,0,0,1,111,0
157,376,1424,0,16,16,0,0,0,1,107,0
157,344,1424,0,80,16,0,0,0,1,106,0
157,616,1392,0,16,16,0,0,0,1,96,0
157,480,1392,0,160,16,0,0,1,1,95,0
157,392,1416,0,16,128,0,0,0,1,84,0
157,448,1128,0,304,16,0,0,0,1,81,0
157,592,1056,0,16,128,0,0,0,1,80,0
157,304,1056,0,16,128,0,0,0,1,79,0
157,447,984,0,304,16,0,0,0,1,78,0
157,304,1200,0,16,128,0,0,0,1,77,0
157,592,1200,0,16,128,0,0,0,1,76,0
157,448,1144,0,304,16,0,0,0,1,75,0
157,376,1256,0,160,16,0,0,0,1,74,0
157,616,1416,0,16,128,0,0,1,1,73,0
157,80,1656,0,32,16,0,0,0,1,72,0
157,296,1416,0,16,128,0,0,0,1,71,0
157,456,1344,0,336,16,0,0,0,1,69,0
157,432,1488,0,288,16,0,0,1,1,68,0
157,344,1656,0,16,16,0,0,0,1,64,0
157,56,1656,0,16,16,0,0,0,1,63,0
157,344,1592,0,16,112,0,0,0,1,57,0
157,56,1592,0,16,112,0,0,0,1,56,0
157,216,1656,0,240,16,0,1,0,1,55,1
157,200,1528,0,320,16,0,0,0,1,54,0
157,160,1976,0,304,16,0,0,0,1,2,0
157,160,1872,0,304,16,0,0,0,1,3,0
157,304,1928,0,16,112,0,0,0,1,4,0
157,16,1920,0,16,112,0,0,0,1,5,0
157,312,1728,0,64,16,0,0,0,1,14,0
157,336,1800,0,16,128,0,0,0,1,15,0
157,192,1856,0,304,16,0,0,0,1,16,0
157,48,1792,0,16,112,0,0,0,1,17,0
157,144,1728,0,208,16,0,0,0,1,25,0
157,592,1864,0,16,192,0,0,0,1,30,0
157,928,1864,0,16,192,0,0,0,1,31,0
157,760,1968,0,352,16,0,0,0,1,32,0
157,760,1768,0,352,16,0,0,0,1,33,0
157,680,1840,0,160,16,0,0,0,1,34,0
157,672,1904,0,160,16,0,0,0,1,35,0
157,760,1312,0,64,16,0,0,0,1,196,0
157,152,872,0,16,16,0,0,0,1,202,0
157,120,840,0,16,16,0,0,0,1,203,0
169,528,1448,0,0,0,0,0,0,1,248,1
169,432,1352,0,0,0,0,0,0,1,98,1
172,248,1720,0,0,0,0,0,0,1,26,1
172,56,976,0,0,0,0,0,0,1,210,1
301,752,1848,0,0,0,269,0,0,1,36,1
301,752,1920,0,0,0,269,42,0,1,37,1
301,752,1776,0,0,0,269,40,0,1,38,1
237,320,0,0,32906,300,0,0,0,1,133,0
166,216,1200,0,0,0,90,0,0,1,220,1
166,24,1200,0,0,0,90,0,0,1,219,1
166,112,856,0,0,0,315,0,0,1,191,1
166,336,816,0,150,0,270,0,0,1,147,1
166,352,912,0,0,0,0,0,0,1,134,1
166,312,1272,0,0,0,0,0,0,1,113,1
166,56,1824,0,0,0,0,0,0,0,22,1
166,56,1840,0,0,0,0,0,0,0,23,1
166,600,1880,0,0,0,0,0,0,0,39,1
166,600,1808,0,0,0,0,0,0,0,40,1
166,600,1944,0,0,0,0,0,0,0,42,1
166,664,888,0,0,0,323,0,0,1,195,1
166,8,1104,0,213,0,90,0,0,1,215,1
155,584,816,0,2,2,0,0,0,1,149,0
155,336,816,0,1,2,0,0,0,0,148,0
155,8,1104,0,1,3,0,0,0,0,211,0
155,208,1104,0,2,3,0,0,0,1,212,0
1234567890
25,16,16,16,16,48,1520,10002,0,0,0,0
25,16,16,16,16,64,1520,10002,0,0,0,0
25,16,16,16,16,80,1520,10002,0,0,0,0
25,16,16,16,16,96,1520,10002,0,0,0,0
25,16,16,16,16,112,1520,10002,0,0,0,0
25,16,16,16,16,128,1520,10002,0,0,0,0
25,16,16,16,16,144,1520,10002,0,0,0,0
25,16,16,16,16,160,1520,10002,0,0,0,0
25,16,16,16,16,176,1520,10002,0,0,0,0
25,16,16,16,16,192,1520,10002,0,0,0,0
25,16,16,16,16,208,1520,10002,0,0,0,0
25,16,16,16,16,224,1520,10002,0,0,0,0
25,16,16,16,16,240,1520,10002,0,0,0,0
25,16,16,16,16,256,1520,10002,0,0,0,0
25,16,16,16,16,272,1520,10002,0,0,0,0
25,0,16,16,16,0,0,10002,0,0,0,0
25,0,16,16,16,0,16,10002,0,0,0,0
25,0,16,16,16,64,32,10002,0,0,0,0
25,0,16,16,16,96,32,10002,0,0,0,0
25,0,16,16,16,144,16,10002,0,0,0,0
25,0,16,16,16,160,16,10002,0,0,0,0
25,0,16,16,16,192,16,10002,0,0,0,0
25,0,16,16,16,240,0,10002,0,0,0,0
25,0,16,16,16,256,0,10002,0,0,0,0
25,0,16,16,16,288,0,10002,0,0,0,0
25,0,16,16,16,304,0,10002,0,0,0,0
25,0,16,16,16,336,0,10002,0,0,0,0
25,0,16,16,16,320,0,10002,0,0,0,0
25,0,16,16,16,288,16,10002,0,0,0,0
25,0,16,16,16,256,32,10002,0,0,0,0
25,0,16,16,16,208,48,10002,0,0,0,0
25,0,16,16,16,176,64,10002,0,0,0,0
25,0,16,16,16,176,80,10002,0,0,0,0
25,0,16,16,16,160,96,10002,0,0,0,0
25,0,16,16,16,176,112,10002,0,0,0,0
25,0,16,16,16,192,128,10002,0,0,0,0
25,0,16,16,16,368,144,10002,0,0,0,0
25,0,16,16,16,464,64,10002,0,0,0,0
25,0,16,16,16,480,32,10002,0,0,0,0
25,0,16,16,16,496,0,10002,0,0,0,0
25,0,16,16,16,480,0,10002,0,0,0,0
25,0,16,16,16,464,0,10002,0,0,0,0
25,0,16,16,16,448,0,10002,0,0,0,0
25,0,16,16,16,432,16,10002,0,0,0,0
25,0,16,16,16,432,32,10002,0,0,0,0
25,0,16,16,16,432,48,10002,0,0,0,0
25,0,16,16,16,432,64,10002,0,0,0,0
25,0,16,16,16,448,64,10002,0,0,0,0
25,0,16,16,16,464,80,10002,0,0,0,0
25,0,16,16,16,480,80,10002,0,0,0,0
25,0,16,16,16,528,64,10002,0,0,0,0
25,0,16,16,16,528,48,10002,0,0,0,0
25,0,16,16,16,544,32,10002,0,0,0,0
25,0,16,16,16,560,16,10002,0,0,0,0
25,0,16,16,16,592,0,10002,0,0,0,0
25,0,16,16,16,576,0,10002,0,0,0,0
25,0,16,16,16,560,0,10002,0,0,0,0
25,0,16,16,16,544,0,10002,0,0,0,0
25,0,16,16,16,528,32,10002,0,0,0,0
25,0,16,16,16,512,48,10002,0,0,0,0
25,0,16,16,16,496,80,10002,0,0,0,0
25,0,16,16,16,480,112,10002,0,0,0,0
25,0,16,16,16,480,128,10002,0,0,0,0
25,0,16,16,16,480,160,10002,0,0,0,0
25,0,16,16,16,496,192,10002,0,0,0,0
25,0,16,16,16,512,208,10002,0,0,0,0
25,0,16,16,16,544,208,10002,0,0,0,0
25,0,16,16,16,560,208,10002,0,0,0,0
25,0,16,16,16,592,208,10002,0,0,0,0
25,0,16,16,16,624,192,10002,0,0,0,0
25,0,16,16,16,624,176,10002,0,0,0,0
25,0,16,16,16,624,160,10002,0,0,0,0
25,0,16,16,16,624,144,10002,0,0,0,0
25,0,16,16,16,624,128,10002,0,0,0,0
25,0,16,16,16,624,112,10002,0,0,0,0
25,0,16,16,16,624,96,10002,0,0,0,0
25,0,16,16,16,608,80,10002,0,0,0,0
25,0,16,16,16,592,80,10002,0,0,0,0
25,0,16,16,16,576,80,10002,0,0,0,0
25,0,16,16,16,560,80,10002,0,0,0,0
25,0,16,16,16,528,80,10002,0,0,0,0
25,0,16,16,16,512,80,10002,0,0,0,0
25,0,16,16,16,480,96,10002,0,0,0,0
25,0,16,16,16,416,112,10002,0,0,0,0
25,0,16,16,16,400,112,10002,0,0,0,0
25,0,16,16,16,368,128,10002,0,0,0,0
25,0,16,16,16,208,112,10002,0,0,0,0
25,0,16,16,16,224,112,10002,0,0,0,0
25,0,16,16,16,224,96,10002,0,0,0,0
25,0,16,16,16,240,96,10002,0,0,0,0
25,0,16,16,16,256,96,10002,0,0,0,0
25,0,16,16,16,288,96,10002,0,0,0,0
25,0,16,16,16,304,96,10002,0,0,0,0
25,0,16,16,16,320,96,10002,0,0,0,0
25,0,16,16,16,336,96,10002,0,0,0,0
25,0,16,16,16,336,112,10002,0,0,0,0
25,0,16,16,16,336,128,10002,0,0,0,0
25,0,16,16,16,320,144,10002,0,0,0,0
25,0,16,16,16,304,144,10002,0,0,0,0
25,0,16,16,16,288,144,10002,0,0,0,0
25,0,16,16,16,272,144,10002,0,0,0,0
25,0,16,16,16,256,144,10002,0,0,0,0
25,0,16,16,16,240,144,10002,0,0,0,0
25,0,16,16,16,224,144,10002,0,0,0,0
25,0,16,16,16,224,128,10002,0,0,0,0
25,0,16,16,16,208,128,10002,0,0,0,0
25,16,16,16,16,304,464,10002,0,0,0,0
25,16,16,16,16,384,480,10002,0,0,0,0
25,16,16,16,16,448,480,10002,0,0,0,0
25,16,16,16,16,432,480,10002,0,0,0,0
25,16,16,16,16,384,464,10002,0,0,0,0
25,16,16,16,16,304,448,10002,0,0,0,0
25,16,16,16,16,176,448,10002,0,0,0,0
25,16,16,16,16,224,448,10002,0,0,0,0
25,16,16,16,16,384,448,10002,0,0,0,0
25,16,16,16,16,432,448,10002,0,0,0,0
25,16,16,16,16,480,448,10002,0,0,0,0
25,16,16,16,16,464,448,10002,0,0,0,0
25,16,16,16,16,400,448,10002,0,0,0,0
25,16,16,16,16,336,448,10002,0,0,0,0
25,16,16,16,16,272,448,10002,0,0,0,0
25,16,16,16,16,192,448,10002,0,0,0,0
25,16,16,16,16,128,448,10002,0,0,0,0
25,16,16,16,16,112,448,10002,0,0,0,0
25,16,16,16,16,144,448,10002,0,0,0,0
25,16,16,16,16,160,448,10002,0,0,0,0
25,16,16,16,16,208,448,10002,0,0,0,0
25,16,16,16,16,320,464,10002,0,0,0,0
25,16,16,16,16,352,464,10002,0,0,0,0
987654321
MwAjEUAuVT9gJy1HIAtGM1ooO1dIXjVDCnw5WHwkeFULBQxwVlxeAwQXYQ==
NyQLO0ALZGlnLm5PJlhIel04O1FdXjFVHHZ4FVt/

