UVx6TlN0AGU9Z1xDK0NIN2I7en9WCDVPP3xNOQNsIDQxIjA1c3F8MyYnbV9+STsqAHQ4J0Mqcic=
160,328,200,0,0,16777215,0,0,0,1,3,0
158,280,200,0,1,16777215,0,1,0,1,2,0
123,296,120,0,128,16777215,0,0,0,1,6,0
197,368,200,0,2,0,0,0,0,1,24,0
381,232,200,0,0,0,0,0,0,1,8,1
189,56,144,0,0,128,0,0,0,1,23,0
167,312,296,0,128,270,0,0,0,1,26,0
186,448,152,0,0,0,0,0,0,1,25,0
185,296,92,0,0,32,1,0,0,1,9,0
179,240,136,0,0,32,32,0,0,1,22,0
157,512,144,0,32,32,0,0,0,1,21,0
157,496,160,0,32,32,0,0,0,1,20,0
157,472,168,0,32,32,0,0,0,1,19,0
157,448,168,0,32,32,0,0,0,1,18,0
157,424,168,0,32,32,0,0,0,1,17,0
157,408,160,0,32,32,0,0,0,1,16,0
157,392,152,0,32,32,0,0,0,1,15,0
157,496,88,0,32,32,0,0,0,1,14,0
157,408,88,0,32,32,0,0,0,1,13,0
157,360,216,0,32,32,0,0,0,1,12,0
157,328,216,0,32,32,0,0,0,1,11,0
157,264,216,0,32,32,0,0,0,1,10,0
157,296,216,0,32,32,0,0,0,1,5,0
166,160,88,0,0,0,0,0,0,1,7,1
1234567890
24,0,320,208,32,144,288,9998,0,0,0,0
24,0,320,208,32,192,128,9998,0,0,0,0
24,0,320,208,32,208,64,9998,0,0,0,0
24,0,320,208,32,160,160,9998,0,0,0,0
24,0,320,208,32,0,192,9998,0,0,0,0
24,0,320,208,32,416,80,9998,0,0,0,0
24,0,320,208,32,448,176,9998,0,0,0,0
24,0,320,208,32,400,208,9998,0,0,0,0
24,0,320,208,32,384,304,9998,0,0,0,0
24,0,320,208,32,256,240,9998,0,0,0,0
24,0,320,208,32,48,256,9998,0,0,0,0
24,0,320,208,32,512,272,9998,0,0,0,0
25,0,0,624,352,16,16,10002,0,0,0,0
37,160,32,112,48,400,192,10000,0,0,0,0
37,160,32,112,48,512,192,10000,0,0,0,0
37,160,32,112,48,512,144,10000,0,0,0,0
37,160,32,112,48,352,112,10000,0,0,0,0
37,160,32,112,48,208,208,10000,0,0,0,0
37,160,32,112,48,224,96,10000,0,0,0,0
37,160,32,112,48,224,32,10000,0,0,0,0
37,160,32,112,48,112,16,10000,0,0,0,0
37,160,32,112,48,400,32,10000,0,0,0,0
37,160,32,112,48,0,240,10000,0,0,0,0
37,160,32,112,48,0,192,10000,0,0,0,0
37,160,32,112,48,0,288,10000,0,0,0,0
37,160,32,112,48,0,144,10000,0,0,0,0
37,160,32,112,48,0,96,10000,0,0,0,0
37,160,32,112,48,0,48,10000,0,0,0,0
987654321
Pgc/QhMqXzxpL2MJJwtFO0IpO1lAXjFBEWxyDls8aRsmaj8/dw==
BBovAxQrXi4lKi1CNl1INhpsWFlbDTUCDW1yWEsiaQdyJjwmYHhidj86LQM=
BQ1qBAkuXCxha3pHJ0MNNFsiaF1ADTUCFWx8HR4lZBwhZA==

