X1t4TlN0AGU9Z15DakRPMH42N1VXTyNWVTU7SBJhIEV+enVgKSQ=
259,200,224,0,32,32,0,0,0,1,215,0
259,200,192,0,32,32,0,0,0,1,216,0
259,656,176,0,64,128,0,0,0,1,313,0
259,8,32,0,32,32,0,0,0,1,359,0
160,648,80,0,0,16777215,0,0,0,1,8,0
195,192,96,0,0,160,344,0,152,1,153,0
195,192,96,0,0,160,344,0,97,1,148,0
195,192,96,0,0,160,344,0,136,1,147,0
195,192,96,0,0,160,344,0,140,1,96,0
311,296,112,1,128,64,16777215,0,0,0,69,0
100,400,40,0,256,16777215,0,270,0,1,266,0
100,456,40,0,256,16777215,0,270,0,1,349,0
100,648,128,0,256,16777215,0,270,0,1,303,0
123,88,128,0,128,16777215,0,0,0,0,277,0
197,152,176,0,2,301,0,0,0,1,10,0
197,656,240,0,2,210,0,0,0,1,302,0
197,152,80,0,2,325,0,0,0,1,9,0
174,440,80,0,1,182,64,72,14,0,61,0
193,8,40,1,1,111,277,0,0,1,120,0
174,304,240,0,1,49,47,173,0,0,51,1
205,488.50,88,0,1,0,0.50,0,0,1,60,0
205,305.50,144,0,1,0,0.50,0,0,1,327,0
186,336,240,0,32,32,0,0,0,1,46,0
186,272,64,0,32,32,0,0,0,1,113,0
188,448,304,0,0,41,0,0,0,1,45,0
188,144,240,0,0,0,120,0,0,1,100,0
154,208,88,0,1,3,96,32,-1,0,140,1
210,680,296,0,166,90,0,0,0,1,163,0
210,680,280,0,165,90,0,0,0,1,164,0
210,680,56,0,0,90,0,0,0,1,214,0
210,680,72,0,0,90,0,0,0,1,213,0
210,280,0,0,0,180,0,0,0,1,110,0
210,376,32,0,0,180,0,0,0,1,166,0
210,184,232,0,213,270,0,0,0,1,211,0
210,264,0,0,0,180,0,0,0,1,109,0
210,264,167,0,109,0,0,0,0,1,107,0
210,360,32,0,0,180,0,0,0,1,165,0
210,184,216,0,214,270,0,0,0,1,212,0
210,280,167,0,110,0,0,0,0,1,108,0
157,264,256,0,32,32,0,0,0,1,3,0
157,296,256,0,32,32,0,0,0,1,4,0
157,328,256,0,32,32,0,0,0,1,5,0
157,360,256,0,32,32,0,0,0,1,6,0
157,232,256,0,32,32,0,0,0,1,7,0
157,200,256,0,32,32,0,0,0,1,11,0
157,168,256,0,32,32,0,0,0,1,12,0
157,168,224,0,32,32,0,0,0,1,15,0
157,168,192,0,32,32,0,0,0,1,16,0
157,392,256,0,32,32,0,0,0,1,18,0
157,184,160,0,32,32,0,0,0,1,19,0
157,184,128,0,32,32,0,0,0,1,20,0
157,184,96,0,32,32,0,0,0,1,21,0
157,232,320,0,320,32,0,0,0,1,33,0
157,512,256,0,32,32,0,0,0,1,37,0
157,544,256,0,32,32,0,0,0,1,38,0
157,576,256,0,32,32,0,0,0,1,39,0
157,608,256,0,32,32,0,0,0,1,40,0
157,224,160,0,64,32,0,0,0,1,52,0
157,272,172,0,32,8,0,0,0,1,53,0
157,312,160,0,48,32,0,0,0,1,55,0
157,344,160,0,32,32,0,0,0,1,56,0
157,376,160,0,32,32,0,0,0,1,57,0
157,408,160,0,32,32,0,0,0,1,58,0
157,440,160,0,32,32,0,0,0,1,59,0
157,552,320,0,320,32,0,0,0,1,81,0
157,96,32,0,176,32,0,0,0,1,127,0
157,336,96,0,32,32,0,0,0,1,150,0
157,336,64,0,32,32,0,0,0,1,151,0
157,336,48,0,32,32,0,0,0,1,161,0
157,640,96,0,96,32,0,0,0,1,191,0
157,608,144,0,32,64,0,0,0,1,297,0
157,480,160,0,48,32,0,0,0,1,298,0
157,608,64,0,32,64,0,0,0,1,299,0
157,608,192,0,32,64,0,0,0,1,300,0
157,440,96,0,32,32,0,0,0,1,348,0
157,640,176,0,96,128,0,0,0,1,301,0
157,224,208,0,32,64,0,0,0,1,210,0
157,56,184,0,32,32,0,0,0,1,72,0
157,56,216,0,32,32,0,0,0,1,14,0
157,152,96,0,32,32,0,0,0,1,22,0
157,136,256,0,32,32,0,0,0,1,13,0
157,136,192,0,32,32,0,0,0,1,17,0
157,120,96,0,32,32,0,0,0,1,23,0
157,88,96,0,32,32,0,0,0,1,24,0
157,56,96,0,32,32,0,0,0,1,25,0
157,56,128,0,32,32,0,0,0,1,26,0
157,56,144,0,32,32,0,0,0,1,27,0
157,56,200,0,32,8,0,0,0,1,28,0
157,56,240,0,32,32,0,0,0,1,29,0
157,56,256,0,32,32,0,0,0,1,30,0
157,56,152,0,32,32,0,0,0,1,87,0
157,48,216,0,32,32,0,0,0,1,93,0
157,48,184,0,32,32,0,0,0,1,94,0
157,56,288,0,32,32,0,0,0,1,31,0
157,56,320,0,32,32,0,0,0,1,32,0
157,504,16,0,368,32,0,0,0,1,149,0
157,656,256,0,80,32,0,0,0,1,162,0
157,696,144,0,32,320,0,0,0,1,160,0
169,224,272,0,0,0,0,0,0,1,41,1
172,464,240,0,1,0,0,0,0,1,47,0
172,408,240,0,0,0,0,0,0,1,49,0
172,256,144,0,0,0,0,0,0,0,62,0
172,96,176,0,1,0,0,0,0,1,64,1
169,184,48,0,1,0,0,0,0,0,97,1
172,256,64,0,0,0,0,0,0,1,111,1
155,208,88,0,1,1,0,0,0,1,138,0
155,312,88,0,2,1,0,0,0,1,139,0
169,320,112,0,1,0,0,0,0,0,152,1
172,440,240,0,1,0,0,0,0,1,173,0
172,64,176,0,1,0,0,0,0,1,182,1
169,336,112,0,1,0,0,0,0,1,254,1
172,456,82,0,0,0,0,0,0,1,325,0
301,584,128,0,0,0,180,69,0,1,217,0
301,584,128,0,0,0,180,254,0,1,276,0
301,584,128,0,0,0,180,62,0,1,338,0
166,208,88,0,140,0,270,0,0,0,136,1
158,272,240,0,1,16777215,0,1,0,1,2,0
1234567890
25,272,176,176,64,64,240,10002,0,0,0,0
25,272,176,176,64,256,240,10002,0,0,0,0
25,272,176,176,64,432,240,10002,0,0,0,0
25,272,176,176,64,432,176,10002,0,0,0,0
25,272,176,176,64,224,96,10002,0,0,0,0
25,272,176,176,64,48,96,10002,0,0,0,0
25,272,176,176,64,48,176,10002,0,0,0,0
25,272,176,176,64,-32,336,10002,0,0,0,0
25,272,176,176,64,144,336,10002,0,0,0,0
25,272,176,176,64,320,336,10002,0,0,0,0
25,272,176,176,64,496,336,10002,0,0,0,0
25,400,96,64,48,0,0,10002,0,0,0,0
25,400,96,64,48,64,0,10002,0,0,0,0
25,400,96,64,48,128,0,10002,0,0,0,0
25,400,96,64,48,192,0,10002,0,0,0,0
25,400,96,64,48,256,0,10002,0,0,0,0
25,400,96,64,48,320,0,10002,0,0,0,0
25,400,96,64,48,384,0,10002,0,0,0,0
25,400,96,64,48,448,0,10002,0,0,0,0
38,0,160,208,160,496,80,9998,0,0,0,0
38,96,0,192,160,304,80,9998,0,0,0,0
38,96,0,192,160,112,80,9998,0,0,0,0
38,96,0,192,160,0,272,9998,0,0,0,0
38,96,0,192,160,192,272,9998,0,0,0,0
38,96,0,192,160,384,240,9998,0,0,0,0
38,96,0,192,160,576,272,9998,0,0,0,0
37,16,144,32,32,0,48,10000,0,0,0,0
37,16,144,32,32,0,80,10000,0,0,0,0
37,16,144,32,32,0,112,10000,0,0,0,0
37,16,144,32,32,0,144,10000,0,0,0,0
37,16,144,32,32,0,176,10000,0,0,0,0
37,16,144,32,32,0,208,10000,0,0,0,0
37,16,144,32,32,0,240,10000,0,0,0,0
37,16,144,32,32,32,240,10000,0,0,0,0
37,16,144,32,32,64,240,10000,0,0,0,0
37,16,144,32,32,96,240,10000,0,0,0,0
37,16,144,32,32,80,208,10000,0,0,0,0
37,16,144,32,32,48,208,10000,0,0,0,0
37,16,144,32,32,80,176,10000,0,0,0,0
37,16,144,32,32,48,176,10000,0,0,0,0
37,16,144,32,32,160,48,10000,0,0,0,0
37,16,144,32,32,128,48,10000,0,0,0,0
37,16,144,32,32,96,48,10000,0,0,0,0
37,16,144,32,32,64,48,10000,0,0,0,0
37,16,144,32,32,32,48,10000,0,0,0,0
37,16,144,32,32,32,80,10000,0,0,0,0
37,16,144,32,32,32,112,10000,0,0,0,0
37,16,144,32,32,32,144,10000,0,0,0,0
37,16,144,32,32,64,144,10000,0,0,0,0
37,16,144,32,32,64,112,10000,0,0,0,0
37,144,176,96,96,384,0,10000,0,0,0,0
37,0,272,80,32,480,80,10000,0,0,0,0
37,0,272,80,32,560,80,10000,0,0,0,0
987654321

