UVx6TlN0AGU9Z1x5ZhtMD0w8QVV7Q3xDGm1+DhJhIEV+enVgKSQ9ZmRj
259,224,128,0,32,32,0,0,0,1,53,0
158,336,144,0,1,16777215,0,1,0,1,42,0
160,344,232,0,0,16777215,0,0,0,1,2,0
123,384,192,0,128,16777215,0,0,0,1,54,0
181,488,120,0,0,128,0,0,0,1,41,0
185,120,56,0,0,32,1,0,0,1,51,0
157,224,64,0,32,32,0,0,0,1,50,0
157,192,64,0,32,32,0,0,0,1,49,0
157,224,96,0,32,32,0,0,0,1,48,0
157,128,128,0,32,32,0,0,0,1,47,0
157,160,64,0,32,32,0,0,0,1,46,0
157,160,128,0,32,32,0,0,0,1,45,0
157,112,208,0,32,32,0,0,0,1,44,0
157,576,176,0,32,32,0,0,0,1,40,0
157,576,208,0,32,32,0,0,0,1,39,0
157,544,224,0,32,32,0,0,0,1,38,0
157,512,240,0,32,32,0,0,0,1,37,0
157,480,256,0,32,32,0,0,0,1,36,0
157,448,272,0,32,32,0,0,0,1,35,0
157,416,240,0,32,32,0,0,0,1,34,0
157,416,272,0,32,32,0,0,0,1,33,0
157,432,304,0,32,32,0,0,0,1,32,0
157,400,304,0,32,32,0,0,0,1,31,0
157,368,304,0,32,32,0,0,0,1,30,0
157,336,304,0,32,32,0,0,0,1,29,0
157,304,304,0,32,32,0,0,0,1,28,0
157,272,304,0,32,32,0,0,0,1,27,0
157,240,304,0,32,32,0,0,0,1,26,0
157,240,272,0,32,32,0,0,0,1,25,0
157,240,240,0,32,32,0,0,0,1,24,0
157,360,256,0,32,32,0,0,0,1,23,0
157,328,256,0,32,32,0,0,0,1,22,0
157,296,256,0,32,32,0,0,0,1,21,0
157,296,224,0,32,32,0,0,0,1,20,0
157,296,192,0,32,32,0,0,0,1,19,0
157,240,208,0,32,32,0,0,0,1,18,0
157,208,208,0,32,32,0,0,0,1,17,0
157,176,208,0,32,32,0,0,0,1,16,0
157,144,208,0,32,32,0,0,0,1,15,0
157,160,160,0,32,32,0,0,0,1,14,0
157,192,160,0,32,32,0,0,0,1,13,0
157,224,160,0,32,32,0,0,0,1,12,0
157,256,160,0,32,32,0,0,0,1,11,0
157,288,160,0,32,32,0,0,0,1,10,0
157,512,160,0,32,32,0,0,0,1,9,0
157,480,160,0,32,32,0,0,0,1,8,0
157,448,160,0,32,32,0,0,0,1,7,0
157,416,160,0,32,32,0,0,0,1,6,0
157,384,160,0,32,32,0,0,0,1,5,0
157,352,160,0,32,32,0,0,0,1,4,0
157,320,160,0,32,32,0,0,0,1,3,0
237,320,0,0,16777215,300,0,0,0,1,52,0
1234567890
37,144,176,96,96,256,48,9998,0,0,0,0
37,144,176,96,96,352,64,9998,0,0,0,0
37,144,176,96,96,448,64,9998,0,0,0,0
37,144,176,96,96,64,48,9998,0,0,0,0
37,400,0,16,16,96,176,9998,0,0,0,0
37,400,0,16,16,112,176,9998,0,0,0,0
37,400,0,16,16,128,176,9998,0,0,0,0
37,400,0,16,16,144,176,9998,0,0,0,0
37,400,0,16,16,160,176,9998,0,0,0,0
37,400,0,16,16,176,176,9998,0,0,0,0
37,400,0,16,16,192,176,9998,0,0,0,0
37,400,0,16,16,208,176,9998,0,0,0,0
37,400,0,16,16,224,176,9998,0,0,0,0
37,400,0,16,16,240,176,9998,0,0,0,0
37,400,0,16,16,256,176,9998,0,0,0,0
37,400,0,16,16,256,192,9998,0,0,0,0
37,400,0,16,16,256,208,9998,0,0,0,0
37,400,0,16,16,256,224,9998,0,0,0,0
37,400,0,16,16,256,240,9998,0,0,0,0
37,400,0,16,16,256,256,9998,0,0,0,0
37,400,0,16,16,256,272,9998,0,0,0,0
37,400,0,16,16,272,272,9998,0,0,0,0
37,400,0,16,16,288,272,9998,0,0,0,0
37,400,0,16,16,304,272,9998,0,0,0,0
37,400,0,16,16,320,272,9998,0,0,0,0
37,400,0,16,16,336,272,9998,0,0,0,0
37,400,0,16,16,352,272,9998,0,0,0,0
37,400,0,16,16,368,272,9998,0,0,0,0
37,400,0,16,16,384,272,9998,0,0,0,0
37,400,0,16,16,384,256,9998,0,0,0,0
37,400,0,16,16,368,256,9998,0,0,0,0
37,400,0,16,16,368,240,9998,0,0,0,0
37,400,0,16,16,384,240,9998,0,0,0,0
37,400,0,16,16,384,224,9998,0,0,0,0
37,400,0,16,16,384,208,9998,0,0,0,0
37,400,0,16,16,400,208,9998,0,0,0,0
37,400,0,16,16,416,208,9998,0,0,0,0
37,400,0,16,16,432,208,9998,0,0,0,0
37,400,0,16,16,432,224,9998,0,0,0,0
37,400,0,16,16,432,240,9998,0,0,0,0
37,400,0,16,16,448,240,9998,0,0,0,0
37,400,0,16,16,448,224,9998,0,0,0,0
37,400,0,16,16,464,224,9998,0,0,0,0
37,400,0,16,16,480,224,9998,0,0,0,0
37,400,0,16,16,480,208,9998,0,0,0,0
37,400,0,16,16,496,208,9998,0,0,0,0
37,400,0,16,16,512,208,9998,0,0,0,0
37,400,0,16,16,512,192,9998,0,0,0,0
37,400,0,16,16,528,192,9998,0,0,0,0
37,400,0,16,16,544,192,9998,0,0,0,0
37,400,0,16,16,544,176,9998,0,0,0,0
37,400,0,16,16,544,160,9998,0,0,0,0
37,400,0,16,16,528,160,9998,0,0,0,0
37,400,0,16,16,528,176,9998,0,0,0,0
987654321
AAdqAwMqWSxzLmBLPV8=

