UVx6TlN0AGU9Z25palxPDWI/eQoaQ3xBFWp5HVY0YAV+e3VgKSQ9ZmRjbV9+SQ==
160,199,256,0,0,16777215,0,0,0,1,107,0
158,288,192,0,1,16777215,0,1,0,1,2,0
311,304,239,1,128,64,667003,0,0,1,43,0
100,264,128,0,100,5658198,0,305,0,1,7,0
123,504,152,0,58,3375308,0,0,0,0,82,0
195,512,128,0,0,150,234,0,98,1,80,0
100,392,160,0,200,663894,0,302,0,0,67,0
321,320,256,0,0,0,0,120,0,1,44,0
197,248,256,0,2,117,0,0,0,1,115,0
193,216,192,1,1,110,101,112,0,1,109,1
174,544,160,0,1,93,94,0,0,0,97,1
193,336,192,1,1,52,36,0,0,1,51,0
316,304,256,0,1,1,0,0,0,0,36,0
188,432,256,0,0,29,53,67,82,1,61,0
188,232,264,0,0,0,0,0,0,1,103,0
188,232,257,0,0,116,125,0,0,1,114,0
317,182,319,0,36,1,-1,0,0,1,117,0
317,208,344,0,36,0,1,0,1,1,116,0
317,253,323,0,36,1,-1,0,0,1,112,0
175,216,144,0,112,30,0,0,0,0,110,0
317,296,320,0,36,1,-1,0,0,1,105,0
175,538,176,0,94,300,0,0,0,0,93,0
317,448,256,0,36,0,-1,0,0,1,53,0
157,624,152,0,96,200,0,0,0,1,135,0
157,640,24,0,200,200,0,0,0,1,134,0
157,592,320,0,200,200,0,0,0,1,133,0
157,432,360,0,200,200,0,0,0,1,132,0
157,240,360,0,200,200,0,0,0,1,131,0
157,456,0,0,200,200,0,0,0,1,130,0
157,264,0,0,200,200,0,0,0,1,129,0
157,48,192,0,200,200,0,0,0,1,128,0
157,56,360,0,200,200,0,0,0,1,127,0
157,64,0,0,200,200,0,0,0,1,126,0
157,160,240,0,32,32,0,0,0,1,106,0
157,160,272,0,32,32,0,0,0,1,100,0
157,192,272,0,32,32,0,0,0,1,99,0
157,544,160,0,16,8,0,0,0,1,91,0
157,152,208,0,32,32,0,0,0,1,88,0
157,152,176,0,32,32,0,0,0,1,87,0
157,152,144,0,32,32,0,0,0,1,86,0
157,152,112,0,32,32,0,0,0,1,85,0
157,184,112,0,32,32,0,0,0,1,84,0
157,216,112,0,32,32,0,0,0,1,83,0
157,536,208,0,32,32,0,0,0,1,76,0
157,568,208,0,32,32,0,0,0,1,75,0
157,568,176,0,32,32,0,0,0,1,74,0
157,568,144,0,32,32,0,0,0,1,73,0
157,568,112,0,32,32,0,0,0,1,72,0
157,504,208,0,32,32,0,0,0,1,71,0
157,504,112,0,32,32,0,0,0,1,70,0
157,536,112,0,32,32,0,0,0,1,69,0
157,472,112,0,32,32,0,0,0,1,65,0
157,464,144,0,32,32,0,0,0,1,64,0
157,424,112,0,64,32,0,0,0,1,63,0
157,416,144,0,64,32,0,0,0,1,62,0
157,440,208,0,32,32,0,0,0,1,60,0
157,408,208,0,32,32,0,0,0,1,59,0
157,472,208,0,32,32,0,0,0,1,58,0
157,480,240,0,32,32,0,0,0,1,57,0
157,480,272,0,32,32,0,0,0,1,56,0
157,448,272,0,32,32,0,0,0,1,55,0
157,416,272,0,32,32,0,0,0,1,54,0
157,352,272,0,32,32,0,0,0,1,35,0
157,320,272,0,32,32,0,0,0,1,34,0
157,288,272,0,32,32,0,0,0,1,33,0
157,256,272,0,32,32,0,0,0,1,32,0
157,384,272,0,32,32,0,0,0,1,31,0
157,224,272,0,32,32,0,0,0,1,30,0
157,376,208,0,32,32,0,0,0,1,28,0
157,368,144,0,32,32,0,0,0,1,27,0
157,376,112,0,32,32,0,0,0,1,26,0
157,344,112,0,32,32,0,0,0,1,25,0
157,344,208,0,32,32,0,0,0,1,12,0
157,312,112,0,32,32,0,0,0,1,11,0
157,280,112,0,32,32,0,0,0,1,10,0
157,248,144,0,32,32,0,0,0,1,9,0
157,248,112,0,32,32,0,0,0,1,8,0
157,216,208,0,32,32,0,0,0,1,5,0
157,248,208,0,32,32,0,0,0,1,4,0
157,312,208,0,32,32,0,0,0,1,3,0
157,280,208,0,32,32,0,0,0,1,23,0
157,184,208,0,32,32,0,0,0,1,125,0
169,256,224,0,0,0,0,0,0,1,101,0
169,240,160,0,0,0,0,0,0,1,94,0
169,352,224,0,0,0,0,0,0,1,52,0
169,352,160,0,0,0,0,0,0,1,29,0
166,392,160,0,0,0,294,0,0,0,98,1
1234567890
25,0,192,48,32,256,128,10002,0,0,0,0
25,0,192,48,32,256,160,10002,0,0,0,0
25,0,192,48,32,304,160,10002,0,0,0,0
25,288,192,32,16,304,128,10002,0,0,0,0
25,288,192,32,16,320,144,10002,0,0,0,0
25,336,208,16,16,304,144,10002,0,0,0,0
25,336,208,16,16,336,128,10002,0,0,0,0
25,0,224,16,32,352,160,10002,0,0,0,0
25,272,96,64,32,272,224,10002,0,0,0,0
25,272,96,64,32,400,224,10002,0,0,0,0
25,176,176,16,16,368,240,10002,0,0,0,0
25,304,48,32,16,368,224,10002,0,0,0,0
25,320,64,16,16,384,240,10002,0,0,0,0
25,0,224,16,32,352,224,10002,0,0,0,0
25,272,48,16,32,336,224,10002,0,0,0,0
25,528,256,32,32,368,160,10002,0,0,0,0
25,592,304,32,32,432,160,10002,0,0,0,0
25,544,320,16,32,464,160,10002,0,0,0,0
25,544,256,16,32,416,160,10002,0,0,0,0
25,544,256,16,32,480,160,10002,0,0,0,0
25,544,320,16,32,400,160,10002,0,0,0,0
25,528,256,16,32,480,128,10002,0,0,0,0
25,544,320,16,32,496,160,10002,0,0,0,0
25,544,320,16,32,528,128,10002,0,0,0,0
25,544,320,16,32,544,160,10002,0,0,0,0
25,544,320,16,32,544,128,10002,0,0,0,0
25,592,304,32,32,512,160,10002,0,0,0,0
25,592,304,32,32,496,128,10002,0,0,0,0
25,272,176,80,80,160,128,10002,0,0,0,0
25,144,112,16,32,240,160,10002,0,0,0,0
25,528,256,32,32,240,224,10002,0,0,0,0
25,528,256,32,32,176,224,10002,0,0,0,0
25,528,256,32,32,208,224,10002,0,0,0,0
987654321
AhspAxAnED1tLi1eIUJeNVo=

