UVx6TlN0AGU9Z24dAUdJaHI4QlUWQ3x3F3F+DFI0aER+enVgKSQ9ZmRjbV9+SQ==
160,424,200,0,0,16777215,0,0,0,1,8,0
158,344,200,0,1,16777215,0,1,0,1,2,0
157,272,216,0,32,32,0,0,0,1,14,0
157,240,120,0,32,32,0,0,0,1,13,0
157,240,152,0,32,32,0,0,0,1,12,0
157,240,216,0,32,32,0,0,0,1,11,0
157,240,184,0,32,32,0,0,0,1,10,0
157,304,216,0,32,32,0,0,0,1,9,0
157,432,216,0,32,32,0,0,0,1,7,0
157,400,216,0,32,32,0,0,0,1,6,0
157,368,216,0,32,32,0,0,0,1,5,0
157,336,216,0,32,32,0,0,0,1,4,0
1234567890
25,96,256,16,16,224,208,9998,0,0,0,0
25,96,256,16,16,240,208,9998,0,0,0,0
25,96,256,16,16,256,208,9998,0,0,0,0
25,96,256,16,16,272,208,9998,0,0,0,0
25,96,256,16,16,288,208,9998,0,0,0,0
25,96,256,16,16,304,208,9998,0,0,0,0
25,96,256,16,16,320,208,9998,0,0,0,0
25,96,256,16,16,336,208,9998,0,0,0,0
25,96,256,16,16,352,208,9998,0,0,0,0
25,96,256,16,16,368,208,9998,0,0,0,0
25,96,256,16,16,384,208,9998,0,0,0,0
25,96,256,16,16,400,208,9998,0,0,0,0
25,96,256,16,16,416,208,9998,0,0,0,0
25,96,256,16,16,432,208,9998,0,0,0,0
25,96,256,16,16,448,208,9998,0,0,0,0
25,96,256,16,16,464,208,9998,0,0,0,0
25,96,256,16,16,480,208,9998,0,0,0,0
25,96,256,16,16,496,208,9998,0,0,0,0
25,96,256,16,16,512,208,9998,0,0,0,0
25,96,256,16,16,528,208,9998,0,0,0,0
39,32,192,16,16,224,224,10000,0,0,0,0
39,32,192,16,16,240,224,10000,0,0,0,0
39,32,192,16,16,256,224,10000,0,0,0,0
39,32,192,16,16,272,224,10000,0,0,0,0
39,32,192,16,16,288,224,10000,0,0,0,0
39,32,192,16,16,304,224,10000,0,0,0,0
39,32,192,16,16,320,224,10000,0,0,0,0
39,32,192,16,16,336,224,10000,0,0,0,0
39,32,192,16,16,352,224,10000,0,0,0,0
39,32,192,16,16,368,224,10000,0,0,0,0
39,32,192,16,16,384,224,10000,0,0,0,0
39,32,192,16,16,400,224,10000,0,0,0,0
39,32,192,16,16,416,224,10000,0,0,0,0
39,32,192,16,16,432,224,10000,0,0,0,0
39,32,192,16,16,448,224,10000,0,0,0,0
39,32,192,16,16,464,224,10000,0,0,0,0
39,32,192,16,16,480,224,10000,0,0,0,0
39,32,192,16,16,496,224,10000,0,0,0,0
39,32,192,16,16,512,224,10000,0,0,0,0
39,32,192,16,16,528,224,10000,0,0,0,0
39,64,272,16,16,224,240,9998,0,0,0,0
39,64,272,16,16,240,240,9998,0,0,0,0
39,64,272,16,16,256,240,9998,0,0,0,0
39,64,272,16,16,272,240,9998,0,0,0,0
39,64,272,16,16,288,240,9998,0,0,0,0
39,64,272,16,16,304,240,9998,0,0,0,0
39,64,272,16,16,320,240,9998,0,0,0,0
39,64,272,16,16,336,240,9998,0,0,0,0
39,64,272,16,16,352,240,9998,0,0,0,0
39,64,272,16,16,368,240,9998,0,0,0,0
39,64,272,16,16,384,240,9998,0,0,0,0
39,64,272,16,16,400,240,9998,0,0,0,0
39,64,272,16,16,416,240,9998,0,0,0,0
39,64,272,16,16,432,240,9998,0,0,0,0
39,64,272,16,16,448,240,9998,0,0,0,0
39,64,272,16,16,464,240,9998,0,0,0,0
39,64,272,16,16,480,240,9998,0,0,0,0
39,64,272,16,16,496,240,9998,0,0,0,0
39,64,272,16,16,512,240,9998,0,0,0,0
39,64,272,16,16,528,240,9998,0,0,0,0
987654321

