UVx6TlN0AGU9Z1hDFR1PaX1xN29HEDRPEGl7CxJhIEV+enVgKSQ9ZmRj
158,104,160,0,1,16777215,0,1,0,1,5,0
160,336,160,0,0,16777215,0,0,0,1,10,0
100,536,88,0,256,255,0,269,0,0,167,0
100,112,120,0,256,255,0,269,0,1,54,0
197,96,88,0,2,167,0,0,0,1,129,0
185,336,216,0,0,64,1,0,0,1,2,0
185,408,128,0,0,64,1,0,0,1,3,0
185,264,128,0,0,64,1,0,0,1,4,0
185,400,256,0,0,32,1,0,0,1,87,0
185,272,256,0,0,32,1,0,0,1,88,0
185,149.50,104,0,99,32,1,0,0,1,89,0
185,525.50,136,0,104,32,1,0,0,1,90,0
185,408,208,0,0,32,1,0,0,1,91,0
185,264,208,0,0,32,1,0,0,1,92,0
210,497.50,160,0,39,0,157,0,0,1,41,0
154,149.50,104,0,1,0.50,32,32,-1,1,99,1
154,525.50,136,0,2,0.50,32,32,-1,1,104,1
154,180.50,256,0,3,0.50,32,96,1,1,140,1
154,208.50,176,0,4,0.50,32,32,1,1,145,1
154,469.50,176,0,6,0.50,32,32,1,1,157,1
210,336,24,0,0,180,0,0,0,1,39,0
157,504,304,0,96,96,0,0,0,1,162,0
157,520,264,0,96,96,0,0,0,1,161,0
157,96,176,0,32,32,0,0,0,1,11,0
157,128,176,0,32,32,0,0,0,1,12,0
157,336,64,0,8,16,0,0,0,1,38,0
157,336,8,0,32,32,0,0,0,1,40,0
157,64,176,0,32,32,0,0,0,1,42,0
157,64,144,0,32,32,0,0,0,1,43,0
157,64,112,0,32,32,0,0,0,1,44,0
157,96,104,0,32,32,0,0,0,1,47,0
157,64,104,0,32,32,0,0,0,1,51,0
157,336,352,0,96,96,0,0,0,1,81,0
157,400,352,0,96,96,0,0,0,1,83,0
157,104,240,0,96,96,0,0,0,1,106,0
157,104,336,0,96,96,0,0,0,1,107,0
157,200,352,0,96,96,0,0,0,1,109,0
157,40,336,0,96,96,0,0,0,1,110,0
157,16,240,0,96,96,0,0,0,1,111,0
157,8,152,0,96,96,0,0,0,1,112,0
157,16,136,0,96,96,0,0,0,1,113,0
157,24,40,0,96,96,0,0,0,1,114,0
157,32,40,0,96,96,0,0,0,1,115,0
157,568,208,0,96,96,0,0,0,1,116,0
157,616,208,0,96,96,0,0,0,1,117,0
157,552,240,0,96,96,0,0,0,1,118,0
157,480,368,0,96,96,0,0,0,1,119,0
157,600,304,0,96,96,0,0,0,1,120,0
157,600,344,0,96,96,0,0,0,1,121,0
157,624,128,0,96,96,0,0,0,1,123,0
157,624,48,0,96,96,0,0,0,1,124,0
157,528,32,0,96,96,0,0,0,1,125,0
157,568,32,0,96,96,0,0,0,1,126,0
157,456,352,0,32,96,0,0,0,1,128,0
157,240,352,0,96,96,0,0,0,1,142,0
157,512,352,0,96,96,0,0,0,1,152,0
157,552,320,0,96,96,0,0,0,1,153,0
155,144,104,0,1,1,0,0,0,1,97,0
155,184,104,0,2,1,0,0,0,1,98,0
155,520,136,0,1,2,0,0,0,1,102,0
155,552,136,0,2,2,0,0,0,1,103,0
155,160,256,0,1,3,0,0,0,1,138,0
155,240,256,0,2,3,0,0,0,1,139,0
155,144,176,0,1,4,0,0,0,1,143,0
155,240,176,0,2,4,0,0,0,1,144,0
155,464,176,0,1,6,0,0,0,1,155,0
155,504,176,0,2,6,0,0,0,1,156,0
1234567890
25,400,48,64,48,144,160,10002,0,0,0,0
25,256,0,16,80,128,0,10002,0,0,0,0
25,256,0,16,80,112,0,10002,0,0,0,0
25,256,0,16,80,112,80,10002,0,0,0,0
25,256,0,16,80,128,80,10002,0,0,0,0
25,176,176,80,80,32,0,10002,0,0,0,0
25,176,176,80,80,32,80,10002,0,0,0,0
25,176,176,80,80,144,80,10002,0,0,0,0
25,176,176,80,80,224,80,10002,0,0,0,0
25,176,176,80,80,304,80,10002,0,0,0,0
25,176,176,80,80,384,80,10002,0,0,0,0
25,176,176,80,80,400,0,10002,0,0,0,0
25,176,176,80,80,320,0,10002,0,0,0,0
25,176,176,80,80,240,0,10002,0,0,0,0
25,176,176,80,80,160,0,10002,0,0,0,0
25,256,0,16,80,144,0,10002,0,0,0,0
25,176,176,80,48,384,256,10002,0,0,0,0
25,176,176,80,48,304,256,10002,0,0,0,0
25,176,176,80,48,224,256,10002,0,0,0,0
25,176,176,80,48,144,256,10002,0,0,0,0
25,464,96,32,48,144,208,10002,0,0,0,0
25,464,96,32,48,176,208,10002,0,0,0,0
25,464,96,32,48,464,208,10002,0,0,0,0
25,464,96,32,48,496,208,10002,0,0,0,0
25,464,96,32,48,432,208,10002,0,0,0,0
25,176,176,80,80,464,80,10002,0,0,0,0
25,176,176,80,80,544,80,10002,0,0,0,0
25,0,176,176,48,208,160,10002,0,0,0,0
25,0,176,176,48,208,208,10002,0,0,0,0
25,0,176,176,48,384,160,10002,0,0,0,0
25,464,96,32,48,400,208,10002,0,0,0,0
38,160,160,48,32,464,96,9998,0,0,0,0
38,144,288,32,32,160,160,9998,0,0,0,0
38,48,288,16,32,320,80,9998,0,0,0,0
38,128,320,32,16,144,288,9998,0,0,0,0
38,16,256,32,32,352,160,9998,0,0,0,0
38,16,256,32,32,144,112,9998,0,0,0,0
38,224,96,32,32,288,64,9998,0,0,0,0
38,192,128,32,32,208,208,9998,0,0,0,0
38,448,176,32,48,80,0,9998,0,0,0,0
38,384,336,32,16,288,32,9998,0,0,0,0
38,16,288,32,32,192,128,9998,0,0,0,0
38,176,288,32,32,464,128,9998,0,0,0,0
38,176,288,32,32,224,48,9998,0,0,0,0
38,176,288,32,32,416,208,9998,0,0,0,0
38,176,320,32,16,368,288,9998,0,0,0,0
38,64,320,32,16,240,288,9998,0,0,0,0
38,160,240,32,48,400,272,9998,0,0,0,0
38,160,240,32,48,272,144,9998,0,0,0,0
38,128,320,32,16,432,288,9998,0,0,0,0
38,0,256,16,32,448,160,9998,0,0,0,0
38,192,128,32,32,432,16,9998,0,0,0,0
38,96,128,32,32,528,96,9998,0,0,0,0
24,464,176,32,16,128,144,9998,0,0,0,0
24,256,80,64,16,416,0,9998,0,0,0,0
24,256,80,64,16,352,0,9998,0,0,0,0
24,64,16,64,16,96,48,9998,0,0,0,0
24,80,32,16,64,192,240,9998,0,0,0,0
24,64,96,32,32,400,16,9998,0,0,0,0
24,32,192,32,32,528,128,9998,0,0,0,0
24,112,160,16,32,560,128,9998,0,0,0,0
24,320,288,144,32,176,0,9998,0,0,0,0
24,288,288,16,32,160,0,9998,0,0,0,0
24,496,224,16,64,144,192,9998,0,0,0,0
24,496,304,64,32,400,64,9998,0,0,0,0
24,496,160,64,32,304,256,9998,0,0,0,0
987654321
MAEkBg0rXCV2ZSMAJENMLhM/O1ZBCnBWFiV7F0g0M1U=

