UVx6TlN0AGU9Z1t5ZkZMAmUrSlZkDjRjRDg7K1syfhAmOQo1ZmZ0Ijt/cUNiVSc2HGgkO182bg==
259,200,320,0,160,32,0,0,0,1,37,0
259,136,232,0,32,208,0,0,0,1,36,0
259,152,144,0,64,32,0,0,0,1,30,0
259,248,304,0,64,64,0,0,0,1,28,0
259,424,128,0,32,64,0,0,0,1,9,0
158,208,160,0,1,16777215,0,1,0,1,7,0
160,192,272,0,0,16777215,0,0,0,1,47,0
123,288,224,0,128,16777215,0,0,0,1,43,0
123,304,128,0,128,16777215,0,0,0,1,41,0
123,368,200,0,128,16777215,0,0,0,1,42,0
174,424,160,0,1,26,25,24,23,0,11,1
174,296,160,0,1,17,18,19,16,0,27,1
185,624,360,0,0,32,1,0,0,1,132,0
185,608,360,0,0,32,1,0,0,1,131,0
185,592,360,0,0,32,1,0,0,1,130,0
185,576,360,0,0,32,1,0,0,1,129,0
185,560,360,0,0,32,1,0,0,1,128,0
185,544,360,0,0,32,1,0,0,1,127,0
185,528,360,0,0,32,1,0,0,1,126,0
185,512,360,0,0,32,1,0,0,1,125,0
185,496,360,0,0,32,1,0,0,1,124,0
185,480,360,0,0,32,1,0,0,1,123,0
185,464,360,0,0,32,1,0,0,1,122,0
185,448,360,0,0,32,1,0,0,1,121,0
185,432,360,0,0,32,1,0,0,1,120,0
185,416,360,0,0,32,1,0,0,1,119,0
185,400,360,0,0,32,1,0,0,1,118,0
185,384,360,0,0,32,1,0,0,1,117,0
185,368,360,0,0,32,1,0,0,1,116,0
185,352,360,0,0,32,1,0,0,1,115,0
185,336,360,0,0,32,1,0,0,1,114,0
185,320,360,0,0,32,1,0,0,1,113,0
185,304,360,0,0,32,1,0,0,1,112,0
185,288,360,0,0,32,1,0,0,1,111,0
185,272,360,0,0,32,1,0,0,1,110,0
185,256,360,0,0,32,1,0,0,1,109,0
185,240,360,0,0,32,1,0,0,1,108,0
185,224,360,0,0,32,1,0,0,1,107,0
185,208,360,0,0,32,1,0,0,1,106,0
185,192,360,0,0,32,1,0,0,1,105,0
185,176,360,0,0,32,1,0,0,1,104,0
185,160,360,0,0,32,1,0,0,1,103,0
185,144,360,0,0,32,1,0,0,1,102,0
185,128,360,0,0,32,1,0,0,1,101,0
185,112,352,0,0,32,1,0,0,1,100,0
185,96,336,0,0,32,1,0,0,1,99,0
185,80,320,0,0,32,1,0,0,1,98,0
185,64,304,0,0,32,1,0,0,1,97,0
185,48,288,0,0,32,1,0,0,1,96,0
185,48,344,0,0,32,1,0,0,1,95,0
185,8,168,0,0,32,1,0,0,1,94,0
185,112,96,0,0,32,1,0,0,1,93,0
185,96,80,0,0,32,1,0,0,1,92,0
185,80,64,0,0,32,1,0,0,1,91,0
185,64,48,0,0,32,1,0,0,1,90,0
185,48,32,0,0,32,1,0,0,1,89,0
185,32,16,0,0,32,1,0,0,1,88,0
185,32,272,0,0,32,1,0,0,1,87,0
185,80,104,0,0,32,1,0,0,1,86,0
185,232,80,0,0,32,1,0,0,1,85,0
185,272,80,0,0,32,1,0,0,1,84,0
185,312,80,0,0,32,1,0,0,1,83,0
185,328,80,0,0,32,1,0,0,1,82,0
185,288,81,0,0,32,1,0,0,1,81,0
185,248,84,0,0,32,1,0,0,1,80,0
185,208,80,0,0,32,1,0,0,1,79,0
185,243,50,0,0,32,1,0,0,1,78,0
185,348,36,0,0,32,1,0,0,1,77,0
185,512,62,0,0,32,1,0,0,1,76,0
185,513,156,0,0,32,1,0,0,1,75,0
157,200,360,0,160,48,0,0,0,1,39,0
157,56,336,0,128,64,0,0,0,1,38,0
157,480,336,0,400,64,0,0,0,1,35,0
157,560,184,0,176,240,0,0,0,1,34,0
157,320,32,0,656,64,0,0,0,1,33,0
157,48,184,0,144,240,0,0,0,1,32,0
157,136,96,0,32,64,0,0,0,1,31,0
157,368,288,0,176,32,0,0,0,1,29,0
157,424,224,0,32,128,0,0,0,1,10,0
157,160,224,0,16,128,0,0,0,1,6,0
157,184,288,0,64,32,0,0,0,1,5,0
157,456,192,0,32,224,0,0,0,1,4,0
157,328,80,0,288,32,0,0,0,1,3,0
157,168,96,0,32,64,0,0,0,1,2,0
157,240,176,0,176,32,0,0,0,1,74,0
166,232,272,0,0,0,90,0,0,1,26,1
166,248,272,0,0,0,90,0,0,1,25,1
166,264,272,0,0,0,90,0,0,1,24,1
166,280,272,0,0,0,90,0,0,1,23,1
166,296,272,0,0,0,90,0,0,1,22,1
166,312,272,0,0,0,90,0,0,1,21,1
166,328,272,0,0,0,90,0,0,1,20,1
166,352,272,0,0,0,106,0,0,1,19,1
166,392,272,0,0,0,128,0,0,1,18,1
166,408,248,0,0,0,144,0,0,1,17,1
166,408,224,0,0,0,155,0,0,1,16,1
166,408,200,0,0,0,171,0,0,1,15,1
166,408,184,0,0,0,180,0,0,1,13,1
166,328,168,0,0,0,0,0,0,1,12,1
1234567890
35,240,48,48,48,384,96,10002,0,0,0,0
35,240,48,48,48,432,96,10002,0,0,0,0
35,240,48,48,48,384,144,10002,0,0,0,0
35,240,48,48,48,384,192,10002,0,0,0,0
35,240,48,48,48,384,240,10002,0,0,0,0
35,240,48,48,48,336,240,10002,0,0,0,0
35,240,48,48,48,336,192,10002,0,0,0,0
35,240,48,48,48,336,96,10002,0,0,0,0
35,240,48,48,48,336,144,10002,0,0,0,0
35,240,48,48,48,288,96,10002,0,0,0,0
35,240,48,48,48,288,144,10002,0,0,0,0
35,240,48,48,48,240,96,10002,0,0,0,0
35,240,48,48,48,192,96,10002,0,0,0,0
35,240,48,48,48,144,96,10002,0,0,0,0
35,240,48,48,48,96,96,10002,0,0,0,0
35,240,48,48,48,96,144,10002,0,0,0,0
35,240,48,48,48,144,144,10002,0,0,0,0
35,240,48,48,48,240,144,10002,0,0,0,0
35,240,48,48,48,288,192,10002,0,0,0,0
35,240,48,48,48,240,192,10002,0,0,0,0
35,240,48,48,48,192,192,10002,0,0,0,0
35,240,48,48,48,192,144,10002,0,0,0,0
35,240,48,48,48,144,192,10002,0,0,0,0
35,240,48,48,48,96,192,10002,0,0,0,0
35,240,48,48,48,96,240,10002,0,0,0,0
35,240,48,48,48,144,240,10002,0,0,0,0
35,240,48,48,48,192,240,10002,0,0,0,0
35,240,48,48,48,240,240,10002,0,0,0,0
35,240,48,48,48,288,240,10002,0,0,0,0
35,240,48,48,48,288,288,10002,0,0,0,0
35,240,48,48,48,240,288,10002,0,0,0,0
35,240,48,48,48,192,288,10002,0,0,0,0
35,240,48,48,48,144,288,10002,0,0,0,0
35,240,48,48,48,96,288,10002,0,0,0,0
35,240,48,48,48,512,336,10002,0,0,0,0
35,240,48,48,48,448,352,10002,0,0,0,0
35,240,48,48,48,320,352,10002,0,0,0,0
35,240,48,48,48,80,352,10002,0,0,0,0
35,240,48,48,48,16,336,10002,0,0,0,0
35,240,48,48,48,0,208,10002,0,0,0,0
35,240,48,48,48,0,144,10002,0,0,0,0
35,240,48,48,48,64,48,10002,0,0,0,0
35,240,48,48,48,128,16,10002,0,0,0,0
35,240,48,48,48,192,16,10002,0,0,0,0
35,240,48,48,48,272,32,10002,0,0,0,0
987654321
Bhs=

