Vl56Ukx6CX8pcyFKFENBPgYKLnV6PylsODgqVGkGQDdgZml8NTghenh/cUNiVSc=
160,1536,560,0,0,16777215,0,0,0,1,4,0
158,168,560,0,1,16777215,0,1,0,1,3,0
224,1184,344,0,156,16777215,0,0,0,1,397,0
100,1456,96,0,524,16777215,0,271,239,1,350,0
100,1016,168,0,120,16777215,0,238,0,1,355,0
100,968,248,0,364,16777215,0,270,0,1,356,0
224,616,696,0,112,16777215,0,0,0,1,406,0
195,520,360,0,0,320,270,190,192,1,169,0
195,344,416,0,0,156,270,0,70,1,40,0
123,200,496,0,112,16777215,0,0,0,1,103,0
123,400,472,0,212,16777215,0,0,0,1,102,0
100,1144,168,0,120,16777215,0,306,0,1,354,0
100,968,416,0,360,16777215,0,270,0,1,307,0
224,976,688,0,164,16777215,0,0,0,1,408,0
224,1216,560,0,192,16777215,0,0,0,1,426,0
224,432,704,0,172,16777215,0,0,0,1,407,0
224,192,648,0,148,16777215,0,0,0,1,405,0
100,520,456,0,404,16777215,0,320,0,1,326,0
100,792,456,0,276,16777215,0,236,0,1,327,0
174,552,560,0,1,206,0,0,0,0,205,1
174,1016,560,0,1,47,0,0,0,0,5,1
189,1456,96,0,239,168,270,0,0,1,242,0
189,968,248,0,0,164,270,0,0,1,359,0
189,968,424,0,0,164,270,0,0,1,29,0
186,168,392,0,0,0,0,0,0,1,88,0
188,392,416,0,180,146,0,0,0,1,152,0
188,696,560,0,0,366,0,0,0,1,196,0
188,616,560,0,0,364,0,0,0,1,199,0
188,584,560,0,0,363,0,0,0,1,200,0
188,728,560,0,0,365,0,0,0,1,197,0
188,1040,208,0,0,237,0,0,0,1,232,0
188,1096,208,0,180,217,0,0,0,1,63,0
188,1096,576,0,0,27,0,0,0,1,65,0
188,112,736,0,0,418,0,0,0,1,423,0
242,656,688,0,32,32,0,0,0,1,335,0
242,848,544,0,32,32,0,0,0,1,336,0
242,1008,192,0,32,32,0,0,0,1,343,0
216,1456,360,0,-1,0,0,192,RVNDQVBF,1,433,0
216,1456,448,0,-1,0,0,96,V0FMTA==,1,422,0
154,726,544,0,4,1,32,32,-1,1,190,1
154,325.60,544,0,2,0.40,16,32,1,1,100,1
154,1096,216,0,1,1.50,48,16,1,1,49,1
154,168,408,0,3,0.50,32,16,1,1,148,1
154,1456,96,0,5,2,32,32,-1,1,239,1
154,1291,280,0,6,0.50,48,32,1,1,256,1
154,1320,336.40,0,7,0.40,48,32,1,1,264,1
154,1384,456.80,0,8,0.40,48,32,1,1,268,1
216,168,448,0,-1,0,0,96,Q0VMTA==,1,416,0
216,920,192,0,-1,0,0,108,Uk9PRg==,1,421,0
216,968,504,0,-1,0,0,140,TUVESUNBTA==,1,420,0
216,432,688,0,-1,0,0,128,U0VXRVI=,0,418,0
216,656,536,0,-1,0,0,176,TEFXTg==,1,419,0
157,1360,616,0,480,112,0,0,0,1,276,0
157,992,752,0,256,96,0,0,1,1,275,0
157,680,568,0,16,16,0,0,0,1,182,0
157,680,632,0,16,80,0,0,0,1,181,0
157,632,584,0,16,48,0,0,0,1,175,0
157,736,752,0,256,96,0,0,1,1,173,0
157,776,616,0,176,112,0,0,0,1,172,0
157,632,648,0,16,48,0,0,0,1,171,0
157,848,368,0,96,320,0,0,0,1,170,0
157,456,488,0,48,144,0,0,0,1,116,0
157,424,504,0,16,112,0,0,0,1,113,0
157,424,424,0,16,16,0,0,0,1,110,0
157,88,496,0,16,160,0,0,0,1,107,0
157,88,616,0,16,48,0,0,0,1,106,0
157,112,384,0,80,64,0,0,1,1,93,0
157,40,544,0,80,384,0,0,0,1,80,0
157,312,616,0,336,112,0,0,0,1,11,0
157,1168,384,0,96,352,0,0,0,1,44,0
157,256,472,0,32,112,0,0,0,1,68,0
157,336,384,0,304,64,0,0,0,1,72,0
157,176,712,0,96,48,0,0,0,1,82,0
157,304,768,0,608,64,0,0,1,1,90,0
157,416,720,0,384,32,0,0,0,1,156,0
157,136,584,0,16,48,0,0,0,1,158,0
157,136,648,0,16,48,0,0,0,1,159,0
157,88,696,0,16,80,0,0,0,1,160,0
157,496,512,0,32,320,0,0,0,1,164,0
157,568,616,0,112,112,0,0,0,1,165,0
157,1056,472,0,32,112,0,0,0,1,210,0
157,984,400,0,176,32,0,0,0,1,212,0
157,968,616,0,208,112,0,0,0,1,213,0
157,1056,296,0,32,112,0,0,0,1,215,0
157,984,224,0,176,32,0,0,0,1,216,0
157,1080,168,0,112,16,0,0,0,1,218,0
157,1128,192,0,16,32,0,0,0,1,219,0
157,1456,512,0,32,96,0,0,0,1,250,0
157,1360,736,0,480,128,0,0,1,1,283,0
157,800,848,0,1616,96,0,0,1,1,284,0
157,256,256,0,512,192,0,0,0,1,285,0
169,248,528,0,0,0,0,0,0,0,70,1
169,1048,528,0,0,0,0,0,0,1,27,1
169,808,528,0,0,0,0,0,0,1,206,1
169,1048,352,0,0,0,0,0,0,1,214,1
169,1048,176,0,0,0,0,0,0,1,217,1
253,1456,464,0,16777215,180,1,0,0,1,398,0
253,680,576,0,10419198,0,0,0,0,1,306,0
253,632,608,0,10419198,0,0,0,0,1,305,0
253,88,640,0,10419198,0,0,0,0,1,304,0
253,136,608,0,10419198,0,0,0,0,1,303,0
253,88,576,0,10419198,0,0,0,0,1,295,0
166,520,544,0,0,0,0,0,0,0,192,1
166,1224,280,0,0,0,0,0,0,1,8,1
166,1224,360,0,0,0,0,0,0,1,251,1
166,1224,440,0,0,0,0,0,0,1,252,1
166,1224,520,0,0,0,0,0,0,1,253,1
166,520,392,0,0,0,291,0,0,0,363,1
166,520,424,0,0,0,306,0,0,0,364,1
166,792,392,0,0,0,249,0,0,0,365,1
166,792,424,0,0,0,234,0,0,0,366,1
216,344,448,0,-1,0,0,132,UFVCTElD,1,417,0
155,880,544,0,2,4,0,0,0,1,189,0
155,528,544,0,1,4,0,0,0,1,188,0
155,376,544,0,2,2,0,0,0,1,99,0
155,312,544,0,1,2,0,0,0,1,98,0
155,1096,568,0,2,1,40,0,0,1,48,0
155,1096,216,0,1,1,40,0,0,0,47,0
155,168,408,0,1,3,30,0,0,0,146,0
155,136,408,0,2,3,0,0,0,1,147,0
155,1456,96,0,1,5,0,0,0,0,237,0
155,784,96,0,2,5,0,0,0,1,238,0
155,1256,280,0,1,6,0,0,0,1,254,0
155,1304,280,0,2,6,0,0,0,1,255,0
155,1320,336,0,1,7,0,0,0,1,262,0
155,1320,368,0,2,7,0,0,0,1,263,0
155,1384,472,0,1,8,0,0,0,1,266,0
155,1384,400,0,2,8,0,0,0,1,267,0
1234567890
36,464,0,176,256,96,416,10002,0,0,0,0
36,464,0,176,256,272,416,10002,0,0,0,0
36,464,0,176,256,896,240,10002,0,0,0,0
36,464,0,176,96,896,496,10002,0,0,0,0
36,352,160,32,32,848,528,10002,0,0,0,0
36,352,160,32,32,816,528,10002,0,0,0,0
36,448,288,96,64,1072,224,10002,0,0,0,0
36,448,288,96,64,1072,288,10002,0,0,0,0
36,448,288,96,64,1072,352,10002,0,0,0,0
36,448,288,96,64,1072,416,10002,0,0,0,0
36,448,288,96,64,1072,480,10002,0,0,0,0
36,448,288,96,64,1072,544,10002,0,0,0,0
36,448,288,96,64,1072,608,10002,0,0,0,0
36,448,288,96,64,1072,672,10002,0,0,0,0
36,448,288,96,64,976,672,10002,0,0,0,0
36,448,288,96,64,880,672,10002,0,0,0,0
36,448,288,96,64,784,672,10002,0,0,0,0
36,448,288,96,64,688,672,10002,0,0,0,0
36,448,288,96,64,592,672,10002,0,0,0,0
36,448,288,96,64,496,672,10002,0,0,0,0
36,448,288,96,64,400,672,10002,0,0,0,0
36,448,288,96,64,304,672,10002,0,0,0,0
36,448,288,96,64,208,672,10002,0,0,0,0
36,448,288,96,64,112,672,10002,0,0,0,0
36,448,288,96,64,16,672,10002,0,0,0,0
36,448,288,96,32,624,560,10002,0,0,0,0
36,448,288,96,32,624,592,10002,0,0,0,0
36,448,288,96,32,624,624,10002,0,0,0,0
36,544,288,32,16,640,656,10002,0,0,0,0
36,464,160,80,48,144,352,10002,0,0,0,0
37,304,128,64,16,96,416,9998,0,0,0,0
37,304,128,64,16,176,416,9998,0,0,0,0
37,304,128,64,16,272,416,9998,0,0,0,0
37,304,128,64,16,352,416,9998,0,0,0,0
37,304,128,64,16,288,672,9998,0,0,0,0
37,304,128,64,16,464,672,9998,0,0,0,0
37,304,128,64,16,672,672,9998,0,0,0,0
37,304,128,64,16,864,672,9998,0,0,0,0
37,304,128,64,16,1008,672,9998,0,0,0,0
37,304,128,64,16,976,240,9998,0,0,0,0
37,304,128,64,16,896,240,9998,0,0,0,0
37,304,128,64,16,816,528,9998,0,0,0,0
36,448,288,48,32,1072,176,10002,0,0,0,0
36,496,288,16,32,1056,176,10002,0,0,0,0
987654321
NSUI

