UVx6TlN0AGU9Z1x5ZkV3DUM1VXkTQ3x3F3F+DFI0aEV+enVgKSQ9ZmRjbV9+SQ==
259,72,344,0,112,16,0,0,0,1,68,0
259,24,312,0,16,64,0,0,0,1,67,0
259,120,312,0,16,64,0,0,0,1,66,0
259,72,320,0,16,64,0,0,0,1,65,0
259,80,264,0,96,112,0,0,0,1,64,0
259,16,112,0,32,32,0,0,0,0,58,0
158,192,296,0,1,16777215,0,1,0,1,16,0
123,328,168,0,104,13675648,0,0,0,1,133,0
195,216,64,0,0,128,256,0,98,1,93,0
123,192,128,0,216,255,0,0,0,1,96,0
381,88,128,0,0,0,0,0,0,1,17,1
174,288,152,0,0,0,0,114,115,0,124,1
174,272,136,0,0,91,92,114,115,0,98,1
174,56,128,0,0,58,55,0,0,0,59,1
316,48,27,0,0,-1,0,0,0,1,38,0
316,320,328,0,0,1,0,0,0,1,4,0
181,264,144,0,0,128,180,0,0,1,126,0
219,88,144,0,48,32,0,0,0,1,36,1
186,48,272,0,0,0,0,0,0,1,12,0
313,320,160,0,131,32,32,0,38,1,129,0
313,128,64,0,53,16,32,0,38,1,52,0
313,320,96,0,124,32,32,0,38,1,122,0
313,128,96,0,57,32,32,0,38,1,56,0
313,320,72,0,117,32,32,0,38,1,116,0
313,96,320,0,8,32,16,1,12,1,9,0
313,48,320,0,7,32,16,1,12,1,10,0
313,48,328,0,63,32,16,0,200,1,62,0
175,388,156,0,128,60,0,0,0,0,131,0
317,320,152,0,38,1,1,1,0,1,128,0
317,320,72,0,38,0,1,0,0,1,117,0
175,178,102,0,71,240,0,0,0,1,75,0
175,120,120,0,59,60,0,0,0,0,57,0
317,58,114,0,38,1,-1,0,1,1,53,0
175,8,40,0,37,60,0,0,0,1,39,0
317,24,64,0,38,1,1,0,0,1,37,0
317,352,248,0,4,1,1,0,0,1,8,0
317,288,256,0,4,1,-1,0,0,1,7,0
154,192,56,0,1,0.50,64,16,1,1,73,1
210,320,0,0,0,180,0,0,0,1,110,0
210,-1,112,0,110,270,0,0,0,1,109,0
210,80,176,0,48,0,0,0,0,1,50,0
210,96,336,0,0,0,0,0,0,1,49,0
210,96,176,0,49,0,0,0,0,1,51,0
210,48,336,0,0,0,0,0,0,1,48,0
157,48,280,0,32,16,0,0,0,1,63,0
157,352,104,0,32,208,0,0,0,1,112,0
157,320,192,0,32,32,0,1,0,1,111,0
157,264,192,0,80,32,0,0,0,1,88,0
157,192,184,0,64,16,0,0,0,1,85,0
157,264,56,0,80,112,0,0,1,1,83,0
157,136,168,0,48,32,0,0,0,1,61,0
157,32,168,0,64,32,0,0,0,1,60,0
157,24,88,0,48,16,0,0,0,1,54,0
157,80,192,0,160,32,0,0,0,1,47,0
157,136,144,0,48,32,0,0,0,1,46,0
157,32,144,0,64,32,0,0,0,1,45,0
157,152,80,0,16,96,0,0,0,1,44,0
157,112,16,0,96,32,0,0,0,1,43,0
157,56,72,0,112,16,0,0,0,1,42,0
157,16,16,0,32,32,0,0,0,1,35,0
157,120,272,0,16,128,0,0,0,1,15,0
157,72,272,0,16,128,0,0,0,1,11,0
157,344,312,0,16,32,0,0,0,1,6,0
157,296,312,0,16,32,0,0,0,1,5,0
157,16,272,0,32,128,0,0,0,1,2,0
157,320,352,0,640,32,0,0,0,1,34,0
169,304,192,0,0,0,0,0,0,1,115,0
169,288,192,0,1,0,0,0,0,1,114,0
169,224,144,0,1,0,0,0,0,1,92,0
169,224,112,0,0,0,0,0,0,1,91,0
169,32,96,0,0,0,0,0,0,0,55,0
155,256,56,0,2,1,0,0,0,0,72,0
155,192,56,0,1,1,0,0,0,0,71,0
1234567890
37,496,304,16,16,96,304,9998,0,0,0,0
37,496,304,16,16,48,304,9998,0,0,0,0
38,304,288,16,16,160,272,10000,0,0,0,0
38,304,288,16,16,144,272,10000,0,0,0,0
38,304,288,16,16,144,304,10000,0,0,0,0
38,304,288,16,16,144,288,10000,0,0,0,0
38,304,288,16,16,160,288,10000,0,0,0,0
38,304,288,16,16,160,304,10000,0,0,0,0
38,624,272,16,16,160,256,10000,0,0,0,0
34,112,304,32,16,80,320,10002,0,0,0,0
34,96,304,32,16,32,320,10002,0,0,0,0
35,240,304,16,16,0,96,10002,0,0,0,0
35,240,336,16,16,0,112,10002,0,0,0,0
35,256,304,16,16,16,96,10002,0,0,0,0
35,256,304,16,16,32,96,10002,0,0,0,0
35,256,336,16,16,16,112,10002,0,0,0,0
35,256,336,16,16,32,112,10002,0,0,0,0
35,256,336,16,16,48,112,10002,0,0,0,0
35,256,336,16,16,64,112,10002,0,0,0,0
35,256,336,16,16,80,112,10002,0,0,0,0
35,256,336,16,16,96,112,10002,0,0,0,0
35,256,336,16,16,112,112,10002,0,0,0,0
35,272,336,16,16,128,112,10002,0,0,0,0
35,272,304,16,16,128,80,10002,0,0,0,0
35,272,320,16,16,128,96,10002,0,0,0,0
35,256,304,16,16,112,80,10002,0,0,0,0
35,256,304,16,16,96,80,10002,0,0,0,0
35,256,304,16,16,80,80,10002,0,0,0,0
35,256,304,16,16,64,80,10002,0,0,0,0
35,240,304,16,16,48,80,10002,0,0,0,0
35,272,288,16,16,48,96,10002,0,0,0,0
35,416,336,16,16,112,96,10002,0,0,0,0
35,352,320,32,16,64,96,10002,0,0,0,0
35,400,304,16,16,96,96,10002,0,0,0,0
35,0,48,16,16,0,32,10002,0,0,0,0
35,0,128,16,16,0,48,10002,0,0,0,0
35,16,48,16,16,128,32,10002,0,0,0,0
35,96,112,64,16,64,32,10002,0,0,0,0
35,96,128,64,16,16,48,10002,0,0,0,0
35,176,128,16,16,32,32,10002,0,0,0,0
35,160,128,16,16,48,32,10002,0,0,0,0
35,128,112,16,16,16,32,10002,0,0,0,0
35,16,48,16,32,48,0,10002,0,0,0,0
35,0,48,16,32,32,0,10002,0,0,0,0
35,176,112,16,16,112,48,10002,0,0,0,0
35,96,128,16,16,80,48,10002,0,0,0,0
35,112,128,16,16,96,48,10002,0,0,0,0
35,16,96,16,16,128,48,10002,0,0,0,0
35,16,128,16,16,128,64,10002,0,0,0,0
35,0,128,16,16,112,64,10002,0,0,0,0
35,96,304,48,48,64,128,10002,0,0,0,0
987654321

