XlF4TlRzBmU9Z1tpO0d/HXI1eglgEQl1K3NzDwNsICUgIzQ1VmB0Jjt/cUNiVSc2HGgkO182bg==
259,16,80,0,32,32,0,0,0,1,32,0
259,480,72,0,256,80,0,0,0,1,37,0
259,392,136,0,112,80,0,0,0,1,76,0
259,176,224,0,336,224,0,0,0,1,146,0
259,328,384,0,576,64,0,0,0,1,160,0
259,544,240,0,192,224,0,0,0,1,258,0
259,808,240,0,336,240,0,0,0,1,259,0
259,392,296,0,112,80,0,0,0,1,267,0
160,368,336,0,0,16777215,0,0,0,1,172,0
158,72,96,0,1,16777215,0,1,0,1,6,0
224,800,264,0,212,16777215,0,0,270,1,203,0
123,600,200,0,148,16777215,0,0,0,1,176,0
224,512,72,0,252,16777215,0,0,0,1,25,0
224,208,80,0,288,16777215,0,0,0,1,19,0
224,144,280,0,188,16777215,0,0,0,1,142,0
197,463,256,0,2,186,0,0,0,1,183,0
197,768,224,0,2,168,0,0,0,1,249,0
197,864,336,0,2,167,0,0,0,1,223,0
197,56,160,0,2,83,0,0,0,1,145,0
197,408,96,0,3.50,75,0,0,0,1,73,0
174,320,208,0,1,117,95,96,118,0,85,0
174,320,96,0,1,29,32,37,0,0,33,0
193,368,160,0,1,129,81,146,0,1,130,1
174,568,96,0,1,27,35,0,0,0,71,0
189,592,192,0,0,128,180,0,0,1,182,0
205,448.50,96,0,1,0,0.50,0,0,1,36,0
308,672,152,0,0,128,270,0,0,1,247,0
308,688,272,0,0,128,270,0,0,1,219,0
308,568,288,0,0,128,270,0,0,1,199,0
308,800,272,0,0,128,270,0,0,1,224,0
308,824,152,0,0,128,270,0,0,1,248,0
205,75.50,336,0,1,0,0.50,0,0,1,92,0
308,904,272,0,0,128,270,0,0,1,226,0
186,280,328,0,0,0,0,0,0,1,89,0
219,280,224,0,32,32,0,0,0,1,108,1
220,464,64,0,32,64,0,0,0,0,35,0
188,48,240,0,180,101,0,0,0,1,107,0
188,496,360,0,270,151,0,0,0,1,159,0
188,392,360,0,270,0,166,0,0,1,191,0
242,480,160,0,80,32,0,0,0,0,81,0
242,624,320,0,32,32,0,0,0,0,206,0
176,488,152,0,173,48,48,0,0,1,174,0
176,304,152,0,154,64,48,0,0,1,152,0
176,624,320,0,206,32,32,0,0,1,205,0
210,288,56,0,18,90,0,0,0,1,16,0
154,224,104,0,1,0.50,48,16,1,1,10,1
154,48,368,0,2,0.50,32,64,1,1,97,1
154,280,344,0,3,0.50,32,16,1,1,103,1
154,224,184,0,4,0.50,32,48,1,1,119,1
154,528,360,0,5,0.50,16,16,1,1,156,1
154,536,232,0,6,0.50,16,32,1,1,180,1
154,424,361,0,7,0.50,16,16,1,1,188,1
210,608,88,0,31,90,0,0,0,1,39,0
216,808,152,0,-1,0,0,192,SEFORyBBTkQgSlVNUA==,1,251,0
210,608,72,0,30,90,0,0,0,1,38,0
210,128,56,0,16,270,0,0,0,1,18,0
210,0,72,0,38,270,0,0,0,1,30,0
210,288,40,0,17,90,0,0,0,1,15,0
210,0,88,0,39,270,0,0,0,1,31,0
210,128,40,0,15,270,0,0,0,1,17,0
157,256,344,0,544,16,0,0,1,1,69,0
157,312,16,0,672,32,0,0,0,1,2,0
157,16,256,0,32,320,0,0,0,1,3,0
157,624,160,0,32,288,0,0,0,1,4,0
157,72,104,0,80,16,0,0,0,1,5,0
157,120,48,0,16,32,0,0,0,1,13,0
157,296,48,0,16,32,0,0,0,1,14,0
157,512,112,0,256,32,0,0,0,1,23,0
157,136,224,0,256,32,0,0,0,1,24,0
157,344,48,0,16,32,0,0,0,1,26,0
157,16,48,0,32,32,0,0,0,1,28,0
157,536,96,0,16,16,0,0,0,1,72,0
157,328,104,0,48,16,0,0,0,1,74,0
157,392,216,0,112,112,0,0,0,1,78,0
157,192,120,0,320,16,0,0,0,1,84,0
157,320,288,0,32,96,0,0,0,1,88,0
157,224,184,0,32,48,0,0,1,1,90,0
157,224,136,0,32,16,0,0,0,1,91,0
157,112,336,0,16,16,0,0,0,1,93,0
157,320,224,0,48,32,0,0,0,1,99,0
157,104,168,0,144,16,0,0,0,1,136,0
157,120,208,0,176,32,0,0,1,1,144,0
157,488,360,0,16,16,0,0,0,1,158,0
157,472,192,0,48,32,0,0,0,1,175,0
157,480,264,0,64,16,0,0,0,1,184,0
157,384,360,0,16,16,0,0,0,1,190,0
157,568,344,0,80,16,0,1,0,1,200,0
157,632,376,0,48,80,0,0,0,1,201,0
157,816,0,0,352,272,0,0,0,1,202,0
157,968,384,0,16,96,0,0,0,1,216,0
157,800,384,0,320,64,0,0,0,1,217,0
157,752,344,0,192,16,0,1,0,1,218,0
157,424,288,0,48,32,0,0,0,1,220,0
157,864,352,0,32,32,0,0,0,1,222,0
157,920,352,0,80,32,0,1,0,1,225,0
157,976,296,0,32,16,0,0,0,1,227,0
157,976,360,0,32,112,0,0,0,1,228,0
157,976,272,0,32,16,0,0,0,1,229,0
157,976,184,0,32,96,0,0,0,1,230,0
157,984,248,0,16,96,0,0,0,1,231,0
157,880,240,0,64,32,0,1,0,1,239,0
157,920,240,0,16,32,0,0,0,1,240,0
157,712,240,0,64,32,0,1,0,1,242,0
157,752,240,0,16,32,0,1,0,1,243,0
157,768,240,0,16,32,0,0,0,1,244,0
157,976,248,0,32,16,0,0,0,1,253,0
169,336,64,0,0,0,0,0,0,1,27,0
169,16,64,0,0,0,0,0,0,1,29,0
172,352,96,0,0,0,0,0,0,1,75,1
169,416,128,0,0,0,0,0,0,1,83,1
169,336,128,0,0,0,0,0,0,1,129,1
172,352,112,0,0,0,0,0,0,0,151,0
169,432,304,0,0,0,0,0,0,1,166,1
169,416,304,0,0,0,0,0,0,1,167,1
169,400,304,0,0,0,0,0,0,1,168,1
169,432,128,0,0,0,0,0,0,0,173,1
253,48,232,0,16777215,0,0,0,0,1,112,0
253,320,96,0,16777215,0,7,0,0,1,113,0
253,320,208,0,16777215,0,7,0,0,1,114,0
253,568,96,0,16777215,0,7,0,0,1,115,0
253,368,160,0,16777215,0,7,0,0,1,232,0
253,464,256,0,16777215,0,7,0,0,1,233,0
253,56,160,0,16777215,0,7,0,0,1,234,0
253,408,96,0,16777215,0,7,0,0,1,235,0
253,864,334,0,16777215,0,7,0,0,1,236,0
253,960,248,0,16777215,0,5,0,0,1,255,0
253,960,272,0,16777215,0,5,0,0,1,256,0
253,960,296,0,16777215,0,5,0,0,1,257,0
253,768,224,0,16777215,0,7,0,0,1,275,0
166,208,32,0,0,0,270,0,0,1,12,1
166,112,104,0,0,0,0,0,0,1,21,1
166,304,104,0,0,0,180,0,0,1,82,1
166,32,184,0,0,0,0,0,0,1,137,1
155,280,104,0,1,1,0,0,0,1,8,0
155,136,104,0,2,1,0,0,0,1,9,0
155,48,368,0,1,2,0,0,0,0,95,0
155,48,304,0,2,2,0,0,0,0,96,0
155,280,344,0,1,3,0,0,0,0,101,0
155,280,216,0,2,3,0,0,0,0,102,0
155,192,184,0,1,4,0,0,0,1,117,0
155,224,184,0,2,4,0,0,0,0,118,0
155,528,360,0,1,5,0,0,0,0,154,0
155,504,360,0,2,5,0,0,0,0,155,0
155,536,176,0,1,6,0,0,0,1,178,0
155,536,240,0,2,6,0,0,0,1,179,0
155,424,361,0,1,7,0,0,0,0,186,0
155,400,360,0,2,7,0,0,0,0,187,0
1234567890
25,0,0,144,96,144,32,10002,0,0,0,0
25,0,0,144,96,288,32,10002,0,0,0,0
25,0,0,144,96,432,32,10002,0,0,0,0
25,0,0,144,96,576,32,10002,0,0,0,0
25,0,0,144,96,0,32,10002,0,0,0,0
25,0,0,144,96,0,128,10002,0,0,0,0
25,0,0,144,96,144,128,10002,0,0,0,0
25,0,0,144,96,288,128,10002,0,0,0,0
25,0,0,144,96,432,128,10002,0,0,0,0
25,0,0,144,96,576,128,10002,0,0,0,0
25,0,0,144,96,0,224,10002,0,0,0,0
25,0,0,144,96,144,224,10002,0,0,0,0
25,0,0,144,96,288,224,10002,0,0,0,0
25,0,0,144,96,432,224,10002,0,0,0,0
25,0,0,144,96,576,224,10002,0,0,0,0
25,0,0,144,96,0,320,10002,0,0,0,0
25,0,0,144,96,144,320,10002,0,0,0,0
25,0,0,144,96,288,320,10002,0,0,0,0
25,0,0,144,96,432,320,10002,0,0,0,0
25,0,0,144,96,576,320,10002,0,0,0,0
25,0,0,144,96,720,128,10002,0,0,0,0
25,0,0,144,96,864,128,10002,0,0,0,0
25,0,0,144,96,720,224,10002,0,0,0,0
25,0,0,144,96,864,224,10002,0,0,0,0
25,0,0,144,96,720,320,10002,0,0,0,0
25,0,0,144,96,864,320,10002,0,0,0,0
25,272,176,176,80,720,32,10002,0,0,0,0
25,272,176,176,80,896,32,10002,0,0,0,0
25,272,256,192,32,640,0,10002,0,0,0,0
25,272,256,192,32,832,0,10002,0,0,0,0
987654321
Lg5qGw83ECFkPWgOI0dMI1EoO1VBDSQCFmM3DFY0LBgzIzdwdmB+JDE=
Hgc/QhcrXCUlKWgOMklBPxQ4dBhNET1SFWBjHR4lZBwhajU1c3F9di0yMgY+AA==
JR0+QgEsSSZrLi1NMkUNKlgtYhhHCnBAHGZ2DU00LBwmajAjJXp+ImgnKQ4m
Dwk4BkAjUypqOWlHPUwNLltsdl0A

